date,sregion,eregion,e1,e2,e3,e4,e5,e6,etotal,s1,s2,s3,s4,s5,s6,stotal
2020-01-01,강원,강원,134234,1043,3328,400,352,6233,145590,134234,1043,3328,400,352,6233,145590
2020-01-01,강원,경기,55251,293,1088,233,142,2044,59051,41495,250,1084,175,197,1819,45020
2020-01-01,강원,경남,310,3,11,0,4,11,339,208,0,9,6,3,11,237
2020-01-01,강원,경북,705,12,17,2,3,24,763,815,11,20,8,7,30,891
2020-01-01,강원,광주,132,2,17,1,2,2,156,142,0,19,8,3,2,174
2020-01-01,강원,대구,310,2,4,3,0,7,326,570,2,28,6,2,15,623
2020-01-01,강원,대전,327,1,29,2,0,15,374,334,0,32,1,0,18,385
2020-01-01,강원,부산,9,0,0,0,0,0,9,10,0,0,0,0,1,11
2020-01-01,강원,서울,2732,7,481,4,0,105,3329,1362,9,301,3,4,46,1725
2020-01-01,강원,세종,11,0,0,0,0,0,11,11,0,0,0,0,0,11
2020-01-01,강원,울산,5,0,0,0,0,0,5,3,0,0,0,1,0,4
2020-01-01,강원,전남,79,0,1,0,1,0,81,84,0,1,1,1,1,88
2020-01-01,강원,전북,236,2,6,2,0,5,251,261,3,5,4,5,4,282
2020-01-01,강원,충남,645,1,8,3,10,29,696,933,5,16,14,18,33,1019
2020-01-01,강원,충북,5787,90,123,49,26,241,6316,6136,80,161,60,38,279,6754
2020-01-01,경기,강원,41495,250,1084,175,197,1819,45020,55251,293,1088,233,142,2044,59051
2020-01-01,경기,경기,287216,6444,8443,5067,2895,17027,327092,287216,6444,8443,5067,2895,17027,327092
2020-01-01,경기,경남,3499,37,247,284,116,128,4311,2898,25,191,181,85,105,3485
2020-01-01,경기,경북,4909,39,239,288,118,183,5776,6938,45,213,290,107,240,7833
2020-01-01,경기,광주,829,8,109,88,18,20,1072,750,4,93,58,18,20,943
2020-01-01,경기,대구,1840,12,91,145,49,45,2182,4135,24,137,151,73,142,4662
2020-01-01,경기,대전,2005,37,156,49,13,90,2350,2613,41,170,37,10,129,3000
2020-01-01,경기,부산,176,3,17,56,27,4,283,346,3,16,55,33,11,464
2020-01-01,경기,서울,97163,2509,4434,1648,549,5331,111634,108747,2444,4406,1260,490,6248,123595
2020-01-01,경기,세종,45,0,2,0,2,1,50,69,1,2,0,3,3,78
2020-01-01,경기,울산,47,0,5,5,6,0,63,89,0,1,11,15,3,119
2020-01-01,경기,전남,1050,5,89,49,36,23,1252,1178,10,81,47,35,25,1376
2020-01-01,경기,전북,1715,10,98,49,66,56,1994,2141,13,104,50,39,86,2433
2020-01-01,경기,충남,37591,461,1396,652,720,1783,42603,41472,433,1408,650,746,1866,46575
2020-01-01,경기,충북,24680,628,1033,790,582,1191,28904,28900,617,972,843,561,1339,33232
2020-01-01,경남,강원,208,0,9,6,3,11,237,310,3,11,0,4,11,339
2020-01-01,경남,경기,2898,25,191,181,85,105,3485,3499,37,247,284,116,128,4311
2020-01-01,경남,경남,168052,3336,3572,1403,1075,9963,187401,168052,3336,3572,1403,1075,9963,187401
2020-01-01,경남,경북,16867,177,409,190,189,763,18595,24161,296,540,369,293,1092,26751
2020-01-01,경남,광주,2172,16,87,53,16,49,2393,1935,13,93,40,19,54,2154
2020-01-01,경남,대구,19398,242,625,292,379,780,21716,14103,151,478,115,67,590,15504
2020-01-01,경남,대전,1495,6,100,23,14,52,1690,1716,12,103,26,11,68,1936
2020-01-01,경남,부산,83704,808,1601,289,400,4695,91497,84861,868,1488,250,494,4971,92932
2020-01-01,경남,서울,2409,9,464,62,34,92,3070,3478,4,498,57,21,108,4166
2020-01-01,경남,세종,369,0,6,2,4,10,391,318,1,18,8,4,12,361
2020-01-01,경남,울산,11807,194,299,80,58,599,13037,13218,186,307,85,81,661,14538
2020-01-01,경남,전남,8924,108,236,117,194,370,9949,9064,116,226,109,195,375,10085
2020-01-01,경남,전북,2703,17,71,35,20,76,2922,2637,20,79,32,22,81,2871
2020-01-01,경남,충남,1834,9,56,25,39,67,2030,2252,15,90,84,92,81,2614
2020-01-01,경남,충북,1935,15,67,66,53,64,2200,2064,14,112,200,116,80,2586
2020-01-01,경북,강원,815,11,20,8,7,30,891,705,12,17,2,3,24,763
2020-01-01,경북,경기,6938,45,213,290,107,240,7833,4909,39,239,288,118,183,5776
2020-01-01,경북,경남,24161,296,540,369,293,1092,26751,16867,177,409,190,189,763,18595
2020-01-01,경북,경북,98886,1259,1682,629,609,4250,107315,98886,1259,1682,629,609,4250,107315
2020-01-01,경북,광주,1404,15,80,62,10,42,1613,1190,13,53,38,9,24,1327
2020-01-01,경북,대구,72697,829,1192,346,216,3181,78461,70786,905,1347,408,327,3192,76965
2020-01-01,경북,대전,3291,10,88,33,26,137,3585,2849,11,90,36,6,158,3150
2020-01-01,경북,부산,10002,45,285,29,78,366,10805,9932,47,282,24,110,396,10791
2020-01-01,경북,서울,4054,19,336,76,17,132,4634,3703,25,276,55,25,118,4202
2020-01-01,경북,세종,462,1,11,4,3,14,495,399,1,9,6,2,14,431
2020-01-01,경북,울산,9486,54,135,128,258,420,10481,8482,46,117,55,290,382,9372
2020-01-01,경북,전남,1836,18,39,38,119,53,2103,1929,19,43,35,158,63,2247
2020-01-01,경북,전북,2429,31,92,47,31,67,2697,2261,30,70,31,51,71,2514
2020-01-01,경북,충남,4916,36,88,100,128,181,5449,4366,28,85,103,152,167,4901
2020-01-01,경북,충북,10673,73,220,215,163,346,11690,8364,72,226,232,165,287,9346
2020-01-01,광주,강원,142,0,19,8,3,2,174,132,2,17,1,2,2,156
2020-01-01,광주,경기,750,4,93,58,18,20,943,829,8,109,88,18,20,1072
2020-01-01,광주,경남,1935,13,93,40,19,54,2154,2172,16,87,53,16,49,2393
2020-01-01,광주,경북,1190,13,53,38,9,24,1327,1404,15,80,62,10,42,1613
2020-01-01,광주,광주,11500,206,428,111,52,371,12668,11500,206,428,111,52,371,12668
2020-01-01,광주,대구,615,6,70,28,4,18,741,692,10,79,22,2,21,826
2020-01-01,광주,대전,471,7,7,7,5,16,513,527,5,10,6,6,24,578
2020-01-01,광주,부산,690,2,51,7,5,24,779,973,2,55,5,12,15,1062
2020-01-01,광주,서울,612,7,15,14,3,13,664,675,6,11,14,5,23,734
2020-01-01,광주,세종,202,0,6,3,1,4,216,161,1,3,1,1,1,168
2020-01-01,광주,울산,61,1,5,0,1,0,68,101,0,8,2,2,1,114
2020-01-01,광주,전남,36895,394,762,191,116,1206,39564,39556,406,746,208,133,1243,42292
2020-01-01,광주,전북,8859,137,243,99,53,277,9668,9821,169,249,96,52,287,10674
2020-01-01,광주,충남,5358,34,429,123,72,143,6159,4497,33,434,215,110,139,5428
2020-01-01,광주,충북,652,8,33,27,6,18,744,667,6,39,41,20,17,790
2020-01-01,대구,강원,570,2,28,6,2,15,623,310,2,4,3,0,7,326
2020-01-01,대구,경기,4135,24,137,151,73,142,4662,1840,12,91,145,49,45,2182
2020-01-01,대구,경남,14103,151,478,115,67,590,15504,19398,242,625,292,379,780,21716
2020-01-01,대구,경북,70786,905,1347,408,327,3192,76965,72697,829,1192,346,216,3181,78461
2020-01-01,대구,광주,692,10,79,22,2,21,826,615,6,70,28,4,18,741
2020-01-01,대구,대구,36937,424,601,200,160,2038,40360,36937,424,601,200,160,2038,40360
2020-01-01,대구,대전,1368,5,29,24,10,51,1487,778,5,24,20,7,29,863
2020-01-01,대구,부산,898,6,58,30,21,30,1043,6775,39,181,25,30,214,7264
2020-01-01,대구,서울,3117,20,180,53,23,77,3470,1721,7,127,37,9,48,1949
2020-01-01,대구,세종,471,1,9,0,1,14,496,201,0,5,1,1,3,211
2020-01-01,대구,울산,2027,13,104,15,56,77,2292,2246,14,99,6,69,79,2513
2020-01-01,대구,전남,804,2,43,8,12,22,891,1023,6,45,11,10,22,1117
2020-01-01,대구,전북,490,5,28,1,0,11,535,484,5,30,1,9,6,535
2020-01-01,대구,충남,2057,16,39,32,39,81,2264,1105,9,24,45,42,33,1258
2020-01-01,대구,충북,2758,20,109,79,73,89,3128,1582,17,69,99,43,51,1861
2020-01-01,대전,강원,334,0,32,1,0,18,385,327,1,29,2,0,15,374
2020-01-01,대전,경기,2613,41,170,37,10,129,3000,2005,37,156,49,13,90,2350
2020-01-01,대전,경남,1716,12,103,26,11,68,1936,1495,6,100,23,14,52,1690
2020-01-01,대전,경북,2849,11,90,36,6,158,3150,3291,10,88,33,26,137,3585
2020-01-01,대전,광주,527,5,10,6,6,24,578,471,7,7,7,5,16,513
2020-01-01,대전,대구,778,5,24,20,7,29,863,1368,5,29,24,10,51,1487
2020-01-01,대전,대전,9652,99,112,41,9,638,10551,9652,99,112,41,9,638,10551
2020-01-01,대전,부산,89,0,0,1,2,2,94,155,0,2,4,6,2,169
2020-01-01,대전,서울,2027,10,188,11,4,91,2331,1680,8,187,13,0,77,1965
2020-01-01,대전,세종,2496,35,26,11,2,154,2724,2015,43,21,10,3,128,2220
2020-01-01,대전,울산,154,0,11,2,3,10,180,199,1,9,1,3,10,223
2020-01-01,대전,전남,538,3,6,8,2,12,569,621,4,11,8,7,18,669
2020-01-01,대전,전북,4350,32,54,19,5,187,4647,4760,38,48,16,13,173,5048
2020-01-01,대전,충남,12999,105,240,65,40,741,14190,12888,116,241,77,48,720,14090
2020-01-01,대전,충북,8366,165,217,52,26,510,9336,7497,122,214,49,20,464,8366
2020-01-01,부산,강원,10,0,0,0,0,1,11,9,0,0,0,0,0,9
2020-01-01,부산,경기,346,3,16,55,33,11,464,176,3,17,56,27,4,283
2020-01-01,부산,경남,84861,868,1488,250,494,4971,92932,83704,808,1601,289,400,4695,91497
2020-01-01,부산,경북,9932,47,282,24,110,396,10791,10002,45,285,29,78,366,10805
2020-01-01,부산,광주,973,2,55,5,12,15,1062,690,2,51,7,5,24,779
2020-01-01,부산,대구,6775,39,181,25,30,214,7264,898,6,58,30,21,30,1043
2020-01-01,부산,대전,155,0,2,4,6,2,169,89,0,0,1,2,2,94
2020-01-01,부산,부산,59659,206,250,87,330,2921,63453,59659,206,250,87,330,2921,63453
2020-01-01,부산,서울,207,2,8,14,18,4,253,183,4,10,12,12,4,225
2020-01-01,부산,세종,63,0,1,1,0,0,65,19,0,0,0,0,0,19
2020-01-01,부산,울산,20694,114,148,85,293,1170,22504,20973,105,103,66,329,1118,22694
2020-01-01,부산,전남,2894,24,98,31,102,99,3248,2424,16,72,35,88,69,2704
2020-01-01,부산,전북,723,3,27,1,18,20,792,626,2,22,5,12,25,692
2020-01-01,부산,충남,282,1,8,9,35,13,348,147,1,5,13,41,4,211
2020-01-01,부산,충북,227,2,10,17,39,10,305,132,2,5,31,35,4,209
2020-01-01,서울,강원,1362,9,301,3,4,46,1725,2732,7,481,4,0,105,3329
2020-01-01,서울,경기,108747,2444,4406,1260,490,6248,123595,97163,2509,4434,1648,549,5331,111634
2020-01-01,서울,경남,3478,4,498,57,21,108,4166,2409,9,464,62,34,92,3070
2020-01-01,서울,경북,3703,25,276,55,25,118,4202,4054,19,336,76,17,132,4634
2020-01-01,서울,광주,675,6,11,14,5,23,734,612,7,15,14,3,13,664
2020-01-01,서울,대구,1721,7,127,37,9,48,1949,3117,20,180,53,23,77,3470
2020-01-01,서울,대전,1680,8,187,13,0,77,1965,2027,10,188,11,4,91,2331
2020-01-01,서울,부산,183,4,10,12,12,4,225,207,2,8,14,18,4,253
2020-01-01,서울,서울,183,2,6,1,0,5,197,183,2,6,1,0,5,197
2020-01-01,서울,세종,34,0,0,0,0,2,36,31,0,0,0,0,1,32
2020-01-01,서울,울산,52,1,2,0,0,3,58,43,0,1,3,5,0,52
2020-01-01,서울,전남,932,5,27,10,3,25,1002,1100,7,29,27,7,31,1201
2020-01-01,서울,전북,1512,10,31,3,4,47,1607,1730,8,34,8,11,36,1827
2020-01-01,서울,충남,30134,124,1902,202,190,1161,33713,34302,148,1922,298,205,1272,38147
2020-01-01,서울,충북,13661,120,730,164,112,608,15395,13953,150,811,265,143,566,15888
2020-01-01,세종,강원,11,0,0,0,0,0,11,11,0,0,0,0,0,11
2020-01-01,세종,경기,69,1,2,0,3,3,78,45,0,2,0,2,1,50
2020-01-01,세종,경남,318,1,18,8,4,12,361,369,0,6,2,4,10,391
2020-01-01,세종,경북,399,1,9,6,2,14,431,462,1,11,4,3,14,495
2020-01-01,세종,광주,161,1,3,1,1,1,168,202,0,6,3,1,4,216
2020-01-01,세종,대구,201,0,5,1,1,3,211,471,1,9,0,1,14,496
2020-01-01,세종,대전,2015,43,21,10,3,128,2220,2496,35,26,11,2,154,2724
2020-01-01,세종,부산,19,0,0,0,0,0,19,63,0,1,1,0,0,65
2020-01-01,세종,서울,31,0,0,0,0,1,32,34,0,0,0,0,2,36
2020-01-01,세종,세종,209,17,1,0,0,9,236,209,17,1,0,0,9,236
2020-01-01,세종,울산,16,0,0,0,1,0,17,28,0,0,0,0,0,28
2020-01-01,세종,전남,188,1,1,0,6,7,203,333,0,1,1,8,8,351
2020-01-01,세종,전북,1002,8,7,1,7,36,1061,1215,5,6,6,9,48,1289
2020-01-01,세종,충남,6562,89,92,40,35,279,7097,6712,67,95,46,38,263,7221
2020-01-01,세종,충북,284,4,2,4,2,21,317,289,8,4,4,1,20,326
2020-01-01,울산,강원,3,0,0,0,1,0,4,5,0,0,0,0,0,5
2020-01-01,울산,경기,89,0,1,11,15,3,119,47,0,5,5,6,0,63
2020-01-01,울산,경남,13218,186,307,85,81,661,14538,11807,194,299,80,58,599,13037
2020-01-01,울산,경북,8482,46,117,55,290,382,9372,9486,54,135,128,258,420,10481
2020-01-01,울산,광주,101,0,8,2,2,1,114,61,1,5,0,1,0,68
2020-01-01,울산,대구,2246,14,99,6,69,79,2513,2027,13,104,15,56,77,2292
2020-01-01,울산,대전,199,1,9,1,3,10,223,154,0,11,2,3,10,180
2020-01-01,울산,부산,20973,105,103,66,329,1118,22694,20694,114,148,85,293,1170,22504
2020-01-01,울산,서울,43,0,1,3,5,0,52,52,1,2,0,0,3,58
2020-01-01,울산,세종,28,0,0,0,0,0,28,16,0,0,0,1,0,17
2020-01-01,울산,울산,5987,62,101,27,60,424,6661,5987,62,101,27,60,424,6661
2020-01-01,울산,전남,437,3,9,8,3,16,476,277,5,5,4,6,5,302
2020-01-01,울산,전북,89,0,6,0,6,3,104,77,0,6,0,4,1,88
2020-01-01,울산,충남,213,2,2,6,27,11,261,165,3,5,12,23,5,213
2020-01-01,울산,충북,50,0,1,4,11,4,70,36,0,1,2,16,1,56
2020-01-01,전남,강원,84,0,1,1,1,1,88,79,0,1,0,1,0,81
2020-01-01,전남,경기,1178,10,81,47,35,25,1376,1050,5,89,49,36,23,1252
2020-01-01,전남,경남,9064,116,226,109,195,375,10085,8924,108,236,117,194,370,9949
2020-01-01,전남,경북,1929,19,43,35,158,63,2247,1836,18,39,38,119,53,2103
2020-01-01,전남,광주,39556,406,746,208,133,1243,42292,36895,394,762,191,116,1206,39564
2020-01-01,전남,대구,1023,6,45,11,10,22,1117,804,2,43,8,12,22,891
2020-01-01,전남,대전,621,4,11,8,7,18,669,538,3,6,8,2,12,569
2020-01-01,전남,부산,2424,16,72,35,88,69,2704,2894,24,98,31,102,99,3248
2020-01-01,전남,서울,1100,7,29,27,7,31,1201,932,5,27,10,3,25,1002
2020-01-01,전남,세종,333,0,1,1,8,8,351,188,1,1,0,6,7,203
2020-01-01,전남,울산,277,5,5,4,6,5,302,437,3,9,8,3,16,476
2020-01-01,전남,전남,59902,539,957,494,648,1905,64445,59902,539,957,494,648,1905,64445
2020-01-01,전남,전북,9163,110,237,173,375,223,10281,8309,94,228,223,371,199,9424
2020-01-01,전남,충남,7408,30,412,203,330,216,8599,5833,36,406,176,279,165,6895
2020-01-01,전남,충북,696,4,17,30,42,16,805,535,3,23,29,52,12,654
2020-01-01,전북,강원,261,3,5,4,5,4,282,236,2,6,2,0,5,251
2020-01-01,전북,경기,2141,13,104,50,39,86,2433,1715,10,98,49,66,56,1994
2020-01-01,전북,경남,2637,20,79,32,22,81,2871,2703,17,71,35,20,76,2922
2020-01-01,전북,경북,2261,30,70,31,51,71,2514,2429,31,92,47,31,67,2697
2020-01-01,전북,광주,9821,169,249,96,52,287,10674,8859,137,243,99,53,277,9668
2020-01-01,전북,대구,484,5,30,1,9,6,535,490,5,28,1,0,11,535
2020-01-01,전북,대전,4760,38,48,16,13,173,5048,4350,32,54,19,5,187,4647
2020-01-01,전북,부산,626,2,22,5,12,25,692,723,3,27,1,18,20,792
2020-01-01,전북,서울,1730,8,34,8,11,36,1827,1512,10,31,3,4,47,1607
2020-01-01,전북,세종,1215,5,6,6,9,48,1289,1002,8,7,1,7,36,1061
2020-01-01,전북,울산,77,0,6,0,4,1,88,89,0,6,0,6,3,104
2020-01-01,전북,전남,8309,94,228,223,371,199,9424,9163,110,237,173,375,223,10281
2020-01-01,전북,전북,15703,248,397,158,98,561,17165,15703,248,397,158,98,561,17165
2020-01-01,전북,충남,20094,151,989,313,399,694,22640,17715,158,969,323,386,601,20152
2020-01-01,전북,충북,2503,38,54,83,47,98,2823,2190,45,66,62,55,65,2483
2020-01-01,충남,강원,933,5,16,14,18,33,1019,645,1,8,3,10,29,696
2020-01-01,충남,경기,41472,433,1408,650,746,1866,46575,37591,461,1396,652,720,1783,42603
2020-01-01,충남,경남,2252,15,90,84,92,81,2614,1834,9,56,25,39,67,2030
2020-01-01,충남,경북,4366,28,85,103,152,167,4901,4916,36,88,100,128,181,5449
2020-01-01,충남,광주,4497,33,434,215,110,139,5428,5358,34,429,123,72,143,6159
2020-01-01,충남,대구,1105,9,24,45,42,33,1258,2057,16,39,32,39,81,2264
2020-01-01,충남,대전,12888,116,241,77,48,720,14090,12999,105,240,65,40,741,14190
2020-01-01,충남,부산,147,1,5,13,41,4,211,282,1,8,9,35,13,348
2020-01-01,충남,서울,34302,148,1922,298,205,1272,38147,30134,124,1902,202,190,1161,33713
2020-01-01,충남,세종,6712,67,95,46,38,263,7221,6562,89,92,40,35,279,7097
2020-01-01,충남,울산,165,3,5,12,23,5,213,213,2,2,6,27,11,261
2020-01-01,충남,전남,5833,36,406,176,279,165,6895,7408,30,412,203,330,216,8599
2020-01-01,충남,전북,17715,158,969,323,386,601,20152,20094,151,989,313,399,694,22640
2020-01-01,충남,충남,107903,1132,4588,1770,2236,4320,121949,107903,1132,4588,1770,2236,4320,121949
2020-01-01,충남,충북,10147,194,309,289,312,535,11786,9738,198,312,181,378,536,11343
2020-01-01,충북,강원,6136,80,161,60,38,279,6754,5787,90,123,49,26,241,6316
2020-01-01,충북,경기,28900,617,972,843,561,1339,33232,24680,628,1033,790,582,1191,28904
2020-01-01,충북,경남,2064,14,112,200,116,80,2586,1935,15,67,66,53,64,2200
2020-01-01,충북,경북,8364,72,226,232,165,287,9346,10673,73,220,215,163,346,11690
2020-01-01,충북,광주,667,6,39,41,20,17,790,652,8,33,27,6,18,744
2020-01-01,충북,대구,1582,17,69,99,43,51,1861,2758,20,109,79,73,89,3128
2020-01-01,충북,대전,7497,122,214,49,20,464,8366,8366,165,217,52,26,510,9336
2020-01-01,충북,부산,132,2,5,31,35,4,209,227,2,10,17,39,10,305
2020-01-01,충북,서울,13953,150,811,265,143,566,15888,13661,120,730,164,112,608,15395
2020-01-01,충북,세종,289,8,4,4,1,20,326,284,4,2,4,2,21,317
2020-01-01,충북,울산,36,0,1,2,16,1,56,50,0,1,4,11,4,70
2020-01-01,충북,전남,535,3,23,29,52,12,654,696,4,17,30,42,16,805
2020-01-01,충북,전북,2190,45,66,62,55,65,2483,2503,38,54,83,47,98,2823
2020-01-01,충북,충남,9738,198,312,181,378,536,11343,10147,194,309,289,312,535,11786
2020-01-01,충북,충북,30744,669,739,597,399,1579,34727,30744,669,739,597,399,1579,34727
2020-01-02,강원,강원,74212,1989,3000,1059,1874,4585,86719,74212,1989,3000,1059,1874,4585,86719
2020-01-02,강원,경기,26564,547,1230,580,588,1177,30686,22922,556,1231,577,726,1040,27052
2020-01-02,강원,경남,233,2,10,4,14,10,273,176,2,5,10,8,2,203
2020-01-02,강원,경북,616,21,32,14,23,23,729,553,13,32,16,15,20,649
2020-01-02,강원,광주,121,1,19,9,3,6,159,112,2,15,6,2,1,138
2020-01-02,강원,대구,308,4,3,9,9,9,342,431,7,14,12,9,12,485
2020-01-02,강원,대전,230,2,28,3,0,7,270,227,6,25,4,1,5,268
2020-01-02,강원,부산,11,0,1,0,1,0,13,5,0,0,1,0,0,6
2020-01-02,강원,서울,826,19,262,14,8,29,1158,975,20,250,13,16,41,1315
2020-01-02,강원,세종,10,1,0,0,0,1,12,7,0,0,0,1,0,8
2020-01-02,강원,울산,5,0,1,0,0,0,6,2,0,0,0,0,0,2
2020-01-02,강원,전남,64,2,2,2,13,0,83,60,0,0,6,6,0,72
2020-01-02,강원,전북,165,3,9,7,11,5,200,208,8,15,13,15,7,266
2020-01-02,강원,충남,523,7,16,17,18,17,598,558,8,23,18,68,17,692
2020-01-02,강원,충북,5044,203,264,178,292,289,6270,5058,186,274,143,195,276,6132
2020-01-02,경기,강원,22922,556,1231,577,726,1040,27052,26564,547,1230,580,588,1177,30686
2020-01-02,경기,경기,400159,21786,22788,16754,21050,30521,513058,400159,21786,22788,16754,21050,30521,513058
2020-01-02,경기,경남,2905,71,280,423,313,91,4083,2188,43,224,331,315,76,3177
2020-01-02,경기,경북,4245,168,464,538,391,149,5955,4343,163,438,696,420,162,6222
2020-01-02,경기,광주,834,28,158,169,108,26,1323,785,13,122,161,81,25,1187
2020-01-02,경기,대구,1972,85,181,236,135,64,2673,3044,95,199,279,336,111,4064
2020-01-02,경기,대전,1903,97,190,92,41,90,2413,2431,107,195,103,55,95,2986
2020-01-02,경기,부산,200,8,23,72,79,7,389,326,13,32,76,167,16,630
2020-01-02,경기,서울,137066,7034,8574,3890,2946,9225,168735,144433,6715,8607,4076,2665,9672,176168
2020-01-02,경기,세종,38,3,5,3,0,2,51,58,1,3,3,3,1,69
2020-01-02,경기,울산,40,2,5,6,15,1,69,43,2,6,14,64,0,129
2020-01-02,경기,전남,861,20,92,113,114,22,1222,868,20,78,114,116,28,1224
2020-01-02,경기,전북,1466,49,150,113,154,47,1979,1530,52,145,155,174,59,2115
2020-01-02,경기,충남,37160,1394,2529,2035,3624,1954,48696,34624,1328,2434,1857,3500,1841,45584
2020-01-02,경기,충북,27980,2067,2753,2670,2824,1356,39650,26238,1964,2564,2489,2869,1314,37438
2020-01-02,경남,강원,176,2,5,10,8,2,203,233,2,10,4,14,10,273
2020-01-02,경남,경기,2188,43,224,331,315,76,3177,2905,71,280,423,313,91,4083
2020-01-02,경남,경남,190758,9492,9237,6307,10544,14784,241122,190758,9492,9237,6307,10544,14784,241122
2020-01-02,경남,경북,11736,585,887,796,1481,603,16088,14259,831,1089,1002,2150,672,20003
2020-01-02,경남,광주,1256,44,112,148,118,32,1710,1365,40,140,95,97,38,1775
2020-01-02,경남,대구,14133,686,888,918,1462,646,18733,11418,462,708,369,366,538,13861
2020-01-02,경남,대전,784,16,96,58,25,25,1004,1152,22,101,80,59,38,1452
2020-01-02,경남,부산,86416,2486,2823,1449,3961,6261,103396,86960,2606,2904,1517,4098,6336,104421
2020-01-02,경남,서울,1932,27,402,196,128,74,2759,2789,36,441,65,52,102,3485
2020-01-02,경남,세종,192,0,10,7,8,3,220,280,1,24,8,14,6,333
2020-01-02,경남,울산,10900,491,554,311,469,651,13376,10386,483,564,314,477,620,12844
2020-01-02,경남,전남,6813,254,435,477,1145,285,9409,6691,249,420,403,1112,269,9144
2020-01-02,경남,전북,1607,33,137,92,98,51,2018,1663,30,140,102,93,43,2071
2020-01-02,경남,충남,1431,32,84,187,181,39,1954,1760,37,147,201,351,58,2554
2020-01-02,경남,충북,1299,40,119,206,237,48,1949,1593,58,172,313,406,58,2600
2020-01-02,경북,강원,553,13,32,16,15,20,649,616,21,32,14,23,23,729
2020-01-02,경북,경기,4343,163,438,696,420,162,6222,4245,168,464,538,391,149,5955
2020-01-02,경북,경남,14259,831,1089,1002,2150,672,20003,11736,585,887,796,1481,603,16088
2020-01-02,경북,경북,74377,3347,3742,2334,3759,4034,91593,74377,3347,3742,2334,3759,4034,91593
2020-01-02,경북,광주,906,45,125,122,62,32,1292,960,30,70,105,43,33,1241
2020-01-02,경북,대구,69603,2615,2505,1294,2350,3920,82287,74402,2912,3015,1666,2741,4058,88794
2020-01-02,경북,대전,1862,52,100,86,68,82,2250,1970,34,94,82,54,93,2327
2020-01-02,경북,부산,5150,113,314,138,524,234,6473,5991,106,353,163,629,269,7511
2020-01-02,경북,서울,2851,83,315,329,110,112,3800,3039,65,309,147,62,98,3720
2020-01-02,경북,세종,294,2,21,22,17,10,366,314,5,14,21,9,7,370
2020-01-02,경북,울산,5778,120,277,364,963,328,7830,5443,119,267,283,1092,319,7523
2020-01-02,경북,전남,1287,42,59,112,392,37,1929,1224,43,72,83,462,36,1920
2020-01-02,경북,전북,1966,81,175,160,184,61,2627,1698,84,163,136,186,47,2314
2020-01-02,경북,충남,3272,107,277,396,481,113,4646,3341,104,265,298,593,128,4729
2020-01-02,경북,충북,5413,223,448,550,776,230,7640,5143,212,473,481,770,212,7291
2020-01-02,광주,강원,112,2,15,6,2,1,138,121,1,19,9,3,6,159
2020-01-02,광주,경기,785,13,122,161,81,25,1187,834,28,158,169,108,26,1323
2020-01-02,광주,경남,1365,40,140,95,97,38,1775,1256,44,112,148,118,32,1710
2020-01-02,광주,경북,960,30,70,105,43,33,1241,906,45,125,122,62,32,1292
2020-01-02,광주,광주,12486,458,605,343,202,556,14650,12486,458,605,343,202,556,14650
2020-01-02,광주,대구,568,29,90,68,21,18,794,646,29,98,60,24,18,875
2020-01-02,광주,대전,436,22,13,12,8,11,502,533,14,16,20,12,10,605
2020-01-02,광주,부산,446,12,39,26,69,5,597,606,22,45,48,87,18,826
2020-01-02,광주,서울,693,13,17,44,11,23,801,774,19,17,23,12,34,879
2020-01-02,광주,세종,151,3,7,5,6,4,176,174,5,6,10,3,3,201
2020-01-02,광주,울산,54,2,6,1,5,2,70,50,0,7,5,3,2,67
2020-01-02,광주,전남,34804,922,1267,831,1393,1376,40593,31932,892,1014,730,1189,1321,37078
2020-01-02,광주,전북,8210,393,514,325,373,335,10150,7842,415,441,246,330,320,9594
2020-01-02,광주,충남,4144,76,515,334,198,108,5375,3829,85,505,352,207,124,5102
2020-01-02,광주,충북,652,26,63,81,47,21,890,652,26,67,120,46,18,929
2020-01-02,대구,강원,431,7,14,12,9,12,485,308,4,3,9,9,9,342
2020-01-02,대구,경기,3044,95,199,279,336,111,4064,1972,85,181,236,135,64,2673
2020-01-02,대구,경남,11418,462,708,369,366,538,13861,14133,686,888,918,1462,646,18733
2020-01-02,대구,경북,74402,2912,3015,1666,2741,4058,88794,69603,2615,2505,1294,2350,3920,82287
2020-01-02,대구,광주,646,29,98,60,24,18,875,568,29,90,68,21,18,794
2020-01-02,대구,대구,57708,2062,1495,760,1228,3851,67104,57708,2062,1495,760,1228,3851,67104
2020-01-02,대구,대전,1009,35,49,46,25,40,1204,685,21,37,25,18,25,811
2020-01-02,대구,부산,672,50,105,58,105,31,1021,3378,92,230,94,215,149,4158
2020-01-02,대구,서울,2537,53,172,127,87,79,3055,1700,40,121,38,32,53,1984
2020-01-02,대구,세종,271,5,16,5,8,13,318,184,0,7,3,4,8,206
2020-01-02,대구,울산,1477,44,134,60,127,86,1928,1341,53,125,70,170,75,1834
2020-01-02,대구,전남,615,11,38,22,42,17,745,526,14,31,41,66,17,695
2020-01-02,대구,전북,411,13,35,7,17,18,501,324,12,35,20,15,12,418
2020-01-02,대구,충남,1795,48,115,158,226,53,2395,1059,45,71,106,125,41,1447
2020-01-02,대구,충북,2113,74,194,207,320,76,2984,1352,79,135,140,83,33,1822
2020-01-02,대전,강원,227,6,25,4,1,5,268,230,2,28,3,0,7,270
2020-01-02,대전,경기,2431,107,195,103,55,95,2986,1903,97,190,92,41,90,2413
2020-01-02,대전,경남,1152,22,101,80,59,38,1452,784,16,96,58,25,25,1004
2020-01-02,대전,경북,1970,34,94,82,54,93,2327,1862,52,100,86,68,82,2250
2020-01-02,대전,광주,533,14,16,20,12,10,605,436,22,13,12,8,11,502
2020-01-02,대전,대구,685,21,37,25,18,25,811,1009,35,49,46,25,40,1204
2020-01-02,대전,대전,13327,377,388,163,185,1011,15451,13327,377,388,163,185,1011,15451
2020-01-02,대전,부산,85,2,6,11,17,4,125,87,0,2,16,16,4,125
2020-01-02,대전,서울,1915,36,208,22,12,68,2261,1680,49,204,12,7,69,2021
2020-01-02,대전,세종,3334,79,65,22,103,248,3851,3287,94,67,29,188,260,3925
2020-01-02,대전,울산,100,1,11,16,16,4,148,90,0,11,8,27,2,138
2020-01-02,대전,전남,323,6,11,29,34,12,415,343,9,14,17,18,8,409
2020-01-02,대전,전북,3384,83,79,63,30,165,3804,3066,95,79,60,30,176,3506
2020-01-02,대전,충남,16218,423,508,187,305,1182,18823,13684,405,463,208,274,1072,16106
2020-01-02,대전,충북,10939,442,424,175,146,796,12922,9313,365,378,146,134,701,11037
2020-01-02,부산,강원,5,0,0,1,0,0,6,11,0,1,0,1,0,13
2020-01-02,부산,경기,326,13,32,76,167,16,630,200,8,23,72,79,7,389
2020-01-02,부산,경남,86960,2606,2904,1517,4098,6336,104421,86416,2486,2823,1449,3961,6261,103396
2020-01-02,부산,경북,5991,106,353,163,629,269,7511,5150,113,314,138,524,234,6473
2020-01-02,부산,광주,606,22,45,48,87,18,826,446,12,39,26,69,5,597
2020-01-02,부산,대구,3378,92,230,94,215,149,4158,672,50,105,58,105,31,1021
2020-01-02,부산,대전,87,0,2,16,16,4,125,85,2,6,11,17,4,125
2020-01-02,부산,부산,41538,659,529,511,1705,2952,47894,41538,659,529,511,1705,2952,47894
2020-01-02,부산,서울,214,11,14,27,41,2,309,185,6,5,13,18,3,230
2020-01-02,부산,세종,20,1,1,0,3,2,27,22,1,3,0,1,0,27
2020-01-02,부산,울산,18824,356,407,541,2112,1204,23444,17456,340,311,367,1996,1200,21670
2020-01-02,부산,전남,2437,75,116,157,456,98,3339,1953,74,122,141,501,71,2862
2020-01-02,부산,전북,485,6,33,24,83,13,644,401,9,31,24,50,6,521
2020-01-02,부산,충남,219,8,14,52,107,3,403,141,7,12,36,120,2,318
2020-01-02,부산,충북,153,11,16,55,180,5,420,110,13,15,58,139,3,338
2020-01-02,서울,강원,975,20,250,13,16,41,1315,826,19,262,14,8,29,1158
2020-01-02,서울,경기,144433,6715,8607,4076,2665,9672,176168,137066,7034,8574,3890,2946,9225,168735
2020-01-02,서울,경남,2789,36,441,65,52,102,3485,1932,27,402,196,128,74,2759
2020-01-02,서울,경북,3039,65,309,147,62,98,3720,2851,83,315,329,110,112,3800
2020-01-02,서울,광주,774,19,17,23,12,34,879,693,13,17,44,11,23,801
2020-01-02,서울,대구,1700,40,121,38,32,53,1984,2537,53,172,127,87,79,3055
2020-01-02,서울,대전,1680,49,204,12,7,69,2021,1915,36,208,22,12,68,2261
2020-01-02,서울,부산,185,6,5,13,18,3,230,214,11,14,27,41,2,309
2020-01-02,서울,서울,171,5,4,5,3,10,198,171,5,4,5,3,10,198
2020-01-02,서울,세종,22,0,2,0,1,1,26,32,1,0,1,0,1,35
2020-01-02,서울,울산,35,0,0,0,0,1,36,36,1,6,2,7,1,53
2020-01-02,서울,전남,970,9,26,31,18,32,1086,936,14,36,69,50,26,1131
2020-01-02,서울,전북,1465,14,51,14,27,31,1602,1300,20,50,28,27,37,1462
2020-01-02,서울,충남,26852,459,2253,609,599,1104,31876,25645,603,2289,1205,1052,994,31788
2020-01-02,서울,충북,14725,517,1147,579,492,659,18119,12400,612,1166,649,573,531,15931
2020-01-02,세종,강원,7,0,0,0,1,0,8,10,1,0,0,0,1,12
2020-01-02,세종,경기,58,1,3,3,3,1,69,38,3,5,3,0,2,51
2020-01-02,세종,경남,280,1,24,8,14,6,333,192,0,10,7,8,3,220
2020-01-02,세종,경북,314,5,14,21,9,7,370,294,2,21,22,17,10,366
2020-01-02,세종,광주,174,5,6,10,3,3,201,151,3,7,5,6,4,176
2020-01-02,세종,대구,184,0,7,3,4,8,206,271,5,16,5,8,13,318
2020-01-02,세종,대전,3287,94,67,29,188,260,3925,3334,79,65,22,103,248,3851
2020-01-02,세종,부산,22,1,3,0,1,0,27,20,1,1,0,3,2,27
2020-01-02,세종,서울,32,1,0,1,0,1,35,22,0,2,0,1,1,26
2020-01-02,세종,세종,226,25,4,2,0,17,274,226,25,4,2,0,17,274
2020-01-02,세종,울산,12,0,0,4,4,2,22,15,0,0,1,7,0,23
2020-01-02,세종,전남,187,4,3,9,14,5,222,159,0,1,4,17,4,185
2020-01-02,세종,전북,798,15,26,8,21,31,899,716,15,21,23,29,29,833
2020-01-02,세종,충남,5879,135,139,68,124,336,6681,4148,121,155,81,107,223,4835
2020-01-02,세종,충북,336,11,27,19,10,20,423,272,13,12,11,17,17,342
2020-01-02,울산,강원,2,0,0,0,0,0,2,5,0,1,0,0,0,6
2020-01-02,울산,경기,43,2,6,14,64,0,129,40,2,5,6,15,1,69
2020-01-02,울산,경남,10386,483,564,314,477,620,12844,10900,491,554,311,469,651,13376
2020-01-02,울산,경북,5443,119,267,283,1092,319,7523,5778,120,277,364,963,328,7830
2020-01-02,울산,광주,50,0,7,5,3,2,67,54,2,6,1,5,2,70
2020-01-02,울산,대구,1341,53,125,70,170,75,1834,1477,44,134,60,127,86,1928
2020-01-02,울산,대전,90,0,11,8,27,2,138,100,1,11,16,16,4,148
2020-01-02,울산,부산,17456,340,311,367,1996,1200,21670,18824,356,407,541,2112,1204,23444
2020-01-02,울산,서울,36,1,6,2,7,1,53,35,0,0,0,0,1,36
2020-01-02,울산,세종,15,0,0,1,7,0,23,12,0,0,4,4,2,22
2020-01-02,울산,울산,7849,189,320,190,429,704,9681,7849,189,320,190,429,704,9681
2020-01-02,울산,전남,365,6,17,15,24,7,434,264,12,20,6,16,8,326
2020-01-02,울산,전북,62,0,9,1,14,1,87,64,0,7,1,2,1,75
2020-01-02,울산,충남,157,6,14,32,100,4,313,109,3,11,20,87,4,234
2020-01-02,울산,충북,27,3,1,11,39,1,82,28,1,0,6,20,2,57
2020-01-02,전남,강원,60,0,0,6,6,0,72,64,2,2,2,13,0,83
2020-01-02,전남,경기,868,20,78,114,116,28,1224,861,20,92,113,114,22,1222
2020-01-02,전남,경남,6691,249,420,403,1112,269,9144,6813,254,435,477,1145,285,9409
2020-01-02,전남,경북,1224,43,72,83,462,36,1920,1287,42,59,112,392,37,1929
2020-01-02,전남,광주,31932,892,1014,730,1189,1321,37078,34804,922,1267,831,1393,1376,40593
2020-01-02,전남,대구,526,14,31,41,66,17,695,615,11,38,22,42,17,745
2020-01-02,전남,대전,343,9,14,17,18,8,409,323,6,11,29,34,12,415
2020-01-02,전남,부산,1953,74,122,141,501,71,2862,2437,75,116,157,456,98,3339
2020-01-02,전남,서울,936,14,36,69,50,26,1131,970,9,26,31,18,32,1086
2020-01-02,전남,세종,159,0,1,4,17,4,185,187,4,3,9,14,5,222
2020-01-02,전남,울산,264,12,20,6,16,8,326,365,6,17,15,24,7,434
2020-01-02,전남,전남,46725,1196,1542,1644,3792,1927,56826,46725,1196,1542,1644,3792,1927,56826
2020-01-02,전남,전북,5367,254,486,503,1130,174,7914,5488,236,457,481,1116,162,7940
2020-01-02,전남,충남,4795,91,452,763,1284,145,7530,4873,68,454,394,852,140,6781
2020-01-02,전남,충북,476,14,33,75,207,18,823,463,22,45,86,216,13,845
2020-01-02,전북,강원,208,8,15,13,15,7,266,165,3,9,7,11,5,200
2020-01-02,전북,경기,1530,52,145,155,174,59,2115,1466,49,150,113,154,47,1979
2020-01-02,전북,경남,1663,30,140,102,93,43,2071,1607,33,137,92,98,51,2018
2020-01-02,전북,경북,1698,84,163,136,186,47,2314,1966,81,175,160,184,61,2627
2020-01-02,전북,광주,7842,415,441,246,330,320,9594,8210,393,514,325,373,335,10150
2020-01-02,전북,대구,324,12,35,20,15,12,418,411,13,35,7,17,18,501
2020-01-02,전북,대전,3066,95,79,60,30,176,3506,3384,83,79,63,30,165,3804
2020-01-02,전북,부산,401,9,31,24,50,6,521,485,6,33,24,83,13,644
2020-01-02,전북,서울,1300,20,50,28,27,37,1462,1465,14,51,14,27,31,1602
2020-01-02,전북,세종,716,15,21,23,29,29,833,798,15,26,8,21,31,899
2020-01-02,전북,울산,64,0,7,1,2,1,75,62,0,9,1,14,1,87
2020-01-02,전북,전남,5488,236,457,481,1116,162,7940,5367,254,486,503,1130,174,7914
2020-01-02,전북,전북,15300,603,890,652,722,569,18736,15300,603,890,652,722,569,18736
2020-01-02,전북,충남,13918,488,1480,1024,1211,476,18597,13514,477,1436,727,1095,484,17733
2020-01-02,전북,충북,1890,103,162,248,242,64,2709,1846,116,191,255,207,51,2666
2020-01-02,충남,강원,558,8,23,18,68,17,692,523,7,16,17,18,17,598
2020-01-02,충남,경기,34624,1328,2434,1857,3500,1841,45584,37160,1394,2529,2035,3624,1954,48696
2020-01-02,충남,경남,1760,37,147,201,351,58,2554,1431,32,84,187,181,39,1954
2020-01-02,충남,경북,3341,104,265,298,593,128,4729,3272,107,277,396,481,113,4646
2020-01-02,충남,광주,3829,85,505,352,207,124,5102,4144,76,515,334,198,108,5375
2020-01-02,충남,대구,1059,45,71,106,125,41,1447,1795,48,115,158,226,53,2395
2020-01-02,충남,대전,13684,405,463,208,274,1072,16106,16218,423,508,187,305,1182,18823
2020-01-02,충남,부산,141,7,12,36,120,2,318,219,8,14,52,107,3,403
2020-01-02,충남,서울,25645,603,2289,1205,1052,994,31788,26852,459,2253,609,599,1104,31876
2020-01-02,충남,세종,4148,121,155,81,107,223,4835,5879,135,139,68,124,336,6681
2020-01-02,충남,울산,109,3,11,20,87,4,234,157,6,14,32,100,4,313
2020-01-02,충남,전남,4873,68,454,394,852,140,6781,4795,91,452,763,1284,145,7530
2020-01-02,충남,전북,13514,477,1436,727,1095,484,17733,13918,488,1480,1024,1211,476,18597
2020-01-02,충남,충남,96199,3298,7587,5888,8583,4605,126160,96199,3298,7587,5888,8583,4605,126160
2020-01-02,충남,충북,12862,615,815,830,1213,777,17112,11679,584,801,731,1208,697,15700
2020-01-02,충북,강원,5058,186,274,143,195,276,6132,5044,203,264,178,292,289,6270
2020-01-02,충북,경기,26238,1964,2564,2489,2869,1314,37438,27980,2067,2753,2670,2824,1356,39650
2020-01-02,충북,경남,1593,58,172,313,406,58,2600,1299,40,119,206,237,48,1949
2020-01-02,충북,경북,5143,212,473,481,770,212,7291,5413,223,448,550,776,230,7640
2020-01-02,충북,광주,652,26,67,120,46,18,929,652,26,63,81,47,21,890
2020-01-02,충북,대구,1352,79,135,140,83,33,1822,2113,74,194,207,320,76,2984
2020-01-02,충북,대전,9313,365,378,146,134,701,11037,10939,442,424,175,146,796,12922
2020-01-02,충북,부산,110,13,15,58,139,3,338,153,11,16,55,180,5,420
2020-01-02,충북,서울,12400,612,1166,649,573,531,15931,14725,517,1147,579,492,659,18119
2020-01-02,충북,세종,272,13,12,11,17,17,342,336,11,27,19,10,20,423
2020-01-02,충북,울산,28,1,0,6,20,2,57,27,3,1,11,39,1,82
2020-01-02,충북,전남,463,22,45,86,216,13,845,476,14,33,75,207,18,823
2020-01-02,충북,전북,1846,116,191,255,207,51,2666,1890,103,162,248,242,64,2709
2020-01-02,충북,충남,11679,584,801,731,1208,697,15700,12862,615,815,830,1213,777,17112
2020-01-02,충북,충북,34950,1830,2245,1990,2476,2165,45656,34950,1830,2245,1990,2476,2165,45656
2020-01-03,강원,강원,82402,2325,3321,1478,2385,5003,96914,82402,2325,3321,1478,2385,5003,96914
2020-01-03,강원,경기,24496,609,1292,685,723,1173,28978,29878,650,1341,748,836,1248,34701
2020-01-03,강원,경남,286,3,13,9,20,14,345,176,2,9,23,11,8,229
2020-01-03,강원,경북,784,22,42,19,16,28,911,700,16,30,23,25,22,816
2020-01-03,강원,광주,126,2,23,8,8,2,169,128,1,13,13,5,1,161
2020-01-03,강원,대구,367,4,10,12,10,9,412,564,9,19,19,20,14,645
2020-01-03,강원,대전,240,5,28,6,0,8,287,267,5,31,5,2,9,319
2020-01-03,강원,부산,7,0,0,0,1,0,8,3,0,0,4,1,0,8
2020-01-03,강원,서울,766,14,313,11,20,34,1158,1213,17,281,9,6,44,1570
2020-01-03,강원,세종,10,0,0,0,1,0,11,10,0,0,0,1,0,11
2020-01-03,강원,울산,3,0,0,0,1,0,4,3,0,0,1,1,0,5
2020-01-03,강원,전남,87,0,4,4,13,2,110,85,1,2,10,12,2,112
2020-01-03,강원,전북,217,3,18,7,16,5,266,246,6,15,16,13,4,300
2020-01-03,강원,충남,487,7,16,19,23,15,567,694,13,19,42,57,33,858
2020-01-03,강원,충북,5642,211,297,197,351,336,7034,5987,198,269,205,254,320,7233
2020-01-03,경기,강원,29878,650,1341,748,836,1248,34701,24496,609,1292,685,723,1173,28978
2020-01-03,경기,경기,428109,23532,25356,19613,24706,31863,553179,428109,23532,25356,19613,24706,31863,553179
2020-01-03,경기,경남,3367,136,373,918,671,93,5558,2303,84,287,638,400,80,3792
2020-01-03,경기,경북,5297,190,530,769,607,183,7576,4910,213,546,882,606,162,7319
2020-01-03,경기,광주,1155,35,189,363,200,45,1987,882,32,138,228,115,27,1422
2020-01-03,경기,대구,2643,133,236,411,265,82,3770,3170,138,270,493,526,109,4706
2020-01-03,경기,대전,2664,143,227,130,60,115,3339,2157,120,202,112,59,103,2753
2020-01-03,경기,부산,212,30,40,223,144,9,658,326,27,44,177,297,8,879
2020-01-03,경기,서울,145822,7666,9204,5084,3551,9866,181193,141812,7254,9602,4805,3295,9507,176275
2020-01-03,경기,세종,68,6,3,4,3,4,88,74,5,4,4,2,6,95
2020-01-03,경기,울산,35,4,3,12,20,1,75,52,3,4,40,111,5,215
2020-01-03,경기,전남,1097,23,123,217,194,36,1690,1007,28,110,176,132,30,1483
2020-01-03,경기,전북,2029,54,185,166,207,56,2697,1646,51,159,231,187,50,2324
2020-01-03,경기,충남,40201,1641,3033,2477,4373,2061,53786,40779,1539,2760,2418,4043,2080,53619
2020-01-03,경기,충북,30406,2186,3029,3184,3503,1548,43856,29541,2139,2896,2916,3579,1492,42563
2020-01-03,경남,강원,176,2,9,23,11,8,229,286,3,13,9,20,14,345
2020-01-03,경남,경기,2303,84,287,638,400,80,3792,3367,136,373,918,671,93,5558
2020-01-03,경남,경남,203956,10376,10487,7632,12528,15372,260351,203956,10376,10487,7632,12528,15372,260351
2020-01-03,경남,경북,12544,628,964,901,1754,578,17369,16458,895,1264,1292,2763,762,23434
2020-01-03,경남,광주,1572,61,141,233,126,42,2175,1535,53,159,152,107,49,2055
2020-01-03,경남,대구,16148,836,1064,1078,1675,654,21455,12313,566,814,440,514,513,15160
2020-01-03,경남,대전,1005,28,121,91,38,46,1329,1291,39,121,136,77,58,1722
2020-01-03,경남,부산,94308,2792,3058,1747,4594,6592,113091,90225,2868,3175,1781,4544,6292,108885
2020-01-03,경남,서울,2128,47,534,327,124,63,3223,2916,66,487,211,125,73,3878
2020-01-03,경남,세종,238,2,12,7,6,10,275,314,2,28,22,18,14,398
2020-01-03,경남,울산,11606,600,652,408,571,694,14531,10858,534,667,364,604,658,13685
2020-01-03,경남,전남,7088,273,508,561,1392,316,10138,7959,312,522,525,1331,316,10965
2020-01-03,경남,전북,1824,54,140,115,141,68,2342,1803,61,139,103,136,57,2299
2020-01-03,경남,충남,1470,53,128,275,227,51,2204,2210,74,184,378,596,64,3506
2020-01-03,경남,충북,1335,57,152,271,252,44,2111,2041,84,240,574,599,79,3617
2020-01-03,경북,강원,700,16,30,23,25,22,816,784,22,42,19,16,28,911
2020-01-03,경북,경기,4910,213,546,882,606,162,7319,5297,190,530,769,607,183,7576
2020-01-03,경북,경남,16458,895,1264,1292,2763,762,23434,12544,628,964,901,1754,578,17369
2020-01-03,경북,경북,81495,3821,4288,2804,5021,4508,101937,81495,3821,4288,2804,5021,4508,101937
2020-01-03,경북,광주,1223,47,145,191,126,28,1760,1030,49,99,166,74,23,1441
2020-01-03,경북,대구,78041,2936,2844,1486,2845,4169,92321,78381,3090,3305,1810,3268,4214,94068
2020-01-03,경북,대전,2147,61,120,121,73,106,2628,2001,57,120,142,68,100,2488
2020-01-03,경북,부산,5672,120,338,219,670,255,7274,5777,149,365,231,788,236,7546
2020-01-03,경북,서울,3058,110,416,416,155,111,4266,3489,90,376,239,112,103,4409
2020-01-03,경북,세종,329,6,20,19,16,13,403,323,9,25,16,17,12,402
2020-01-03,경북,울산,6015,174,306,398,1104,344,8341,5885,167,312,308,1323,350,8345
2020-01-03,경북,전남,1371,50,86,141,490,46,2184,1411,47,98,126,581,45,2308
2020-01-03,경북,전북,2095,86,195,189,222,67,2854,1853,84,192,162,252,62,2605
2020-01-03,경북,충남,3523,137,328,495,599,118,5200,4076,142,316,455,780,169,5938
2020-01-03,경북,충북,6126,242,533,691,891,268,8751,6237,245,593,674,1006,269,9024
2020-01-03,광주,강원,128,1,13,13,5,1,161,126,2,23,8,8,2,169
2020-01-03,광주,경기,882,32,138,228,115,27,1422,1155,35,189,363,200,45,1987
2020-01-03,광주,경남,1535,53,159,152,107,49,2055,1572,61,141,233,126,42,2175
2020-01-03,광주,경북,1030,49,99,166,74,23,1441,1223,47,145,191,126,28,1760
2020-01-03,광주,광주,13251,496,674,366,255,589,15631,13251,496,674,366,255,589,15631
2020-01-03,광주,대구,741,24,99,88,35,22,1009,715,33,111,74,33,20,986
2020-01-03,광주,대전,514,19,18,35,21,22,629,532,21,25,30,21,21,650
2020-01-03,광주,부산,475,9,54,42,67,12,659,553,15,61,67,120,16,832
2020-01-03,광주,서울,753,22,31,65,25,23,919,1034,26,36,53,22,25,1196
2020-01-03,광주,세종,142,3,10,6,1,4,166,216,4,9,6,4,5,244
2020-01-03,광주,울산,61,0,8,1,7,1,78,69,0,7,3,12,4,95
2020-01-03,광주,전남,34609,995,1315,824,1990,1377,41110,35414,995,1134,704,1937,1400,41584
2020-01-03,광주,전북,8544,450,594,372,399,327,10686,9109,466,526,330,370,346,11147
2020-01-03,광주,충남,4392,113,616,416,291,126,5954,5063,140,635,669,416,134,7057
2020-01-03,광주,충북,647,26,66,107,55,13,914,860,30,99,184,107,34,1314
2020-01-03,대구,강원,564,9,19,19,20,14,645,367,4,10,12,10,9,412
2020-01-03,대구,경기,3170,138,270,493,526,109,4706,2643,133,236,411,265,82,3770
2020-01-03,대구,경남,12313,566,814,440,514,513,15160,16148,836,1064,1078,1675,654,21455
2020-01-03,대구,경북,78381,3090,3305,1810,3268,4214,94068,78041,2936,2844,1486,2845,4169,92321
2020-01-03,대구,광주,715,33,111,74,33,20,986,741,24,99,88,35,22,1009
2020-01-03,대구,대구,60508,2179,1778,798,1255,3994,70512,60508,2179,1778,798,1255,3994,70512
2020-01-03,대구,대전,1048,38,69,88,44,53,1340,831,33,47,53,29,41,1034
2020-01-03,대구,부산,637,61,98,62,167,29,1054,3370,97,243,98,285,138,4231
2020-01-03,대구,서울,2693,95,243,269,120,64,3484,1926,63,175,140,68,52,2424
2020-01-03,대구,세종,298,2,17,4,5,10,336,205,5,7,3,7,8,235
2020-01-03,대구,울산,1489,55,137,72,166,53,1972,1669,64,146,72,197,85,2233
2020-01-03,대구,전남,644,14,52,51,55,24,840,743,22,40,58,76,25,964
2020-01-03,대구,전북,478,18,43,11,27,10,587,489,12,42,19,32,19,613
2020-01-03,대구,충남,1657,79,166,220,244,46,2412,1539,62,118,173,206,53,2151
2020-01-03,대구,충북,2119,93,247,287,379,80,3205,1944,86,156,252,146,69,2653
2020-01-03,대전,강원,267,5,31,5,2,9,319,240,5,28,6,0,8,287
2020-01-03,대전,경기,2157,120,202,112,59,103,2753,2664,143,227,130,60,115,3339
2020-01-03,대전,경남,1291,39,121,136,77,58,1722,1005,28,121,91,38,46,1329
2020-01-03,대전,경북,2001,57,120,142,68,100,2488,2147,61,120,121,73,106,2628
2020-01-03,대전,광주,532,21,25,30,21,21,650,514,19,18,35,21,22,629
2020-01-03,대전,대구,831,33,47,53,29,41,1034,1048,38,69,88,44,53,1340
2020-01-03,대전,대전,14046,422,437,302,194,1079,16480,14046,422,437,302,194,1079,16480
2020-01-03,대전,부산,74,4,10,17,12,0,117,104,4,11,16,18,2,155
2020-01-03,대전,서울,1746,49,212,38,11,72,2128,2000,53,225,45,8,80,2411
2020-01-03,대전,세종,3498,121,93,27,90,299,4128,3463,124,92,26,108,275,4088
2020-01-03,대전,울산,106,2,11,17,25,3,164,123,1,10,14,30,6,184
2020-01-03,대전,전남,379,11,6,34,26,18,474,424,9,13,39,25,17,527
2020-01-03,대전,전북,3546,76,111,105,51,142,4031,3566,92,100,79,41,159,4037
2020-01-03,대전,충남,16265,479,571,257,247,1233,19052,15471,452,549,231,244,1150,18097
2020-01-03,대전,충북,10904,479,472,211,156,802,13024,10449,401,446,176,125,766,12363
2020-01-03,부산,강원,3,0,0,4,1,0,8,7,0,0,0,1,0,8
2020-01-03,부산,경기,326,27,44,177,297,8,879,212,30,40,223,144,9,658
2020-01-03,부산,경남,90225,2868,3175,1781,4544,6292,108885,94308,2792,3058,1747,4594,6592,113091
2020-01-03,부산,경북,5777,149,365,231,788,236,7546,5672,120,338,219,670,255,7274
2020-01-03,부산,광주,553,15,61,67,120,16,832,475,9,54,42,67,12,659
2020-01-03,부산,대구,3370,97,243,98,285,138,4231,637,61,98,62,167,29,1054
2020-01-03,부산,대전,104,4,11,16,18,2,155,74,4,10,17,12,0,117
2020-01-03,부산,부산,44019,733,664,835,1809,3081,51141,44019,733,664,835,1809,3081,51141
2020-01-03,부산,서울,238,16,22,69,94,8,447,185,21,17,63,41,4,331
2020-01-03,부산,세종,24,1,0,4,4,2,35,16,2,1,0,3,0,22
2020-01-03,부산,울산,18043,398,483,618,2433,1239,23214,19113,413,397,442,2218,1331,23914
2020-01-03,부산,전남,2430,91,156,204,528,77,3486,2233,79,129,155,545,81,3222
2020-01-03,부산,전북,470,16,47,46,94,17,690,384,12,25,46,71,8,546
2020-01-03,부산,충남,222,20,16,81,161,7,507,176,9,26,72,145,4,432
2020-01-03,부산,충북,154,17,28,98,209,5,511,111,24,34,126,171,3,469
2020-01-03,서울,강원,1213,17,281,9,6,44,1570,766,14,313,11,20,34,1158
2020-01-03,서울,경기,141812,7254,9602,4805,3295,9507,176275,145822,7666,9204,5084,3551,9866,181193
2020-01-03,서울,경남,2916,66,487,211,125,73,3878,2128,47,534,327,124,63,3223
2020-01-03,서울,경북,3489,90,376,239,112,103,4409,3058,110,416,416,155,111,4266
2020-01-03,서울,광주,1034,26,36,53,22,25,1196,753,22,31,65,25,23,919
2020-01-03,서울,대구,1926,63,175,140,68,52,2424,2693,95,243,269,120,64,3484
2020-01-03,서울,대전,2000,53,225,45,8,80,2411,1746,49,212,38,11,72,2128
2020-01-03,서울,부산,185,21,17,63,41,4,331,238,16,22,69,94,8,447
2020-01-03,서울,서울,181,4,7,1,3,11,207,181,4,7,1,3,11,207
2020-01-03,서울,세종,50,0,1,1,1,2,55,39,0,2,1,0,3,45
2020-01-03,서울,울산,21,2,1,5,1,0,30,31,1,4,9,13,1,59
2020-01-03,서울,전남,1141,8,30,49,43,27,1298,963,15,24,94,54,35,1185
2020-01-03,서울,전북,1785,27,48,28,19,46,1953,1395,34,52,45,20,40,1586
2020-01-03,서울,충남,28205,574,2597,904,721,1100,34101,27641,676,2590,1397,1204,1146,34654
2020-01-03,서울,충북,14754,590,1261,829,655,661,18750,14718,673,1238,853,763,613,18858
2020-01-03,세종,강원,10,0,0,0,1,0,11,10,0,0,0,1,0,11
2020-01-03,세종,경기,74,5,4,4,2,6,95,68,6,3,4,3,4,88
2020-01-03,세종,경남,314,2,28,22,18,14,398,238,2,12,7,6,10,275
2020-01-03,세종,경북,323,9,25,16,17,12,402,329,6,20,19,16,13,403
2020-01-03,세종,광주,216,4,9,6,4,5,244,142,3,10,6,1,4,166
2020-01-03,세종,대구,205,5,7,3,7,8,235,298,2,17,4,5,10,336
2020-01-03,세종,대전,3463,124,92,26,108,275,4088,3498,121,93,27,90,299,4128
2020-01-03,세종,부산,16,2,1,0,3,0,22,24,1,0,4,4,2,35
2020-01-03,세종,서울,39,0,2,1,0,3,45,50,0,1,1,1,2,55
2020-01-03,세종,세종,260,26,2,2,1,27,318,260,26,2,2,1,27,318
2020-01-03,세종,울산,13,0,0,3,4,0,20,11,1,0,3,8,0,23
2020-01-03,세종,전남,222,4,6,13,14,6,265,217,1,0,11,27,3,259
2020-01-03,세종,전북,872,23,39,18,40,35,1027,848,16,37,19,42,27,989
2020-01-03,세종,충남,5990,161,141,105,169,350,6916,5177,159,165,84,164,269,6018
2020-01-03,세종,충북,354,9,15,20,19,22,439,314,18,17,13,11,26,399
2020-01-03,울산,강원,3,0,0,1,1,0,5,3,0,0,0,1,0,4
2020-01-03,울산,경기,52,3,4,40,111,5,215,35,4,3,12,20,1,75
2020-01-03,울산,경남,10858,534,667,364,604,658,13685,11606,600,652,408,571,694,14531
2020-01-03,울산,경북,5885,167,312,308,1323,350,8345,6015,174,306,398,1104,344,8341
2020-01-03,울산,광주,69,0,7,3,12,4,95,61,0,8,1,7,1,78
2020-01-03,울산,대구,1669,64,146,72,197,85,2233,1489,55,137,72,166,53,1972
2020-01-03,울산,대전,123,1,10,14,30,6,184,106,2,11,17,25,3,164
2020-01-03,울산,부산,19113,413,397,442,2218,1331,23914,18043,398,483,618,2433,1239,23214
2020-01-03,울산,서울,31,1,4,9,13,1,59,21,2,1,5,1,0,30
2020-01-03,울산,세종,11,1,0,3,8,0,23,13,0,0,3,4,0,20
2020-01-03,울산,울산,8229,284,429,254,486,738,10420,8229,284,429,254,486,738,10420
2020-01-03,울산,전남,320,12,23,8,31,4,398,336,21,20,9,27,6,419
2020-01-03,울산,전북,75,0,9,3,14,4,105,64,1,8,3,4,2,82
2020-01-03,울산,충남,154,3,22,43,147,1,370,153,3,15,39,119,1,330
2020-01-03,울산,충북,38,2,6,19,61,0,126,24,1,4,18,41,0,88
2020-01-03,전남,강원,85,1,2,10,12,2,112,87,0,4,4,13,2,110
2020-01-03,전남,경기,1007,28,110,176,132,30,1483,1097,23,123,217,194,36,1690
2020-01-03,전남,경남,7959,312,522,525,1331,316,10965,7088,273,508,561,1392,316,10138
2020-01-03,전남,경북,1411,47,98,126,581,45,2308,1371,50,86,141,490,46,2184
2020-01-03,전남,광주,35414,995,1134,704,1937,1400,41584,34609,995,1315,824,1990,1377,41110
2020-01-03,전남,대구,743,22,40,58,76,25,964,644,14,52,51,55,24,840
2020-01-03,전남,대전,424,9,13,39,25,17,527,379,11,6,34,26,18,474
2020-01-03,전남,부산,2233,79,129,155,545,81,3222,2430,91,156,204,528,77,3486
2020-01-03,전남,서울,963,15,24,94,54,35,1185,1141,8,30,49,43,27,1298
2020-01-03,전남,세종,217,1,0,11,27,3,259,222,4,6,13,14,6,265
2020-01-03,전남,울산,336,21,20,9,27,6,419,320,12,23,8,31,4,398
2020-01-03,전남,전남,50856,1343,1817,2111,4624,2015,62766,50856,1343,1817,2111,4624,2015,62766
2020-01-03,전남,전북,6313,269,522,621,1270,194,9189,5583,233,474,588,1243,170,8291
2020-01-03,전남,충남,5479,108,486,795,1179,148,8195,5865,107,547,603,1071,135,8328
2020-01-03,전남,충북,550,20,42,105,306,17,1040,558,19,49,121,264,13,1024
2020-01-03,전북,강원,246,6,15,16,13,4,300,217,3,18,7,16,5,266
2020-01-03,전북,경기,1646,51,159,231,187,50,2324,2029,54,185,166,207,56,2697
2020-01-03,전북,경남,1803,61,139,103,136,57,2299,1824,54,140,115,141,68,2342
2020-01-03,전북,경북,1853,84,192,162,252,62,2605,2095,86,195,189,222,67,2854
2020-01-03,전북,광주,9109,466,526,330,370,346,11147,8544,450,594,372,399,327,10686
2020-01-03,전북,대구,489,12,42,19,32,19,613,478,18,43,11,27,10,587
2020-01-03,전북,대전,3566,92,100,79,41,159,4037,3546,76,111,105,51,142,4031
2020-01-03,전북,부산,384,12,25,46,71,8,546,470,16,47,46,94,17,690
2020-01-03,전북,서울,1395,34,52,45,20,40,1586,1785,27,48,28,19,46,1953
2020-01-03,전북,세종,848,16,37,19,42,27,989,872,23,39,18,40,35,1027
2020-01-03,전북,울산,64,1,8,3,4,2,82,75,0,9,3,14,4,105
2020-01-03,전북,전남,5583,233,474,588,1243,170,8291,6313,269,522,621,1270,194,9189
2020-01-03,전북,전북,16627,685,978,547,782,647,20266,16627,685,978,547,782,647,20266
2020-01-03,전북,충남,15260,526,1639,1144,1245,532,20346,16707,515,1611,1023,1329,605,21790
2020-01-03,전북,충북,2117,131,208,284,282,74,3096,2350,113,240,283,275,81,3342
2020-01-03,충남,강원,694,13,19,42,57,33,858,487,7,16,19,23,15,567
2020-01-03,충남,경기,40779,1539,2760,2418,4043,2080,53619,40201,1641,3033,2477,4373,2061,53786
2020-01-03,충남,경남,2210,74,184,378,596,64,3506,1470,53,128,275,227,51,2204
2020-01-03,충남,경북,4076,142,316,455,780,169,5938,3523,137,328,495,599,118,5200
2020-01-03,충남,광주,5063,140,635,669,416,134,7057,4392,113,616,416,291,126,5954
2020-01-03,충남,대구,1539,62,118,173,206,53,2151,1657,79,166,220,244,46,2412
2020-01-03,충남,대전,15471,452,549,231,244,1150,18097,16265,479,571,257,247,1233,19052
2020-01-03,충남,부산,176,9,26,72,145,4,432,222,20,16,81,161,7,507
2020-01-03,충남,서울,27641,676,2590,1397,1204,1146,34654,28205,574,2597,904,721,1100,34101
2020-01-03,충남,세종,5177,159,165,84,164,269,6018,5990,161,141,105,169,350,6916
2020-01-03,충남,울산,153,3,15,39,119,1,330,154,3,22,43,147,1,370
2020-01-03,충남,전남,5865,107,547,603,1071,135,8328,5479,108,486,795,1179,148,8195
2020-01-03,충남,전북,16707,515,1611,1023,1329,605,21790,15260,526,1639,1144,1245,532,20346
2020-01-03,충남,충남,105178,3810,8561,7069,10328,5012,139958,105178,3810,8561,7069,10328,5012,139958
2020-01-03,충남,충북,14250,674,965,960,1472,876,19197,12765,632,886,871,1436,737,17327
2020-01-03,충북,강원,5987,198,269,205,254,320,7233,5642,211,297,197,351,336,7034
2020-01-03,충북,경기,29541,2139,2896,2916,3579,1492,42563,30406,2186,3029,3184,3503,1548,43856
2020-01-03,충북,경남,2041,84,240,574,599,79,3617,1335,57,152,271,252,44,2111
2020-01-03,충북,경북,6237,245,593,674,1006,269,9024,6126,242,533,691,891,268,8751
2020-01-03,충북,광주,860,30,99,184,107,34,1314,647,26,66,107,55,13,914
2020-01-03,충북,대구,1944,86,156,252,146,69,2653,2119,93,247,287,379,80,3205
2020-01-03,충북,대전,10449,401,446,176,125,766,12363,10904,479,472,211,156,802,13024
2020-01-03,충북,부산,111,24,34,126,171,3,469,154,17,28,98,209,5,511
2020-01-03,충북,서울,14718,673,1238,853,763,613,18858,14754,590,1261,829,655,661,18750
2020-01-03,충북,세종,314,18,17,13,11,26,399,354,9,15,20,19,22,439
2020-01-03,충북,울산,24,1,4,18,41,0,88,38,2,6,19,61,0,126
2020-01-03,충북,전남,558,19,49,121,264,13,1024,550,20,42,105,306,17,1040
2020-01-03,충북,전북,2350,113,240,283,275,81,3342,2117,131,208,284,282,74,3096
2020-01-03,충북,충남,12765,632,886,871,1436,737,17327,14250,674,965,960,1472,876,19197
2020-01-03,충북,충북,37928,2016,2302,2185,2894,2286,49611,37928,2016,2302,2185,2894,2286,49611
2020-01-04,강원,강원,101136,1561,2832,866,2052,5001,113448,101136,1561,2832,866,2052,5001,113448
2020-01-04,강원,경기,33191,343,1265,355,423,1366,36943,43307,388,1196,406,548,1733,47578
2020-01-04,강원,경남,287,4,19,7,6,10,333,191,1,13,7,2,7,221
2020-01-04,강원,경북,916,18,40,10,4,35,1023,847,6,38,23,5,33,952
2020-01-04,강원,광주,118,2,18,4,6,5,153,98,1,17,6,2,3,127
2020-01-04,강원,대구,462,1,12,4,3,12,494,627,3,23,8,4,17,682
2020-01-04,강원,대전,247,1,29,2,1,8,288,312,1,35,1,1,12,362
2020-01-04,강원,부산,9,0,1,0,1,0,11,8,0,0,0,0,0,8
2020-01-04,강원,서울,948,6,347,5,8,30,1344,1249,12,315,5,6,41,1628
2020-01-04,강원,세종,7,0,0,0,2,2,11,16,0,0,0,1,3,20
2020-01-04,강원,울산,3,0,0,0,0,0,3,1,0,2,0,0,0,3
2020-01-04,강원,전남,73,0,4,1,7,3,88,81,1,2,5,6,1,96
2020-01-04,강원,전북,249,0,18,5,5,8,285,188,5,13,16,11,5,238
2020-01-04,강원,충남,500,6,28,10,19,19,582,735,7,34,27,50,24,877
2020-01-04,강원,충북,5955,139,216,131,201,307,6949,6998,125,213,140,193,299,7968
2020-01-04,경기,강원,43307,388,1196,406,548,1733,47578,33191,343,1265,355,423,1366,36943
2020-01-04,경기,경기,360909,10618,12850,8963,13383,22796,429519,360909,10618,12850,8963,13383,22796,429519
2020-01-04,경기,경남,3710,58,305,592,410,134,5209,2444,39,195,329,213,84,3304
2020-01-04,경기,경북,6800,84,302,463,342,220,8211,5084,78,255,433,300,196,6346
2020-01-04,경기,광주,1267,9,142,173,78,35,1704,1003,5,107,115,46,33,1309
2020-01-04,경기,대구,2830,32,155,282,140,83,3522,3151,57,168,237,168,105,3886
2020-01-04,경기,대전,3272,62,192,89,28,110,3753,2856,58,198,58,24,127,3321
2020-01-04,경기,부산,345,19,43,168,114,13,702,336,12,15,91,96,12,562
2020-01-04,경기,서울,128869,4212,5798,2839,2182,7596,151496,124874,3629,5741,2145,1912,7239,145540
2020-01-04,경기,세종,53,2,1,1,5,1,63,75,2,2,2,7,0,88
2020-01-04,경기,울산,39,0,6,6,19,1,71,46,4,1,7,29,1,88
2020-01-04,경기,전남,1381,12,97,115,87,37,1729,1099,10,61,84,57,28,1339
2020-01-04,경기,전북,2685,31,133,64,105,90,3108,1995,20,101,72,97,65,2350
2020-01-04,경기,충남,45666,741,1795,1154,1846,2063,53265,42826,697,1866,1118,1766,1980,50253
2020-01-04,경기,충북,32269,914,1563,1414,1764,1501,39425,29603,888,1461,1356,1733,1409,36450
2020-01-04,경남,강원,191,1,13,7,2,7,221,287,4,19,7,6,10,333
2020-01-04,경남,경기,2444,39,195,329,213,84,3304,3710,58,305,592,410,134,5209
2020-01-04,경남,경남,190471,6014,6308,3744,8098,12448,227083,190471,6014,6308,3744,8098,12448,227083
2020-01-04,경남,경북,17264,288,588,460,879,762,20241,19961,376,769,676,1325,902,24009
2020-01-04,경남,광주,1783,25,130,107,61,58,2164,1976,22,123,84,32,54,2291
2020-01-04,경남,대구,18476,379,836,546,659,831,21727,15999,302,603,282,258,697,18141
2020-01-04,경남,대전,1251,18,93,34,21,43,1460,1791,15,111,82,34,63,2096
2020-01-04,경남,부산,93859,1597,2255,1239,2428,5891,107269,90271,1595,2181,1091,2368,5671,103177
2020-01-04,경남,서울,2179,20,477,132,75,56,2939,3384,34,579,152,78,112,4339
2020-01-04,경남,세종,250,1,10,4,5,9,279,417,2,19,5,11,14,468
2020-01-04,경남,울산,12666,323,353,179,266,706,14493,12065,331,388,181,239,661,13865
2020-01-04,경남,전남,8539,137,339,268,754,341,10378,8438,156,354,251,700,338,10237
2020-01-04,경남,전북,2600,21,126,51,74,75,2947,2258,21,113,54,62,61,2569
2020-01-04,경남,충남,1563,15,77,86,114,65,1920,2357,21,104,173,311,74,3040
2020-01-04,경남,충북,1555,24,84,105,127,62,1957,2255,49,138,309,374,67,3192
2020-01-04,경북,강원,847,6,38,23,5,33,952,916,18,40,10,4,35,1023
2020-01-04,경북,경기,5084,78,255,433,300,196,6346,6800,84,302,463,342,220,8211
2020-01-04,경북,경남,19961,376,769,676,1325,902,24009,17264,288,588,460,879,762,20241
2020-01-04,경북,경북,86778,2277,2812,1467,3214,4063,100611,86778,2277,2812,1467,3214,4063,100611
2020-01-04,경북,광주,1100,21,84,85,51,28,1369,1159,23,58,96,42,30,1408
2020-01-04,경북,대구,75231,1787,2021,914,2259,3604,85816,80612,1842,2203,1081,2077,3759,91574
2020-01-04,경북,대전,2564,36,95,55,52,129,2931,2778,25,91,84,34,142,3154
2020-01-04,경북,부산,7833,67,313,79,266,376,8934,9126,71,323,107,322,373,10322
2020-01-04,경북,서울,3572,47,351,161,81,94,4306,4889,38,346,134,88,142,5637
2020-01-04,경북,세종,326,0,9,8,8,10,361,392,3,12,10,3,12,432
2020-01-04,경북,울산,7285,67,186,225,619,357,8739,7449,69,178,148,774,386,9004
2020-01-04,경북,전남,1665,21,68,61,268,52,2135,1655,27,60,69,348,47,2206
2020-01-04,경북,전북,2382,48,111,80,104,73,2798,2108,51,107,55,105,68,2494
2020-01-04,경북,충남,3890,59,131,193,279,140,4692,4812,47,177,199,401,154,5790
2020-01-04,경북,충북,7317,134,315,328,483,313,8890,7910,127,345,357,612,300,9651
2020-01-04,광주,강원,98,1,17,6,2,3,127,118,2,18,4,6,5,153
2020-01-04,광주,경기,1003,5,107,115,46,33,1309,1267,9,142,173,78,35,1704
2020-01-04,광주,경남,1976,22,123,84,32,54,2291,1783,25,130,107,61,58,2164
2020-01-04,광주,경북,1159,23,58,96,42,30,1408,1100,21,84,85,51,28,1369
2020-01-04,광주,광주,12239,336,534,223,124,392,13848,12239,336,534,223,124,392,13848
2020-01-04,광주,대구,832,13,86,64,15,21,1031,843,18,103,65,18,22,1069
2020-01-04,광주,대전,690,9,10,15,7,20,751,724,11,12,18,13,30,808
2020-01-04,광주,부산,721,5,45,15,22,23,831,625,11,50,40,44,15,785
2020-01-04,광주,서울,847,10,15,35,8,24,939,1203,9,10,29,12,32,1295
2020-01-04,광주,세종,159,0,6,1,2,3,171,284,2,4,5,5,8,308
2020-01-04,광주,울산,78,0,10,0,1,1,90,71,1,12,2,4,0,90
2020-01-04,광주,전남,39709,662,1093,528,1375,1420,44787,37625,633,918,501,1460,1318,42455
2020-01-04,광주,전북,10170,224,349,190,197,318,11448,9801,257,378,189,221,294,11140
2020-01-04,광주,충남,5415,52,576,193,97,155,6488,5780,52,586,365,239,161,7183
2020-01-04,광주,충북,679,10,46,43,29,28,835,823,13,66,90,67,19,1078
2020-01-04,대구,강원,627,3,23,8,4,17,682,462,1,12,4,3,12,494
2020-01-04,대구,경기,3151,57,168,237,168,105,3886,2830,32,155,282,140,83,3522
2020-01-04,대구,경남,15999,302,603,282,258,697,18141,18476,379,836,546,659,831,21727
2020-01-04,대구,경북,80612,1842,2203,1081,2077,3759,91574,75231,1787,2021,914,2259,3604,85816
2020-01-04,대구,광주,843,18,103,65,18,22,1069,832,13,86,64,15,21,1031
2020-01-04,대구,대구,51603,1294,1189,536,827,3006,58455,51603,1294,1189,536,827,3006,58455
2020-01-04,대구,대전,1464,22,51,40,34,57,1668,974,13,35,31,12,48,1113
2020-01-04,대구,부산,1024,21,87,61,65,37,1295,4414,45,206,40,114,170,4989
2020-01-04,대구,서울,2910,33,255,127,50,95,3470,2150,24,171,85,48,65,2543
2020-01-04,대구,세종,342,2,8,1,5,8,366,301,2,5,0,3,10,321
2020-01-04,대구,울산,2026,32,127,34,94,81,2394,2261,28,122,32,148,96,2687
2020-01-04,대구,전남,829,10,48,13,23,19,942,870,10,38,19,24,25,986
2020-01-04,대구,전북,623,5,42,9,10,18,707,526,7,36,16,10,12,607
2020-01-04,대구,충남,1746,25,79,74,106,54,2084,1462,33,51,92,112,45,1795
2020-01-04,대구,충북,2664,30,161,122,174,82,3233,1983,42,108,191,111,85,2520
2020-01-04,대전,강원,312,1,35,1,1,12,362,247,1,29,2,1,8,288
2020-01-04,대전,경기,2856,58,198,58,24,127,3321,3272,62,192,89,28,110,3753
2020-01-04,대전,경남,1791,15,111,82,34,63,2096,1251,18,93,34,21,43,1460
2020-01-04,대전,경북,2778,25,91,84,34,142,3154,2564,36,95,55,52,129,2931
2020-01-04,대전,광주,724,11,12,18,13,30,808,690,9,10,15,7,20,751
2020-01-04,대전,대구,974,13,35,31,12,48,1113,1464,22,51,40,34,57,1668
2020-01-04,대전,대전,11483,213,266,95,119,807,12983,11483,213,266,95,119,807,12983
2020-01-04,대전,부산,114,0,3,5,8,0,130,120,1,5,11,18,1,156
2020-01-04,대전,서울,2263,20,267,24,7,95,2676,2479,20,266,27,13,114,2919
2020-01-04,대전,세종,3050,62,45,18,151,189,3515,2999,69,40,19,170,213,3510
2020-01-04,대전,울산,128,1,10,11,11,5,166,156,0,10,3,13,8,190
2020-01-04,대전,전남,568,4,7,26,13,17,635,503,3,12,12,18,13,561
2020-01-04,대전,전북,4986,52,92,63,28,214,5435,4745,70,87,35,30,162,5129
2020-01-04,대전,충남,14816,292,364,146,205,928,16751,13912,270,353,133,217,830,15715
2020-01-04,대전,충북,9960,306,343,117,96,602,11424,9267,260,312,113,92,589,10633
2020-01-04,부산,강원,8,0,0,0,0,0,8,9,0,1,0,1,0,11
2020-01-04,부산,경기,336,12,15,91,96,12,562,345,19,43,168,114,13,702
2020-01-04,부산,경남,90271,1595,2181,1091,2368,5671,103177,93859,1597,2255,1239,2428,5891,107269
2020-01-04,부산,경북,9126,71,323,107,322,373,10322,7833,67,313,79,266,376,8934
2020-01-04,부산,광주,625,11,50,40,44,15,785,721,5,45,15,22,23,831
2020-01-04,부산,대구,4414,45,206,40,114,170,4989,1024,21,87,61,65,37,1295
2020-01-04,부산,대전,120,1,5,11,18,1,156,114,0,3,5,8,0,130
2020-01-04,부산,부산,48069,379,355,379,1208,2766,53156,48069,379,355,379,1208,2766,53156
2020-01-04,부산,서울,296,5,7,38,29,11,386,270,8,27,54,21,6,386
2020-01-04,부산,세종,25,2,1,3,1,1,33,37,1,0,2,1,0,41
2020-01-04,부산,울산,19909,214,232,253,1006,1150,22764,21185,220,193,194,985,1230,24007
2020-01-04,부산,전남,2739,38,130,102,312,93,3414,2447,32,84,74,296,89,3022
2020-01-04,부산,전북,637,7,46,12,38,16,756,461,5,43,16,26,8,559
2020-01-04,부산,충남,232,3,17,16,44,8,320,220,5,18,51,103,3,400
2020-01-04,부산,충북,195,6,21,28,102,4,356,162,11,22,62,105,7,369
2020-01-04,서울,강원,1249,12,315,5,6,41,1628,948,6,347,5,8,30,1344
2020-01-04,서울,경기,124874,3629,5741,2145,1912,7239,145540,128869,4212,5798,2839,2182,7596,151496
2020-01-04,서울,경남,3384,34,579,152,78,112,4339,2179,20,477,132,75,56,2939
2020-01-04,서울,경북,4889,38,346,134,88,142,5637,3572,47,351,161,81,94,4306
2020-01-04,서울,광주,1203,9,10,29,12,32,1295,847,10,15,35,8,24,939
2020-01-04,서울,대구,2150,24,171,85,48,65,2543,2910,33,255,127,50,95,3470
2020-01-04,서울,대전,2479,20,266,27,13,114,2919,2263,20,267,24,7,95,2676
2020-01-04,서울,부산,270,8,27,54,21,6,386,296,5,7,38,29,11,386
2020-01-04,서울,서울,182,7,13,1,2,4,209,182,7,13,1,2,4,209
2020-01-04,서울,세종,43,0,0,1,0,3,47,47,1,1,0,0,2,51
2020-01-04,서울,울산,44,0,1,0,1,1,47,26,0,2,4,12,0,44
2020-01-04,서울,전남,1480,5,25,32,25,38,1605,1044,13,28,28,17,31,1161
2020-01-04,서울,전북,2585,8,66,17,16,74,2766,1717,12,66,16,19,51,1881
2020-01-04,서울,충남,35567,247,2500,418,434,1373,40539,33249,266,2458,607,589,1244,38413
2020-01-04,서울,충북,17038,204,1057,411,329,646,19685,15750,258,1068,512,435,685,18708
2020-01-04,세종,강원,16,0,0,0,1,3,20,7,0,0,0,2,2,11
2020-01-04,세종,경기,75,2,2,2,7,0,88,53,2,1,1,5,1,63
2020-01-04,세종,경남,417,2,19,5,11,14,468,250,1,10,4,5,9,279
2020-01-04,세종,경북,392,3,12,10,3,12,432,326,0,9,8,8,10,361
2020-01-04,세종,광주,284,2,4,5,5,8,308,159,0,6,1,2,3,171
2020-01-04,세종,대구,301,2,5,0,3,10,321,342,2,8,1,5,8,366
2020-01-04,세종,대전,2999,69,40,19,170,213,3510,3050,62,45,18,151,189,3515
2020-01-04,세종,부산,37,1,0,2,1,0,41,25,2,1,3,1,1,33
2020-01-04,세종,서울,47,1,1,0,0,2,51,43,0,0,1,0,3,47
2020-01-04,세종,세종,230,19,5,2,0,15,271,230,19,5,2,0,15,271
2020-01-04,세종,울산,13,0,0,0,0,0,13,10,0,0,0,2,1,13
2020-01-04,세종,전남,284,2,1,5,6,4,302,195,0,3,1,6,6,211
2020-01-04,세종,전북,1403,14,12,7,23,48,1507,1009,7,15,8,17,42,1098
2020-01-04,세종,충남,6674,112,96,61,129,304,7376,5005,93,98,52,111,211,5570
2020-01-04,세종,충북,296,9,15,9,22,21,372,260,9,14,9,16,20,328
2020-01-04,울산,강원,1,0,2,0,0,0,3,3,0,0,0,0,0,3
2020-01-04,울산,경기,46,4,1,7,29,1,88,39,0,6,6,19,1,71
2020-01-04,울산,경남,12065,331,388,181,239,661,13865,12666,323,353,179,266,706,14493
2020-01-04,울산,경북,7449,69,178,148,774,386,9004,7285,67,186,225,619,357,8739
2020-01-04,울산,광주,71,1,12,2,4,0,90,78,0,10,0,1,1,90
2020-01-04,울산,대구,2261,28,122,32,148,96,2687,2026,32,127,34,94,81,2394
2020-01-04,울산,대전,156,0,10,3,13,8,190,128,1,10,11,11,5,166
2020-01-04,울산,부산,21185,220,193,194,985,1230,24007,19909,214,232,253,1006,1150,22764
2020-01-04,울산,서울,26,0,2,4,12,0,44,44,0,1,0,1,1,47
2020-01-04,울산,세종,10,0,0,0,2,1,13,13,0,0,0,0,0,13
2020-01-04,울산,울산,6087,103,173,107,330,533,7333,6087,103,173,107,330,533,7333
2020-01-04,울산,전남,308,4,8,6,14,8,348,332,9,6,5,14,8,374
2020-01-04,울산,전북,87,0,6,2,9,4,108,69,0,6,0,1,1,77
2020-01-04,울산,충남,163,3,6,15,46,3,236,163,2,9,22,56,4,256
2020-01-04,울산,충북,27,0,4,8,28,1,68,35,1,2,8,27,1,74
2020-01-04,전남,강원,81,1,2,5,6,1,96,73,0,4,1,7,3,88
2020-01-04,전남,경기,1099,10,61,84,57,28,1339,1381,12,97,115,87,37,1729
2020-01-04,전남,경남,8438,156,354,251,700,338,10237,8539,137,339,268,754,341,10378
2020-01-04,전남,경북,1655,27,60,69,348,47,2206,1665,21,68,61,268,52,2135
2020-01-04,전남,광주,37625,633,918,501,1460,1318,42455,39709,662,1093,528,1375,1420,44787
2020-01-04,전남,대구,870,10,38,19,24,25,986,829,10,48,13,23,19,942
2020-01-04,전남,대전,503,3,12,12,18,13,561,568,4,7,26,13,17,635
2020-01-04,전남,부산,2447,32,84,74,296,89,3022,2739,38,130,102,312,93,3414
2020-01-04,전남,서울,1044,13,28,28,17,31,1161,1480,5,25,32,25,38,1605
2020-01-04,전남,세종,195,0,3,1,6,6,211,284,2,1,5,6,4,302
2020-01-04,전남,울산,332,9,6,5,14,8,374,308,4,8,6,14,8,348
2020-01-04,전남,전남,52890,870,1385,1186,3277,1827,61435,52890,870,1385,1186,3277,1827,61435
2020-01-04,전남,전북,7661,178,415,361,745,221,9581,7433,153,358,389,803,182,9318
2020-01-04,전남,충남,6048,52,413,290,410,165,7378,6865,58,503,362,530,202,8520
2020-01-04,전남,충북,558,9,22,57,114,20,780,668,6,27,61,170,19,951
2020-01-04,전북,강원,188,5,13,16,11,5,238,249,0,18,5,5,8,285
2020-01-04,전북,경기,1995,20,101,72,97,65,2350,2685,31,133,64,105,90,3108
2020-01-04,전북,경남,2258,21,113,54,62,61,2569,2600,21,126,51,74,75,2947
2020-01-04,전북,경북,2108,51,107,55,105,68,2494,2382,48,111,80,104,73,2798
2020-01-04,전북,광주,9801,257,378,189,221,294,11140,10170,224,349,190,197,318,11448
2020-01-04,전북,대구,526,7,36,16,10,12,607,623,5,42,9,10,18,707
2020-01-04,전북,대전,4745,70,87,35,30,162,5129,4986,52,92,63,28,214,5435
2020-01-04,전북,부산,461,5,43,16,26,8,559,637,7,46,12,38,16,756
2020-01-04,전북,서울,1717,12,66,16,19,51,1881,2585,8,66,17,16,74,2766
2020-01-04,전북,세종,1009,7,15,8,17,42,1098,1403,14,12,7,23,48,1507
2020-01-04,전북,울산,69,0,6,0,1,1,77,87,0,6,2,9,4,108
2020-01-04,전북,전남,7433,153,358,389,803,182,9318,7661,178,415,361,745,221,9581
2020-01-04,전북,전북,16574,410,716,433,497,614,19244,16574,410,716,433,497,614,19244
2020-01-04,전북,충남,19004,264,1261,517,664,633,22343,21347,270,1260,538,784,738,24937
2020-01-04,전북,충북,2350,54,116,172,137,77,2906,2744,58,124,132,148,99,3305
2020-01-04,충남,강원,735,7,34,27,50,24,877,500,6,28,10,19,19,582
2020-01-04,충남,경기,42826,697,1866,1118,1766,1980,50253,45666,741,1795,1154,1846,2063,53265
2020-01-04,충남,경남,2357,21,104,173,311,74,3040,1563,15,77,86,114,65,1920
2020-01-04,충남,경북,4812,47,177,199,401,154,5790,3890,59,131,193,279,140,4692
2020-01-04,충남,광주,5780,52,586,365,239,161,7183,5415,52,576,193,97,155,6488
2020-01-04,충남,대구,1462,33,51,92,112,45,1795,1746,25,79,74,106,54,2084
2020-01-04,충남,대전,13912,270,353,133,217,830,15715,14816,292,364,146,205,928,16751
2020-01-04,충남,부산,220,5,18,51,103,3,400,232,3,17,16,44,8,320
2020-01-04,충남,서울,33249,266,2458,607,589,1244,38413,35567,247,2500,418,434,1373,40539
2020-01-04,충남,세종,5005,93,98,52,111,211,5570,6674,112,96,61,129,304,7376
2020-01-04,충남,울산,163,2,9,22,56,4,256,163,3,6,15,46,3,236
2020-01-04,충남,전남,6865,58,503,362,530,202,8520,6048,52,413,290,410,165,7378
2020-01-04,충남,전북,21347,270,1260,538,784,738,24937,19004,264,1261,517,664,633,22343
2020-01-04,충남,충남,111662,1813,5975,2981,5139,4590,132160,111662,1813,5975,2981,5139,4590,132160
2020-01-04,충남,충북,12040,307,465,431,778,603,14624,11467,326,464,390,814,600,14061
2020-01-04,충북,강원,6998,125,213,140,193,299,7968,5955,139,216,131,201,307,6949
2020-01-04,충북,경기,29603,888,1461,1356,1733,1409,36450,32269,914,1563,1414,1764,1501,39425
2020-01-04,충북,경남,2255,49,138,309,374,67,3192,1555,24,84,105,127,62,1957
2020-01-04,충북,경북,7910,127,345,357,612,300,9651,7317,134,315,328,483,313,8890
2020-01-04,충북,광주,823,13,66,90,67,19,1078,679,10,46,43,29,28,835
2020-01-04,충북,대구,1983,42,108,191,111,85,2520,2664,30,161,122,174,82,3233
2020-01-04,충북,대전,9267,260,312,113,92,589,10633,9960,306,343,117,96,602,11424
2020-01-04,충북,부산,162,11,22,62,105,7,369,195,6,21,28,102,4,356
2020-01-04,충북,서울,15750,258,1068,512,435,685,18708,17038,204,1057,411,329,646,19685
2020-01-04,충북,세종,260,9,14,9,16,20,328,296,9,15,9,22,21,372
2020-01-04,충북,울산,35,1,2,8,27,1,74,27,0,4,8,28,1,68
2020-01-04,충북,전남,668,6,27,61,170,19,951,558,9,22,57,114,20,780
2020-01-04,충북,전북,2744,58,124,132,148,99,3305,2350,54,116,172,137,77,2906
2020-01-04,충북,충남,11467,326,464,390,814,600,14061,12040,307,465,431,778,603,14624
2020-01-04,충북,충북,34476,973,1245,1089,1709,1865,41357,34476,973,1245,1089,1709,1865,41357
2020-01-05,강원,강원,80790,674,2490,264,412,4358,88988,80790,674,2490,264,412,4358,88988
2020-01-05,강원,경기,43287,234,1054,177,123,1610,46485,25242,157,1014,122,173,1143,27851
2020-01-05,강원,경남,374,4,22,3,1,8,412,149,0,9,9,2,9,178
2020-01-05,강원,경북,1008,12,40,4,4,30,1098,731,3,38,11,2,29,814
2020-01-05,강원,광주,139,1,20,3,3,1,167,125,1,19,6,1,2,154
2020-01-05,강원,대구,568,3,24,5,1,15,616,530,5,49,4,2,15,605
2020-01-05,강원,대전,331,0,35,0,0,11,377,254,1,40,0,0,11,306
2020-01-05,강원,부산,6,0,0,0,0,0,6,3,0,0,0,0,0,3
2020-01-05,강원,서울,1612,15,454,5,4,43,2133,929,6,335,3,1,34,1308
2020-01-05,강원,세종,8,0,0,0,0,1,9,7,0,0,0,0,0,7
2020-01-05,강원,울산,6,0,1,1,2,0,10,3,1,0,0,0,0,4
2020-01-05,강원,전남,91,0,2,4,0,0,97,73,0,3,1,2,3,82
2020-01-05,강원,전북,267,1,15,5,0,6,294,217,0,8,11,1,9,246
2020-01-05,강원,충남,708,3,19,5,12,28,775,559,3,34,8,16,19,639
2020-01-05,강원,충북,6098,62,162,43,51,254,6670,5130,51,179,25,51,259,5695
2020-01-05,경기,강원,25242,157,1014,122,173,1143,27851,43287,234,1054,177,123,1610,46485
2020-01-05,경기,경기,288526,4839,7153,3102,4828,17854,326302,288526,4839,7153,3102,4828,17854,326302
2020-01-05,경기,경남,3036,16,224,125,65,137,3603,3270,15,193,128,83,93,3782
2020-01-05,경기,경북,4727,33,222,166,67,168,5383,7201,53,218,186,82,251,7991
2020-01-05,경기,광주,875,7,108,36,10,18,1054,1219,7,92,38,22,27,1405
2020-01-05,경기,대구,2196,10,114,71,33,57,2481,4131,17,132,78,55,114,4527
2020-01-05,경기,대전,2342,14,178,23,7,137,2701,3002,35,167,18,9,147,3378
2020-01-05,경기,부산,232,5,2,28,15,9,291,524,5,10,19,32,25,615
2020-01-05,경기,서울,102769,1729,4171,1159,461,5965,116254,113108,1899,4193,1076,503,6539,127318
2020-01-05,경기,세종,39,2,1,2,0,2,46,59,0,1,0,6,4,70
2020-01-05,경기,울산,40,1,2,0,5,1,49,48,2,2,3,5,2,62
2020-01-05,경기,전남,894,1,69,33,22,26,1045,1558,3,73,60,35,49,1778
2020-01-05,경기,전북,1708,12,118,33,24,57,1952,2843,14,111,47,36,93,3144
2020-01-05,경기,충남,35668,261,1318,484,560,1736,40027,40089,300,1351,395,475,1842,44452
2020-01-05,경기,충북,25808,475,933,539,526,1286,29567,30428,462,921,489,438,1389,34127
2020-01-05,경남,강원,149,0,9,9,2,9,178,374,4,22,3,1,8,412
2020-01-05,경남,경기,3270,15,193,128,83,93,3782,3036,16,224,125,65,137,3603
2020-01-05,경남,경남,162477,2297,3503,938,1566,9992,180773,162477,2297,3503,938,1566,9992,180773
2020-01-05,경남,경북,15683,149,472,149,163,731,17347,20949,228,597,257,198,944,23173
2020-01-05,경남,광주,1815,19,116,48,16,52,2066,1702,17,128,32,15,51,1945
2020-01-05,경남,대구,18596,170,641,248,367,753,20775,14668,102,516,105,70,651,16112
2020-01-05,경남,대전,1435,7,103,32,10,45,1632,1608,8,104,11,3,86,1820
2020-01-05,경남,부산,81296,634,1695,271,680,4773,89349,77897,635,1568,251,703,4810,85864
2020-01-05,경남,서울,2742,23,464,125,70,77,3501,3024,23,515,28,9,81,3680
2020-01-05,경남,세종,437,2,6,4,0,11,460,323,1,20,1,1,7,353
2020-01-05,경남,울산,11997,140,278,52,55,646,13168,10849,118,274,57,60,585,11943
2020-01-05,경남,전남,7453,75,266,127,150,289,8360,8259,76,267,136,176,343,9257
2020-01-05,경남,전북,2026,18,107,26,12,62,2251,2506,21,114,29,21,76,2767
2020-01-05,경남,충남,1999,16,49,47,33,78,2222,1976,23,76,40,49,62,2226
2020-01-05,경남,충북,2022,20,83,65,46,71,2307,1980,18,132,101,61,80,2372
2020-01-05,경북,강원,731,3,38,11,2,29,814,1008,12,40,4,4,30,1098
2020-01-05,경북,경기,7201,53,218,186,82,251,7991,4727,33,222,166,67,168,5383
2020-01-05,경북,경남,20949,228,597,257,198,944,23173,15683,149,472,149,163,731,17347
2020-01-05,경북,경북,80917,953,1563,491,738,3696,88358,80917,953,1563,491,738,3696,88358
2020-01-05,경북,광주,1218,22,83,64,14,42,1443,1262,18,58,88,23,36,1485
2020-01-05,경북,대구,66181,604,1202,291,296,3034,71608,68055,649,1425,288,369,3228,74014
2020-01-05,경북,대전,2575,12,79,20,21,126,2833,2579,11,76,13,9,121,2809
2020-01-05,경북,부산,8366,34,271,29,81,345,9126,8748,44,284,36,101,352,9565
2020-01-05,경북,서울,4824,29,323,129,36,143,5484,3368,21,292,36,29,110,3856
2020-01-05,경북,세종,465,1,8,3,3,20,500,400,2,8,7,1,15,433
2020-01-05,경북,울산,8177,29,130,73,245,399,9053,6901,27,113,70,207,328,7646
2020-01-05,경북,전남,1572,19,45,32,103,46,1817,1656,16,58,34,122,46,1932
2020-01-05,경북,전북,1984,24,70,30,43,56,2207,2187,26,62,33,45,56,2409
2020-01-05,경북,충남,4670,30,84,46,103,158,5091,4070,21,81,63,124,141,4500
2020-01-05,경북,충북,8334,61,177,155,139,277,9143,7023,54,218,113,100,251,7759
2020-01-05,광주,강원,125,1,19,6,1,2,154,139,1,20,3,3,1,167
2020-01-05,광주,경기,1219,7,92,38,22,27,1405,875,7,108,36,10,18,1054
2020-01-05,광주,경남,1702,17,128,32,15,51,1945,1815,19,116,48,16,52,2066
2020-01-05,광주,경북,1262,18,58,88,23,36,1485,1218,22,83,64,14,42,1443
2020-01-05,광주,광주,10475,149,418,81,51,394,11568,10475,149,418,81,51,394,11568
2020-01-05,광주,대구,748,12,80,70,6,17,933,774,14,113,34,5,25,965
2020-01-05,광주,대전,603,2,9,6,4,17,641,667,3,9,3,4,13,699
2020-01-05,광주,부산,576,3,46,16,3,18,662,786,5,57,2,3,23,876
2020-01-05,광주,서울,1245,9,14,13,5,30,1316,892,9,18,3,4,24,950
2020-01-05,광주,세종,268,1,3,0,0,11,283,189,1,1,0,0,10,201
2020-01-05,광주,울산,88,0,12,1,1,2,104,47,1,12,1,0,0,61
2020-01-05,광주,전남,33094,276,836,191,158,1164,35719,33654,289,713,348,162,1204,36370
2020-01-05,광주,전북,8523,90,227,58,47,274,9219,9281,101,252,45,40,316,10035
2020-01-05,광주,충남,5863,43,543,111,75,165,6800,4812,36,548,113,43,138,5690
2020-01-05,광주,충북,807,10,30,20,12,22,901,726,7,36,34,6,19,828
2020-01-05,대구,강원,530,5,49,4,2,15,605,568,3,24,5,1,15,616
2020-01-05,대구,경기,4131,17,132,78,55,114,4527,2196,10,114,71,33,57,2481
2020-01-05,대구,경남,14668,102,516,105,70,651,16112,18596,170,641,248,367,753,20775
2020-01-05,대구,경북,68055,649,1425,288,369,3228,74014,66181,604,1202,291,296,3034,71608
2020-01-05,대구,광주,774,14,113,34,5,25,965,748,12,80,70,6,17,933
2020-01-05,대구,대구,39319,382,591,147,181,2180,42800,39319,382,591,147,181,2180,42800
2020-01-05,대구,대전,1443,5,42,11,4,58,1563,880,3,32,4,1,33,953
2020-01-05,대구,부산,852,11,65,26,11,32,997,4985,30,183,32,30,177,5437
2020-01-05,대구,서울,3063,14,174,50,23,85,3409,2043,9,125,11,7,64,2259
2020-01-05,대구,세종,477,0,11,1,1,14,504,232,0,2,0,1,6,241
2020-01-05,대구,울산,2271,15,106,10,47,102,2551,1927,16,109,10,52,80,2194
2020-01-05,대구,전남,807,10,62,14,9,21,923,942,11,57,21,33,21,1085
2020-01-05,대구,전북,518,4,46,5,4,12,589,616,5,45,8,4,20,698
2020-01-05,대구,충남,2256,16,53,27,39,69,2460,1218,9,35,26,16,51,1355
2020-01-05,대구,충북,2870,17,150,59,71,110,3277,1861,19,91,44,26,68,2109
2020-01-05,대전,강원,254,1,40,0,0,11,306,331,0,35,0,0,11,377
2020-01-05,대전,경기,3002,35,167,18,9,147,3378,2342,14,178,23,7,137,2701
2020-01-05,대전,경남,1608,8,104,11,3,86,1820,1435,7,103,32,10,45,1632
2020-01-05,대전,경북,2579,11,76,13,9,121,2809,2575,12,79,20,21,126,2833
2020-01-05,대전,광주,667,3,9,3,4,13,699,603,2,9,6,4,17,641
2020-01-05,대전,대구,880,3,32,4,1,33,953,1443,5,42,11,4,58,1563
2020-01-05,대전,대전,8948,70,125,30,17,617,9807,8948,70,125,30,17,617,9807
2020-01-05,대전,부산,103,0,2,1,0,3,109,189,1,1,1,2,4,198
2020-01-05,대전,서울,2333,8,252,5,3,91,2692,1971,9,260,1,2,75,2318
2020-01-05,대전,세종,2464,34,32,1,2,192,2725,2025,28,31,4,7,136,2231
2020-01-05,대전,울산,187,0,10,1,7,10,215,123,0,12,1,6,2,144
2020-01-05,대전,전남,426,2,10,4,7,22,471,531,2,6,2,7,19,567
2020-01-05,대전,전북,4011,20,66,11,6,167,4281,4572,23,74,27,10,210,4916
2020-01-05,대전,충남,12078,72,233,36,27,726,13172,11559,97,213,46,21,666,12602
2020-01-05,대전,충북,8201,122,235,34,26,526,9144,7587,90,225,33,14,463,8412
2020-01-05,부산,강원,3,0,0,0,0,0,3,6,0,0,0,0,0,6
2020-01-05,부산,경기,524,5,10,19,32,25,615,232,5,2,28,15,9,291
2020-01-05,부산,경남,77897,635,1568,251,703,4810,85864,81296,634,1695,271,680,4773,89349
2020-01-05,부산,경북,8748,44,284,36,101,352,9565,8366,34,271,29,81,345,9126
2020-01-05,부산,광주,786,5,57,2,3,23,876,576,3,46,16,3,18,662
2020-01-05,부산,대구,4985,30,183,32,30,177,5437,852,11,65,26,11,32,997
2020-01-05,부산,대전,189,1,1,1,2,4,198,103,0,2,1,0,3,109
2020-01-05,부산,부산,45712,163,163,64,258,2474,48834,45712,163,163,64,258,2474,48834
2020-01-05,부산,서울,387,3,10,19,14,8,441,242,2,8,10,6,2,270
2020-01-05,부산,세종,58,0,1,0,0,2,61,27,0,0,0,1,0,28
2020-01-05,부산,울산,20108,72,150,73,282,1198,21883,18170,68,85,68,287,1079,19757
2020-01-05,부산,전남,2663,16,114,38,82,97,3010,2337,15,94,96,104,76,2722
2020-01-05,부산,전북,608,3,62,4,16,18,711,580,1,46,18,14,18,677
2020-01-05,부산,충남,374,3,13,8,12,16,426,182,3,13,5,19,7,229
2020-01-05,부산,충북,294,2,11,11,31,9,358,116,0,4,15,9,4,148
2020-01-05,서울,강원,929,6,335,3,1,34,1308,1612,15,454,5,4,43,2133
2020-01-05,서울,경기,113108,1899,4193,1076,503,6539,127318,102769,1729,4171,1159,461,5965,116254
2020-01-05,서울,경남,3024,23,515,28,9,81,3680,2742,23,464,125,70,77,3501
2020-01-05,서울,경북,3368,21,292,36,29,110,3856,4824,29,323,129,36,143,5484
2020-01-05,서울,광주,892,9,18,3,4,24,950,1245,9,14,13,5,30,1316
2020-01-05,서울,대구,2043,9,125,11,7,64,2259,3063,14,174,50,23,85,3409
2020-01-05,서울,대전,1971,9,260,1,2,75,2318,2333,8,252,5,3,91,2692
2020-01-05,서울,부산,242,2,8,10,6,2,270,387,3,10,19,14,8,441
2020-01-05,서울,서울,181,1,6,3,3,7,201,181,1,6,3,3,7,201
2020-01-05,서울,세종,26,0,0,0,0,1,27,37,0,0,0,0,0,37
2020-01-05,서울,울산,39,0,3,1,1,0,44,30,1,4,1,4,1,41
2020-01-05,서울,전남,981,6,24,15,4,31,1061,1701,9,27,78,50,39,1904
2020-01-05,서울,전북,1483,5,59,5,0,47,1599,2786,9,61,18,8,84,2966
2020-01-05,서울,충남,31343,137,2212,224,165,1277,35358,35983,186,2136,613,304,1368,40590
2020-01-05,서울,충북,14805,108,891,187,104,689,16784,15661,106,954,185,94,652,17652
2020-01-05,세종,강원,7,0,0,0,0,0,7,8,0,0,0,0,1,9
2020-01-05,세종,경기,59,0,1,0,6,4,70,39,2,1,2,0,2,46
2020-01-05,세종,경남,323,1,20,1,1,7,353,437,2,6,4,0,11,460
2020-01-05,세종,경북,400,2,8,7,1,15,433,465,1,8,3,3,20,500
2020-01-05,세종,광주,189,1,1,0,0,10,201,268,1,3,0,0,11,283
2020-01-05,세종,대구,232,0,2,0,1,6,241,477,0,11,1,1,14,504
2020-01-05,세종,대전,2025,28,31,4,7,136,2231,2464,34,32,1,2,192,2725
2020-01-05,세종,부산,27,0,0,0,1,0,28,58,0,1,0,0,2,61
2020-01-05,세종,서울,37,0,0,0,0,0,37,26,0,0,0,0,1,27
2020-01-05,세종,세종,192,6,1,0,0,7,206,192,6,1,0,0,7,206
2020-01-05,세종,울산,14,0,0,0,0,0,14,14,0,2,0,0,0,16
2020-01-05,세종,전남,178,1,3,0,4,8,194,329,0,5,5,4,8,351
2020-01-05,세종,전북,894,0,12,4,3,29,942,1241,3,5,2,3,42,1296
2020-01-05,세종,충남,5285,39,76,25,19,212,5656,5171,37,80,31,25,226,5570
2020-01-05,세종,충북,242,5,6,3,3,17,276,283,6,4,2,3,22,320
2020-01-05,울산,강원,3,1,0,0,0,0,4,6,0,1,1,2,0,10
2020-01-05,울산,경기,48,2,2,3,5,2,62,40,1,2,0,5,1,49
2020-01-05,울산,경남,10849,118,274,57,60,585,11943,11997,140,278,52,55,646,13168
2020-01-05,울산,경북,6901,27,113,70,207,328,7646,8177,29,130,73,245,399,9053
2020-01-05,울산,광주,47,1,12,1,0,0,61,88,0,12,1,1,2,104
2020-01-05,울산,대구,1927,16,109,10,52,80,2194,2271,15,106,10,47,102,2551
2020-01-05,울산,대전,123,0,12,1,6,2,144,187,0,10,1,7,10,215
2020-01-05,울산,부산,18170,68,85,68,287,1079,19757,20108,72,150,73,282,1198,21883
2020-01-05,울산,서울,30,1,4,1,4,1,41,39,0,3,1,1,0,44
2020-01-05,울산,세종,14,0,2,0,0,0,16,14,0,0,0,0,0,14
2020-01-05,울산,울산,5082,30,137,21,79,396,5745,5082,30,137,21,79,396,5745
2020-01-05,울산,전남,245,2,6,2,1,8,264,349,4,6,1,3,14,377
2020-01-05,울산,전북,81,0,8,0,9,0,98,99,0,6,1,3,9,118
2020-01-05,울산,충남,215,2,5,6,28,4,260,174,0,7,8,18,7,214
2020-01-05,울산,충북,26,1,6,2,4,1,40,23,0,5,4,7,1,40
2020-01-05,전남,강원,73,0,3,1,2,3,82,91,0,2,4,0,0,97
2020-01-05,전남,경기,1558,3,73,60,35,49,1778,894,1,69,33,22,26,1045
2020-01-05,전남,경남,8259,76,267,136,176,343,9257,7453,75,266,127,150,289,8360
2020-01-05,전남,경북,1656,16,58,34,122,46,1932,1572,19,45,32,103,46,1817
2020-01-05,전남,광주,33654,289,713,348,162,1204,36370,33094,276,836,191,158,1164,35719
2020-01-05,전남,대구,942,11,57,21,33,21,1085,807,10,62,14,9,21,923
2020-01-05,전남,대전,531,2,6,2,7,19,567,426,2,10,4,7,22,471
2020-01-05,전남,부산,2337,15,94,96,104,76,2722,2663,16,114,38,82,97,3010
2020-01-05,전남,서울,1701,9,27,78,50,39,1904,981,6,24,15,4,31,1061
2020-01-05,전남,세종,329,0,5,5,4,8,351,178,1,3,0,4,8,194
2020-01-05,전남,울산,349,4,6,1,3,14,377,245,2,6,2,1,8,264
2020-01-05,전남,전남,47209,434,1016,869,701,1702,51931,47209,434,1016,869,701,1702,51931
2020-01-05,전남,전북,7432,108,222,270,238,209,8479,6796,91,232,166,203,186,7674
2020-01-05,전남,충남,8009,51,389,483,440,220,9592,5219,31,420,129,182,145,6126
2020-01-05,전남,충북,767,3,21,35,44,14,884,519,2,23,28,55,16,643
2020-01-05,전북,강원,217,0,8,11,1,9,246,267,1,15,5,0,6,294
2020-01-05,전북,경기,2843,14,111,47,36,93,3144,1708,12,118,33,24,57,1952
2020-01-05,전북,경남,2506,21,114,29,21,76,2767,2026,18,107,26,12,62,2251
2020-01-05,전북,경북,2187,26,62,33,45,56,2409,1984,24,70,30,43,56,2207
2020-01-05,전북,광주,9281,101,252,45,40,316,10035,8523,90,227,58,47,274,9219
2020-01-05,전북,대구,616,5,45,8,4,20,698,518,4,46,5,4,12,589
2020-01-05,전북,대전,4572,23,74,27,10,210,4916,4011,20,66,11,6,167,4281
2020-01-05,전북,부산,580,1,46,18,14,18,677,608,3,62,4,16,18,711
2020-01-05,전북,서울,2786,9,61,18,8,84,2966,1483,5,59,5,0,47,1599
2020-01-05,전북,세종,1241,3,5,2,3,42,1296,894,0,12,4,3,29,942
2020-01-05,전북,울산,99,0,6,1,3,9,118,81,0,8,0,9,0,98
2020-01-05,전북,전남,6796,91,232,166,203,186,7674,7432,108,222,270,238,209,8479
2020-01-05,전북,전북,14153,141,470,106,100,478,15448,14153,141,470,106,100,478,15448
2020-01-05,전북,충남,20984,139,1009,305,316,774,23527,16408,112,1006,173,232,583,18514
2020-01-05,전북,충북,2773,30,75,110,54,92,3134,2130,37,84,75,48,58,2432
2020-01-05,충남,강원,559,3,34,8,16,19,639,708,3,19,5,12,28,775
2020-01-05,충남,경기,40089,300,1351,395,475,1842,44452,35668,261,1318,484,560,1736,40027
2020-01-05,충남,경남,1976,23,76,40,49,62,2226,1999,16,49,47,33,78,2222
2020-01-05,충남,경북,4070,21,81,63,124,141,4500,4670,30,84,46,103,158,5091
2020-01-05,충남,광주,4812,36,548,113,43,138,5690,5863,43,543,111,75,165,6800
2020-01-05,충남,대구,1218,9,35,26,16,51,1355,2256,16,53,27,39,69,2460
2020-01-05,충남,대전,11559,97,213,46,21,666,12602,12078,72,233,36,27,726,13172
2020-01-05,충남,부산,182,3,13,5,19,7,229,374,3,13,8,12,16,426
2020-01-05,충남,서울,35983,186,2136,613,304,1368,40590,31343,137,2212,224,165,1277,35358
2020-01-05,충남,세종,5171,37,80,31,25,226,5570,5285,39,76,25,19,212,5656
2020-01-05,충남,울산,174,0,7,8,18,7,214,215,2,5,6,28,4,260
2020-01-05,충남,전남,5219,31,420,129,182,145,6126,8009,51,389,483,440,220,9592
2020-01-05,충남,전북,16408,112,1006,173,232,583,18514,20984,139,1009,305,316,774,23527
2020-01-05,충남,충남,101655,903,4838,1376,1870,4261,114903,101655,903,4838,1376,1870,4261,114903
2020-01-05,충남,충북,10455,142,318,186,202,513,11816,9873,151,342,166,225,495,11252
2020-01-05,충북,강원,5130,51,179,25,51,259,5695,6098,62,162,43,51,254,6670
2020-01-05,충북,경기,30428,462,921,489,438,1389,34127,25808,475,933,539,526,1286,29567
2020-01-05,충북,경남,1980,18,132,101,61,80,2372,2022,20,83,65,46,71,2307
2020-01-05,충북,경북,7023,54,218,113,100,251,7759,8334,61,177,155,139,277,9143
2020-01-05,충북,광주,726,7,36,34,6,19,828,807,10,30,20,12,22,901
2020-01-05,충북,대구,1861,19,91,44,26,68,2109,2870,17,150,59,71,110,3277
2020-01-05,충북,대전,7587,90,225,33,14,463,8412,8201,122,235,34,26,526,9144
2020-01-05,충북,부산,116,0,4,15,9,4,148,294,2,11,11,31,9,358
2020-01-05,충북,서울,15661,106,954,185,94,652,17652,14805,108,891,187,104,689,16784
2020-01-05,충북,세종,283,6,4,2,3,22,320,242,5,6,3,3,17,276
2020-01-05,충북,울산,23,0,5,4,7,1,40,26,1,6,2,4,1,40
2020-01-05,충북,전남,519,2,23,28,55,16,643,767,3,21,35,44,14,884
2020-01-05,충북,전북,2130,37,84,75,48,58,2432,2773,30,75,110,54,92,3134
2020-01-05,충북,충남,9873,151,342,166,225,495,11252,10455,142,318,186,202,513,11816
2020-01-05,충북,충북,29813,418,680,444,401,1566,33322,29813,418,680,444,401,1566,33322
2020-01-06,강원,강원,64638,2192,3162,1395,2368,4457,78212,64638,2192,3162,1395,2368,4457,78212
2020-01-06,강원,경기,19614,568,1213,614,681,861,23551,18781,611,1262,601,778,904,22937
2020-01-06,강원,경남,228,4,18,8,12,10,280,109,2,12,23,9,5,160
2020-01-06,강원,경북,484,15,42,9,21,27,598,464,14,40,20,17,19,574
2020-01-06,강원,광주,71,3,17,8,8,3,110,91,2,18,8,3,4,126
2020-01-06,강원,대구,247,4,8,7,4,11,281,379,2,21,17,22,10,451
2020-01-06,강원,대전,158,2,32,2,0,9,203,201,4,30,2,2,11,250
2020-01-06,강원,부산,7,0,0,0,0,0,7,2,1,0,0,1,0,4
2020-01-06,강원,서울,650,14,278,6,33,24,1005,687,14,242,11,12,17,983
2020-01-06,강원,세종,6,0,0,0,0,0,6,7,0,1,1,0,0,9
2020-01-06,강원,울산,1,0,0,0,1,0,2,1,0,0,0,1,0,2
2020-01-06,강원,전남,63,2,1,7,8,0,81,52,1,7,7,15,4,86
2020-01-06,강원,전북,149,2,12,6,14,6,189,167,6,19,28,7,7,234
2020-01-06,강원,충남,370,8,22,17,28,25,470,411,9,24,33,68,17,562
2020-01-06,강원,충북,4996,210,283,228,345,284,6346,4893,176,262,170,297,280,6078
2020-01-06,경기,강원,18781,611,1262,601,778,904,22937,19614,568,1213,614,681,861,23551
2020-01-06,경기,경기,407249,22334,24188,18241,23528,31028,526568,407249,22334,24188,18241,23528,31028,526568
2020-01-06,경기,경남,2687,74,289,452,379,103,3984,2059,48,236,429,326,90,3188
2020-01-06,경기,경북,4237,171,509,616,422,134,6089,3945,171,491,776,543,119,6045
2020-01-06,경기,광주,763,31,173,258,138,18,1381,731,19,146,225,115,24,1260
2020-01-06,경기,대구,1882,61,213,255,167,52,2630,2706,78,224,350,389,93,3840
2020-01-06,경기,대전,1900,102,200,80,50,95,2427,2424,105,197,96,57,108,2987
2020-01-06,경기,부산,143,7,18,67,75,4,314,279,11,30,84,206,9,619
2020-01-06,경기,서울,136226,7030,9066,4590,3288,9369,169569,143481,6710,9218,4958,3037,9712,177116
2020-01-06,경기,세종,41,2,2,6,1,1,53,64,1,3,3,1,2,74
2020-01-06,경기,울산,33,0,1,3,14,1,52,38,1,5,19,63,1,127
2020-01-06,경기,전남,703,15,87,147,120,19,1091,700,13,85,115,106,17,1036
2020-01-06,경기,전북,1254,34,162,121,172,28,1771,1392,52,133,162,181,42,1962
2020-01-06,경기,충남,36861,1512,2832,2296,4100,1940,49541,34738,1438,2752,2151,3888,1881,46848
2020-01-06,경기,충북,28042,2148,2913,2971,3319,1476,40869,26007,2122,2891,2696,3491,1339,38546
2020-01-06,경남,강원,109,2,12,23,9,5,160,228,4,18,8,12,10,280
2020-01-06,경남,경기,2059,48,236,429,326,90,3188,2687,74,289,452,379,103,3984
2020-01-06,경남,경남,186484,9535,9707,7044,11539,14568,238877,186484,9535,9707,7044,11539,14568,238877
2020-01-06,경남,경북,10184,590,991,841,1670,473,14749,12546,867,1202,1168,2603,570,18956
2020-01-06,경남,광주,1099,60,134,161,106,30,1590,1201,48,141,156,90,38,1674
2020-01-06,경남,대구,13227,728,932,941,1623,575,18026,10896,481,759,407,482,481,13506
2020-01-06,경남,대전,669,17,101,54,33,30,904,955,22,110,72,46,33,1238
2020-01-06,경남,부산,84169,2561,2895,1606,4087,5948,101266,84330,2694,3046,1701,4290,6017,102078
2020-01-06,경남,서울,1742,33,439,219,115,55,2603,2507,37,482,94,61,85,3266
2020-01-06,경남,세종,181,2,11,13,2,3,212,267,2,21,9,12,10,321
2020-01-06,경남,울산,10038,631,723,525,663,618,13198,9150,571,740,458,666,571,12156
2020-01-06,경남,전남,5704,239,475,463,1226,259,8366,5838,236,452,406,1165,256,8353
2020-01-06,경남,전북,1281,32,117,95,170,52,1747,1322,29,143,82,164,50,1790
2020-01-06,경남,충남,1307,38,123,225,189,39,1921,1626,47,173,252,430,57,2585
2020-01-06,경남,충북,1192,56,154,239,291,34,1966,1406,73,227,370,574,46,2696
2020-01-06,경북,강원,464,14,40,20,17,19,574,484,15,42,9,21,27,598
2020-01-06,경북,경기,3945,171,491,776,543,119,6045,4237,171,509,616,422,134,6089
2020-01-06,경북,경남,12546,867,1202,1168,2603,570,18956,10184,590,991,841,1670,473,14749
2020-01-06,경북,경북,71291,3621,4222,2868,4507,3905,90414,71291,3621,4222,2868,4507,3905,90414
2020-01-06,경북,광주,793,50,132,205,116,20,1316,826,44,108,152,90,13,1233
2020-01-06,경북,대구,67888,2702,2846,1370,2479,3810,81095,73414,2882,3150,1750,3074,3907,88177
2020-01-06,경북,대전,1539,37,113,103,74,68,1934,1794,36,100,92,60,78,2160
2020-01-06,경북,부산,3894,117,298,170,513,225,5217,4876,117,341,191,697,253,6475
2020-01-06,경북,서울,2609,100,343,316,111,85,3564,2891,84,350,159,77,94,3655
2020-01-06,경북,세종,253,8,22,13,10,7,313,287,8,13,17,10,10,345
2020-01-06,경북,울산,4939,152,350,402,975,303,7121,4600,142,365,331,1179,298,6915
2020-01-06,경북,전남,1017,29,84,104,422,33,1689,945,31,77,110,545,33,1741
2020-01-06,경북,전북,1622,80,196,156,203,69,2326,1398,76,166,155,218,67,2080
2020-01-06,경북,충남,3120,118,355,507,565,133,4798,3156,116,330,411,655,102,4770
2020-01-06,경북,충북,5143,215,526,703,930,215,7732,4945,214,562,627,909,200,7457
2020-01-06,광주,강원,91,2,18,8,3,4,126,71,3,17,8,8,3,110
2020-01-06,광주,경기,731,19,146,225,115,24,1260,763,31,173,258,138,18,1381
2020-01-06,광주,경남,1201,48,141,156,90,38,1674,1099,60,134,161,106,30,1590
2020-01-06,광주,경북,826,44,108,152,90,13,1233,793,50,132,205,116,20,1316
2020-01-06,광주,광주,12173,441,639,321,179,522,14275,12173,441,639,321,179,522,14275
2020-01-06,광주,대구,586,30,83,76,24,11,810,594,32,86,75,26,19,832
2020-01-06,광주,대전,417,26,16,16,11,17,503,500,13,23,15,17,15,583
2020-01-06,광주,부산,332,9,34,48,72,12,507,434,14,46,56,99,10,659
2020-01-06,광주,서울,635,15,28,53,15,18,764,716,14,15,29,10,21,805
2020-01-06,광주,세종,152,2,8,4,1,1,168,161,2,7,3,2,5,180
2020-01-06,광주,울산,59,0,11,2,6,1,79,66,0,9,3,8,0,86
2020-01-06,광주,전남,31979,858,1118,701,1476,1283,37415,29435,837,997,566,1348,1222,34405
2020-01-06,광주,전북,7529,381,555,327,347,283,9422,7257,414,482,295,347,282,9077
2020-01-06,광주,충남,3907,98,543,420,276,102,5346,3682,116,549,486,284,98,5215
2020-01-06,광주,충북,643,27,73,108,62,18,931,606,35,97,133,56,14,941
2020-01-06,대구,강원,379,2,21,17,22,10,451,247,4,8,7,4,11,281
2020-01-06,대구,경기,2706,78,224,350,389,93,3840,1882,61,213,255,167,52,2630
2020-01-06,대구,경남,10896,481,759,407,482,481,13506,13227,728,932,941,1623,575,18026
2020-01-06,대구,경북,73414,2882,3150,1750,3074,3907,88177,67888,2702,2846,1370,2479,3810,81095
2020-01-06,대구,광주,594,32,86,75,26,19,832,586,30,83,76,24,11,810
2020-01-06,대구,대구,58320,2104,1766,883,1106,3806,67985,58320,2104,1766,883,1106,3806,67985
2020-01-06,대구,대전,898,41,42,51,34,25,1091,648,19,40,21,18,17,763
2020-01-06,대구,부산,527,45,77,39,137,12,837,2944,93,212,94,249,133,3725
2020-01-06,대구,서울,2315,47,198,159,108,74,2901,1684,36,146,63,28,46,2003
2020-01-06,대구,세종,240,2,14,7,11,7,281,173,2,5,8,4,2,194
2020-01-06,대구,울산,1384,53,138,72,177,60,1884,1276,58,140,66,176,62,1778
2020-01-06,대구,전남,542,11,39,31,62,19,704,454,13,44,44,83,22,660
2020-01-06,대구,전북,410,5,39,14,22,11,501,349,5,41,18,20,7,440
2020-01-06,대구,충남,1694,67,143,186,273,57,2420,1089,52,122,147,167,31,1608
2020-01-06,대구,충북,1936,83,219,241,342,72,2893,1297,77,157,151,114,45,1841
2020-01-06,대전,강원,201,4,30,2,2,11,250,158,2,32,2,0,9,203
2020-01-06,대전,경기,2424,105,197,96,57,108,2987,1900,102,200,80,50,95,2427
2020-01-06,대전,경남,955,22,110,72,46,33,1238,669,17,101,54,33,30,904
2020-01-06,대전,경북,1794,36,100,92,60,78,2160,1539,37,113,103,74,68,1934
2020-01-06,대전,광주,500,13,23,15,17,15,583,417,26,16,16,11,17,503
2020-01-06,대전,대구,648,19,40,21,18,17,763,898,41,42,51,34,25,1091
2020-01-06,대전,대전,13067,371,393,329,104,997,15261,13067,371,393,329,104,997,15261
2020-01-06,대전,부산,60,2,8,13,11,1,95,85,4,4,8,11,3,115
2020-01-06,대전,서울,1848,31,210,26,10,101,2226,1757,47,198,24,5,81,2112
2020-01-06,대전,세종,3299,77,76,37,150,268,3907,3314,90,77,32,184,270,3967
2020-01-06,대전,울산,86,6,9,8,25,4,138,83,1,9,6,22,0,121
2020-01-06,대전,전남,292,3,10,16,24,6,351,262,7,15,26,23,9,342
2020-01-06,대전,전북,3095,63,89,50,25,131,3453,2795,89,86,73,34,137,3214
2020-01-06,대전,충남,16022,447,526,275,213,1241,18724,13614,417,471,260,194,1074,16030
2020-01-06,대전,충북,10935,438,456,189,148,855,13021,9269,385,389,158,113,739,11053
2020-01-06,부산,강원,2,1,0,0,1,0,4,7,0,0,0,0,0,7
2020-01-06,부산,경기,279,11,30,84,206,9,619,143,7,18,67,75,4,314
2020-01-06,부산,경남,84330,2694,3046,1701,4290,6017,102078,84169,2561,2895,1606,4087,5948,101266
2020-01-06,부산,경북,4876,117,341,191,697,253,6475,3894,117,298,170,513,225,5217
2020-01-06,부산,광주,434,14,46,56,99,10,659,332,9,34,48,72,12,507
2020-01-06,부산,대구,2944,93,212,94,249,133,3725,527,45,77,39,137,12,837
2020-01-06,부산,대전,85,4,4,8,11,3,115,60,2,8,13,11,1,95
2020-01-06,부산,부산,37456,685,621,994,1917,2663,44336,37456,685,621,994,1917,2663,44336
2020-01-06,부산,서울,246,10,10,40,47,10,363,173,4,2,21,12,3,215
2020-01-06,부산,세종,24,1,2,0,1,2,30,19,0,0,2,4,0,25
2020-01-06,부산,울산,16495,384,508,643,2429,1158,21617,15299,398,448,415,2169,1129,19858
2020-01-06,부산,전남,2018,84,127,155,549,91,3024,1590,72,108,129,506,70,2475
2020-01-06,부산,전북,371,12,28,31,82,10,534,274,8,28,36,70,6,422
2020-01-06,부산,충남,212,12,25,46,100,9,404,112,6,15,46,141,2,322
2020-01-06,부산,충북,140,8,24,55,159,2,388,75,3,15,71,132,2,298
2020-01-06,서울,강원,687,14,242,11,12,17,983,650,14,278,6,33,24,1005
2020-01-06,서울,경기,143481,6710,9218,4958,3037,9712,177116,136226,7030,9066,4590,3288,9369,169569
2020-01-06,서울,경남,2507,37,482,94,61,85,3266,1742,33,439,219,115,55,2603
2020-01-06,서울,경북,2891,84,350,159,77,94,3655,2609,100,343,316,111,85,3564
2020-01-06,서울,광주,716,14,15,29,10,21,805,635,15,28,53,15,18,764
2020-01-06,서울,대구,1684,36,146,63,28,46,2003,2315,47,198,159,108,74,2901
2020-01-06,서울,대전,1757,47,198,24,5,81,2112,1848,31,210,26,10,101,2226
2020-01-06,서울,부산,173,4,2,21,12,3,215,246,10,10,40,47,10,363
2020-01-06,서울,서울,180,6,8,6,1,12,213,180,6,8,6,1,12,213
2020-01-06,서울,세종,28,0,0,2,1,0,31,35,2,1,2,2,2,44
2020-01-06,서울,울산,40,0,1,0,4,1,46,23,0,7,3,12,0,45
2020-01-06,서울,전남,751,6,25,26,24,27,859,781,14,20,73,42,13,943
2020-01-06,서울,전북,1219,24,37,15,22,38,1355,1132,17,42,27,27,35,1280
2020-01-06,서울,충남,26010,484,2388,694,638,1054,31268,23610,543,2423,1140,1070,936,29722
2020-01-06,서울,충북,14341,539,1175,709,640,587,17991,12310,622,1168,772,739,511,16122
2020-01-06,세종,강원,7,0,1,1,0,0,9,6,0,0,0,0,0,6
2020-01-06,세종,경기,64,1,3,3,1,2,74,41,2,2,6,1,1,53
2020-01-06,세종,경남,267,2,21,9,12,10,321,181,2,11,13,2,3,212
2020-01-06,세종,경북,287,8,13,17,10,10,345,253,8,22,13,10,7,313
2020-01-06,세종,광주,161,2,7,3,2,5,180,152,2,8,4,1,1,168
2020-01-06,세종,대구,173,2,5,8,4,2,194,240,2,14,7,11,7,281
2020-01-06,세종,대전,3314,90,77,32,184,270,3967,3299,77,76,37,150,268,3907
2020-01-06,세종,부산,19,0,0,2,4,0,25,24,1,2,0,1,2,30
2020-01-06,세종,서울,35,2,1,2,2,2,44,28,0,0,2,1,0,31
2020-01-06,세종,세종,242,20,5,1,5,20,293,242,20,5,1,5,20,293
2020-01-06,세종,울산,19,0,0,2,0,1,22,9,0,1,1,2,0,13
2020-01-06,세종,전남,151,3,5,9,13,3,184,150,2,1,6,13,2,174
2020-01-06,세종,전북,702,23,19,6,31,34,815,642,16,20,14,34,26,752
2020-01-06,세종,충남,6092,139,138,95,153,345,6962,4160,131,134,95,120,241,4881
2020-01-06,세종,충북,327,9,17,11,11,24,399,280,11,26,9,13,28,367
2020-01-06,울산,강원,1,0,0,0,1,0,2,1,0,0,0,1,0,2
2020-01-06,울산,경기,38,1,5,19,63,1,127,33,0,1,3,14,1,52
2020-01-06,울산,경남,9150,571,740,458,666,571,12156,10038,631,723,525,663,618,13198
2020-01-06,울산,경북,4600,142,365,331,1179,298,6915,4939,152,350,402,975,303,7121
2020-01-06,울산,광주,66,0,9,3,8,0,86,59,0,11,2,6,1,79
2020-01-06,울산,대구,1276,58,140,66,176,62,1778,1384,53,138,72,177,60,1884
2020-01-06,울산,대전,83,1,9,6,22,0,121,86,6,9,8,25,4,138
2020-01-06,울산,부산,15299,398,448,415,2169,1129,19858,16495,384,508,643,2429,1158,21617
2020-01-06,울산,서울,23,0,7,3,12,0,45,40,0,1,0,4,1,46
2020-01-06,울산,세종,9,0,1,1,2,0,13,19,0,0,2,0,1,22
2020-01-06,울산,울산,7486,266,542,314,613,730,9951,7486,266,542,314,613,730,9951
2020-01-06,울산,전남,183,12,20,17,36,10,278,154,16,23,6,43,10,252
2020-01-06,울산,전북,36,0,8,4,15,1,64,46,1,6,4,4,1,62
2020-01-06,울산,충남,131,2,19,35,135,5,327,127,0,15,23,88,5,258
2020-01-06,울산,충북,21,2,4,20,52,0,99,25,1,1,11,33,2,73
2020-01-06,전남,강원,52,1,7,7,15,4,86,63,2,1,7,8,0,81
2020-01-06,전남,경기,700,13,85,115,106,17,1036,703,15,87,147,120,19,1091
2020-01-06,전남,경남,5838,236,452,406,1165,256,8353,5704,239,475,463,1226,259,8366
2020-01-06,전남,경북,945,31,77,110,545,33,1741,1017,29,84,104,422,33,1689
2020-01-06,전남,광주,29435,837,997,566,1348,1222,34405,31979,858,1118,701,1476,1283,37415
2020-01-06,전남,대구,454,13,44,44,83,22,660,542,11,39,31,62,19,704
2020-01-06,전남,대전,262,7,15,26,23,9,342,292,3,10,16,24,6,351
2020-01-06,전남,부산,1590,72,108,129,506,70,2475,2018,84,127,155,549,91,3024
2020-01-06,전남,서울,781,14,20,73,42,13,943,751,6,25,26,24,27,859
2020-01-06,전남,세종,150,2,1,6,13,2,174,151,3,5,9,13,3,184
2020-01-06,전남,울산,154,16,23,6,43,10,252,183,12,20,17,36,10,278
2020-01-06,전남,전남,41888,1134,1481,1447,4097,1770,51817,41888,1134,1481,1447,4097,1770,51817
2020-01-06,전남,전북,4417,230,485,536,1100,113,6881,4517,197,436,540,1185,128,7003
2020-01-06,전남,충남,3980,83,444,716,1218,118,6559,3891,74,480,463,940,104,5952
2020-01-06,전남,충북,402,17,27,96,230,11,783,384,14,46,82,238,8,772
2020-01-06,전북,강원,167,6,19,28,7,7,234,149,2,12,6,14,6,189
2020-01-06,전북,경기,1392,52,133,162,181,42,1962,1254,34,162,121,172,28,1771
2020-01-06,전북,경남,1322,29,143,82,164,50,1790,1281,32,117,95,170,52,1747
2020-01-06,전북,경북,1398,76,166,155,218,67,2080,1622,80,196,156,203,69,2326
2020-01-06,전북,광주,7257,414,482,295,347,282,9077,7529,381,555,327,347,283,9422
2020-01-06,전북,대구,349,5,41,18,20,7,440,410,5,39,14,22,11,501
2020-01-06,전북,대전,2795,89,86,73,34,137,3214,3095,63,89,50,25,131,3453
2020-01-06,전북,부산,274,8,28,36,70,6,422,371,12,28,31,82,10,534
2020-01-06,전북,서울,1132,17,42,27,27,35,1280,1219,24,37,15,22,38,1355
2020-01-06,전북,세종,642,16,20,14,34,26,752,702,23,19,6,31,34,815
2020-01-06,전북,울산,46,1,6,4,4,1,62,36,0,8,4,15,1,64
2020-01-06,전북,전남,4517,197,436,540,1185,128,7003,4417,230,485,536,1100,113,6881
2020-01-06,전북,전북,14504,588,869,593,545,563,17662,14504,588,869,593,545,563,17662
2020-01-06,전북,충남,12585,458,1594,1044,1239,441,17361,12471,432,1530,822,1216,461,16932
2020-01-06,전북,충북,1841,107,164,304,246,58,2720,1686,98,201,262,217,53,2517
2020-01-06,충남,강원,411,9,24,33,68,17,562,370,8,22,17,28,25,470
2020-01-06,충남,경기,34738,1438,2752,2151,3888,1881,46848,36861,1512,2832,2296,4100,1940,49541
2020-01-06,충남,경남,1626,47,173,252,430,57,2585,1307,38,123,225,189,39,1921
2020-01-06,충남,경북,3156,116,330,411,655,102,4770,3120,118,355,507,565,133,4798
2020-01-06,충남,광주,3682,116,549,486,284,98,5215,3907,98,543,420,276,102,5346
2020-01-06,충남,대구,1089,52,122,147,167,31,1608,1694,67,143,186,273,57,2420
2020-01-06,충남,대전,13614,417,471,260,194,1074,16030,16022,447,526,275,213,1241,18724
2020-01-06,충남,부산,112,6,15,46,141,2,322,212,12,25,46,100,9,404
2020-01-06,충남,서울,23610,543,2423,1140,1070,936,29722,26010,484,2388,694,638,1054,31268
2020-01-06,충남,세종,4160,131,134,95,120,241,4881,6092,139,138,95,153,345,6962
2020-01-06,충남,울산,127,0,15,23,88,5,258,131,2,19,35,135,5,327
2020-01-06,충남,전남,3891,74,480,463,940,104,5952,3980,83,444,716,1218,118,6559
2020-01-06,충남,전북,12471,432,1530,822,1216,461,16932,12585,458,1594,1044,1239,441,17361
2020-01-06,충남,충남,93007,3292,8006,6529,9526,4577,124937,93007,3292,8006,6529,9526,4577,124937
2020-01-06,충남,충북,13155,649,915,911,1272,751,17653,12002,592,924,795,1341,675,16329
2020-01-06,충북,강원,4893,176,262,170,297,280,6078,4996,210,283,228,345,284,6346
2020-01-06,충북,경기,26007,2122,2891,2696,3491,1339,38546,28042,2148,2913,2971,3319,1476,40869
2020-01-06,충북,경남,1406,73,227,370,574,46,2696,1192,56,154,239,291,34,1966
2020-01-06,충북,경북,4945,214,562,627,909,200,7457,5143,215,526,703,930,215,7732
2020-01-06,충북,광주,606,35,97,133,56,14,941,643,27,73,108,62,18,931
2020-01-06,충북,대구,1297,77,157,151,114,45,1841,1936,83,219,241,342,72,2893
2020-01-06,충북,대전,9269,385,389,158,113,739,11053,10935,438,456,189,148,855,13021
2020-01-06,충북,부산,75,3,15,71,132,2,298,140,8,24,55,159,2,388
2020-01-06,충북,서울,12310,622,1168,772,739,511,16122,14341,539,1175,709,640,587,17991
2020-01-06,충북,세종,280,11,26,9,13,28,367,327,9,17,11,11,24,399
2020-01-06,충북,울산,25,1,1,11,33,2,73,21,2,4,20,52,0,99
2020-01-06,충북,전남,384,14,46,82,238,8,772,402,17,27,96,230,11,783
2020-01-06,충북,전북,1686,98,201,262,217,53,2517,1841,107,164,304,246,58,2720
2020-01-06,충북,충남,12002,592,924,795,1341,675,16329,13155,649,915,911,1272,751,17653
2020-01-06,충북,충북,34675,1808,2288,2232,2905,2124,46032,34675,1808,2288,2232,2905,2124,46032
2020-01-07,강원,강원,53745,1923,2970,1103,1919,3700,65360,53745,1923,2970,1103,1919,3700,65360
2020-01-07,강원,경기,15296,534,1236,618,621,722,19027,14175,579,1163,624,753,737,18031
2020-01-07,강원,경남,168,3,17,17,30,5,240,90,0,6,21,8,4,129
2020-01-07,강원,경북,397,19,44,13,16,14,503,331,8,23,22,18,11,413
2020-01-07,강원,광주,66,1,22,13,6,3,111,65,2,13,8,5,3,96
2020-01-07,강원,대구,206,6,18,6,9,2,247,259,4,25,21,19,5,333
2020-01-07,강원,대전,143,2,31,2,1,6,185,121,5,29,6,1,7,169
2020-01-07,강원,부산,4,0,0,0,0,0,4,6,0,0,1,3,0,10
2020-01-07,강원,서울,520,11,264,11,21,16,843,484,19,229,13,10,19,774
2020-01-07,강원,세종,2,0,0,1,0,0,3,8,0,0,0,1,0,9
2020-01-07,강원,울산,1,0,0,0,1,0,2,2,0,0,1,0,0,3
2020-01-07,강원,전남,43,1,5,0,10,3,62,39,3,4,6,10,1,63
2020-01-07,강원,전북,93,3,12,7,16,4,135,103,4,14,14,17,4,156
2020-01-07,강원,충남,289,6,31,25,26,12,389,325,2,30,35,60,9,461
2020-01-07,강원,충북,4050,202,288,176,247,246,5209,3927,205,283,207,214,224,5060
2020-01-07,경기,강원,14175,579,1163,624,753,737,18031,15296,534,1236,618,621,722,19027
2020-01-07,경기,경기,379696,21189,23630,17672,18569,29398,490154,379696,21189,23630,17672,18569,29398,490154
2020-01-07,경기,경남,2131,99,341,863,603,73,4110,1554,63,258,589,434,47,2945
2020-01-07,경기,경북,3640,187,530,795,537,124,5813,3463,199,497,882,493,98,5632
2020-01-07,경기,광주,694,26,178,339,141,20,1398,583,25,138,231,123,14,1114
2020-01-07,경기,대구,1801,93,248,438,233,46,2859,2294,120,263,470,484,75,3706
2020-01-07,경기,대전,1622,98,212,129,58,75,2194,1689,107,179,104,49,61,2189
2020-01-07,경기,부산,171,26,39,193,127,7,563,208,19,43,174,292,3,739
2020-01-07,경기,서울,129874,6771,8886,4824,2565,9061,161981,129779,6425,8967,4670,2438,8954,161233
2020-01-07,경기,세종,48,3,3,7,2,1,64,42,5,3,3,1,0,54
2020-01-07,경기,울산,34,1,3,19,34,1,92,46,3,8,38,127,0,222
2020-01-07,경기,전남,663,15,99,171,133,18,1099,591,15,81,128,123,19,957
2020-01-07,경기,전북,1015,45,173,155,178,36,1602,1046,44,148,176,162,35,1611
2020-01-07,경기,충남,31393,1455,2802,2410,3845,1601,43506,30675,1339,2722,2358,3557,1605,42256
2020-01-07,경기,충북,23395,2012,2831,2836,2923,1152,35149,22668,1972,2668,2704,2678,1094,33784
2020-01-07,경남,강원,90,0,6,21,8,4,129,168,3,17,17,30,5,240
2020-01-07,경남,경기,1554,63,258,589,434,47,2945,2131,99,341,863,603,73,4110
2020-01-07,경남,경남,172565,9289,9541,6333,9251,13347,220326,172565,9289,9541,6333,9251,13347,220326
2020-01-07,경남,경북,8288,524,967,829,1619,378,12605,10685,807,1219,1210,2401,467,16789
2020-01-07,경남,광주,964,41,158,182,125,25,1495,859,29,156,167,103,20,1334
2020-01-07,경남,대구,11524,728,1040,1085,1674,461,16512,9397,509,771,400,468,390,11935
2020-01-07,경남,대전,587,21,95,77,27,17,824,819,25,110,134,58,28,1174
2020-01-07,경남,부산,78375,2467,2849,1288,3820,5755,94554,77308,2501,2916,1367,3917,5763,93772
2020-01-07,경남,서울,1362,32,442,276,128,37,2277,1863,47,453,191,122,64,2740
2020-01-07,경남,세종,159,0,14,7,4,7,191,185,4,15,17,8,4,233
2020-01-07,경남,울산,8780,596,705,494,577,566,11718,8269,547,736,432,605,525,11114
2020-01-07,경남,전남,4866,211,421,430,1105,218,7251,4875,234,427,380,1089,215,7220
2020-01-07,경남,전북,925,42,126,113,114,41,1361,992,38,123,96,123,30,1402
2020-01-07,경남,충남,1011,44,153,234,203,33,1678,1326,56,186,374,526,38,2506
2020-01-07,경남,충북,894,48,159,261,250,25,1637,1173,72,204,476,599,33,2557
2020-01-07,경북,강원,331,8,23,22,18,11,413,397,19,44,13,16,14,503
2020-01-07,경북,경기,3463,199,497,882,493,98,5632,3640,187,530,795,537,124,5813
2020-01-07,경북,경남,10685,807,1219,1210,2401,467,16789,8288,524,967,829,1619,378,12605
2020-01-07,경북,경북,63879,3539,4126,2799,3459,3408,81210,63879,3539,4126,2799,3459,3408,81210
2020-01-07,경북,광주,744,51,124,198,109,8,1234,649,42,118,143,74,10,1036
2020-01-07,경북,대구,64546,2654,2710,1423,1764,3696,76793,66520,2758,3156,1763,2362,3738,80297
2020-01-07,경북,대전,1386,58,126,97,74,62,1803,1482,42,127,135,73,58,1917
2020-01-07,경북,부산,3746,111,304,191,526,153,5031,3763,135,335,207,750,191,5381
2020-01-07,경북,서울,2136,96,340,401,122,57,3152,2303,69,336,224,92,63,3087
2020-01-07,경북,세종,216,6,21,15,9,7,274,214,8,17,17,6,4,266
2020-01-07,경북,울산,4263,146,350,428,963,255,6405,4064,151,341,342,1163,234,6295
2020-01-07,경북,전남,829,35,63,111,457,20,1515,822,36,80,96,546,15,1595
2020-01-07,경북,전북,1380,87,182,186,198,48,2081,1261,87,172,157,186,37,1900
2020-01-07,경북,충남,2548,133,369,554,549,93,4246,2698,112,331,459,703,93,4396
2020-01-07,경북,충북,4235,203,515,671,708,172,6504,4020,220,549,634,731,151,6305
2020-01-07,광주,강원,65,2,13,8,5,3,96,66,1,22,13,6,3,111
2020-01-07,광주,경기,583,25,138,231,123,14,1114,694,26,178,339,141,20,1398
2020-01-07,광주,경남,859,29,156,167,103,20,1334,964,41,158,182,125,25,1495
2020-01-07,광주,경북,649,42,118,143,74,10,1036,744,51,124,198,109,8,1234
2020-01-07,광주,광주,11133,416,604,308,168,522,13151,11133,416,604,308,168,522,13151
2020-01-07,광주,대구,525,30,94,98,29,10,786,533,25,108,82,24,10,782
2020-01-07,광주,대전,426,23,21,22,14,15,521,436,18,19,38,16,12,539
2020-01-07,광주,부산,379,5,54,42,72,9,561,406,15,61,87,106,15,690
2020-01-07,광주,서울,505,19,24,65,22,12,647,670,24,24,55,19,26,818
2020-01-07,광주,세종,131,1,7,6,2,4,151,152,2,7,3,3,4,171
2020-01-07,광주,울산,54,1,9,2,4,0,70,42,0,6,3,12,1,64
2020-01-07,광주,전남,28546,814,1096,656,1263,1130,33505,27789,818,944,551,1128,1112,32342
2020-01-07,광주,전북,6585,421,528,345,327,262,8468,6845,428,474,300,308,276,8631
2020-01-07,광주,충남,3211,118,535,469,293,72,4698,3354,140,556,602,384,79,5115
2020-01-07,광주,충북,504,14,68,96,60,17,759,569,22,92,182,91,13,969
2020-01-07,대구,강원,259,4,25,21,19,5,333,206,6,18,6,9,2,247
2020-01-07,대구,경기,2294,120,263,470,484,75,3706,1801,93,248,438,233,46,2859
2020-01-07,대구,경남,9397,509,771,400,468,390,11935,11524,728,1040,1085,1674,461,16512
2020-01-07,대구,경북,66520,2758,3156,1763,2362,3738,80297,64546,2654,2710,1423,1764,3696,76793
2020-01-07,대구,광주,533,25,108,82,24,10,782,525,30,94,98,29,10,786
2020-01-07,대구,대구,55502,1998,1784,766,865,3770,64685,55502,1998,1784,766,865,3770,64685
2020-01-07,대구,대전,742,41,74,83,39,30,1009,568,26,44,55,22,21,736
2020-01-07,대구,부산,542,49,104,49,133,23,900,2437,101,220,88,210,97,3153
2020-01-07,대구,서울,1850,63,197,271,124,53,2558,1324,55,154,139,58,28,1758
2020-01-07,대구,세종,211,3,10,7,8,6,245,146,2,8,2,1,5,164
2020-01-07,대구,울산,1128,45,145,68,151,70,1607,1078,53,145,65,168,54,1563
2020-01-07,대구,전남,405,9,32,22,57,18,543,399,10,41,32,84,10,576
2020-01-07,대구,전북,274,15,40,15,13,4,361,290,12,42,17,15,7,383
2020-01-07,대구,충남,1246,69,158,213,237,35,1958,976,56,135,164,165,30,1526
2020-01-07,대구,충북,1499,87,233,264,365,46,2494,1196,82,167,239,135,28,1847
2020-01-07,대전,강원,121,5,29,6,1,7,169,143,2,31,2,1,6,185
2020-01-07,대전,경기,1689,107,179,104,49,61,2189,1622,98,212,129,58,75,2194
2020-01-07,대전,경남,819,25,110,134,58,28,1174,587,21,95,77,27,17,824
2020-01-07,대전,경북,1482,42,127,135,73,58,1917,1386,58,126,97,74,62,1803
2020-01-07,대전,광주,436,18,19,38,16,12,539,426,23,21,22,14,15,521
2020-01-07,대전,대구,568,26,44,55,22,21,736,742,41,74,83,39,30,1009
2020-01-07,대전,대전,12580,357,403,180,166,963,14649,12580,357,403,180,166,963,14649
2020-01-07,대전,부산,58,5,4,24,21,1,113,64,1,8,19,15,0,107
2020-01-07,대전,서울,1347,47,202,40,8,61,1705,1377,50,203,44,5,64,1743
2020-01-07,대전,세종,3138,85,71,20,84,267,3665,3145,85,74,21,80,240,3645
2020-01-07,대전,울산,90,1,12,22,26,2,153,83,5,12,7,28,5,140
2020-01-07,대전,전남,226,4,7,26,32,7,302,220,2,12,29,17,8,288
2020-01-07,대전,전북,2543,70,88,87,31,132,2951,2574,78,74,70,36,117,2949
2020-01-07,대전,충남,14568,391,506,235,212,1160,17072,13379,359,467,200,183,1000,15588
2020-01-07,대전,충북,9917,438,427,193,117,770,11862,9073,355,386,175,87,702,10778
2020-01-07,부산,강원,6,0,0,1,3,0,10,4,0,0,0,0,0,4
2020-01-07,부산,경기,208,19,43,174,292,3,739,171,26,39,193,127,7,563
2020-01-07,부산,경남,77308,2501,2916,1367,3917,5763,93772,78375,2467,2849,1288,3820,5755,94554
2020-01-07,부산,경북,3763,135,335,207,750,191,5381,3746,111,304,191,526,153,5031
2020-01-07,부산,광주,406,15,61,87,106,15,690,379,5,54,42,72,9,561
2020-01-07,부산,대구,2437,101,220,88,210,97,3153,542,49,104,49,133,23,900
2020-01-07,부산,대전,64,1,8,19,15,0,107,58,5,4,24,21,1,113
2020-01-07,부산,부산,34395,655,558,451,1617,2667,40343,34395,655,558,451,1617,2667,40343
2020-01-07,부산,서울,160,12,14,77,71,5,339,154,9,21,68,22,2,276
2020-01-07,부산,세종,17,0,1,3,1,1,23,14,0,1,1,1,0,17
2020-01-07,부산,울산,14469,388,452,583,2346,1009,19247,14818,401,389,436,2205,1046,19295
2020-01-07,부산,전남,1637,74,135,170,578,60,2654,1541,70,133,132,579,68,2523
2020-01-07,부산,전북,289,10,32,43,96,5,475,260,10,35,50,56,8,419
2020-01-07,부산,충남,129,14,30,70,149,4,396,111,7,27,77,209,2,433
2020-01-07,부산,충북,97,15,15,83,197,3,410,98,15,17,108,162,5,405
2020-01-07,서울,강원,484,19,229,13,10,19,774,520,11,264,11,21,16,843
2020-01-07,서울,경기,129779,6425,8967,4670,2438,8954,161233,129874,6771,8886,4824,2565,9061,161981
2020-01-07,서울,경남,1863,47,453,191,122,64,2740,1362,32,442,276,128,37,2277
2020-01-07,서울,경북,2303,69,336,224,92,63,3087,2136,96,340,401,122,57,3152
2020-01-07,서울,광주,670,24,24,55,19,26,818,505,19,24,65,22,12,647
2020-01-07,서울,대구,1324,55,154,139,58,28,1758,1850,63,197,271,124,53,2558
2020-01-07,서울,대전,1377,50,203,44,5,64,1743,1347,47,202,40,8,61,1705
2020-01-07,서울,부산,154,9,21,68,22,2,276,160,12,14,77,71,5,339
2020-01-07,서울,서울,172,9,2,7,2,7,199,172,9,2,7,2,7,199
2020-01-07,서울,세종,40,0,1,1,0,2,44,24,0,1,2,0,4,31
2020-01-07,서울,울산,32,2,6,6,1,1,48,24,3,3,18,20,0,68
2020-01-07,서울,전남,664,8,26,46,24,29,797,620,13,31,68,52,28,812
2020-01-07,서울,전북,990,13,54,36,23,22,1138,974,27,53,45,27,30,1156
2020-01-07,서울,충남,20152,452,2316,798,612,741,25071,20110,550,2312,1251,944,790,25957
2020-01-07,서울,충북,11390,483,1138,713,576,463,14763,11153,609,1158,754,558,440,14672
2020-01-07,세종,강원,8,0,0,0,1,0,9,2,0,0,1,0,0,3
2020-01-07,세종,경기,42,5,3,3,1,0,54,48,3,3,7,2,1,64
2020-01-07,세종,경남,185,4,15,17,8,4,233,159,0,14,7,4,7,191
2020-01-07,세종,경북,214,8,17,17,6,4,266,216,6,21,15,9,7,274
2020-01-07,세종,광주,152,2,7,3,3,4,171,131,1,7,6,2,4,151
2020-01-07,세종,대구,146,2,8,2,1,5,164,211,3,10,7,8,6,245
2020-01-07,세종,대전,3145,85,74,21,80,240,3645,3138,85,71,20,84,267,3665
2020-01-07,세종,부산,14,0,1,1,1,0,17,17,0,1,3,1,1,23
2020-01-07,세종,서울,24,0,1,2,0,4,31,40,0,1,1,0,2,44
2020-01-07,세종,세종,231,17,3,2,0,21,274,231,17,3,2,0,21,274
2020-01-07,세종,울산,5,0,0,1,2,1,9,10,1,0,1,4,1,17
2020-01-07,세종,전남,103,2,3,8,17,6,139,132,2,0,5,20,4,163
2020-01-07,세종,전북,546,9,19,10,27,17,628,534,15,14,16,23,18,620
2020-01-07,세종,충남,5019,137,137,99,109,275,5776,3902,110,155,84,112,184,4547
2020-01-07,세종,충북,326,16,22,21,10,21,416,296,21,17,11,13,13,371
2020-01-07,울산,강원,2,0,0,1,0,0,3,1,0,0,0,1,0,2
2020-01-07,울산,경기,46,3,8,38,127,0,222,34,1,3,19,34,1,92
2020-01-07,울산,경남,8269,547,736,432,605,525,11114,8780,596,705,494,577,566,11718
2020-01-07,울산,경북,4064,151,341,342,1163,234,6295,4263,146,350,428,963,255,6405
2020-01-07,울산,광주,42,0,6,3,12,1,64,54,1,9,2,4,0,70
2020-01-07,울산,대구,1078,53,145,65,168,54,1563,1128,45,145,68,151,70,1607
2020-01-07,울산,대전,83,5,12,7,28,5,140,90,1,12,22,26,2,153
2020-01-07,울산,부산,14818,401,389,436,2205,1046,19295,14469,388,452,583,2346,1009,19247
2020-01-07,울산,서울,24,3,3,18,20,0,68,32,2,6,6,1,1,48
2020-01-07,울산,세종,10,1,0,1,4,1,17,5,0,0,1,2,1,9
2020-01-07,울산,울산,7591,245,524,291,514,720,9885,7591,245,524,291,514,720,9885
2020-01-07,울산,전남,136,17,23,14,29,4,223,159,14,27,8,60,3,271
2020-01-07,울산,전북,47,0,7,3,14,0,71,44,0,7,6,10,1,68
2020-01-07,울산,충남,101,8,25,50,139,3,326,104,7,19,49,130,6,315
2020-01-07,울산,충북,15,5,3,30,54,1,108,25,1,4,19,39,0,88
2020-01-07,전남,강원,39,3,4,6,10,1,63,43,1,5,0,10,3,62
2020-01-07,전남,경기,591,15,81,128,123,19,957,663,15,99,171,133,18,1099
2020-01-07,전남,경남,4875,234,427,380,1089,215,7220,4866,211,421,430,1105,218,7251
2020-01-07,전남,경북,822,36,80,96,546,15,1595,829,35,63,111,457,20,1515
2020-01-07,전남,광주,27789,818,944,551,1128,1112,32342,28546,814,1096,656,1263,1130,33505
2020-01-07,전남,대구,399,10,41,32,84,10,576,405,9,32,22,57,18,543
2020-01-07,전남,대전,220,2,12,29,17,8,288,226,4,7,26,32,7,302
2020-01-07,전남,부산,1541,70,133,132,579,68,2523,1637,74,135,170,578,60,2654
2020-01-07,전남,서울,620,13,31,68,52,28,812,664,8,26,46,24,29,797
2020-01-07,전남,세종,132,2,0,5,20,4,163,103,2,3,8,17,6,139
2020-01-07,전남,울산,159,14,27,8,60,3,271,136,17,23,14,29,4,223
2020-01-07,전남,전남,39242,1082,1382,1294,3552,1589,48141,39242,1082,1382,1294,3552,1589,48141
2020-01-07,전남,전북,3834,243,509,508,1116,123,6333,3756,205,461,487,1089,107,6105
2020-01-07,전남,충남,3195,73,410,707,1195,87,5667,3371,85,455,512,997,82,5502
2020-01-07,전남,충북,331,28,30,96,242,8,735,318,20,48,99,244,8,737
2020-01-07,전북,강원,103,4,14,14,17,4,156,93,3,12,7,16,4,135
2020-01-07,전북,경기,1046,44,148,176,162,35,1611,1015,45,173,155,178,36,1602
2020-01-07,전북,경남,992,38,123,96,123,30,1402,925,42,126,113,114,41,1361
2020-01-07,전북,경북,1261,87,172,157,186,37,1900,1380,87,182,186,198,48,2081
2020-01-07,전북,광주,6845,428,474,300,308,276,8631,6585,421,528,345,327,262,8468
2020-01-07,전북,대구,290,12,42,17,15,7,383,274,15,40,15,13,4,361
2020-01-07,전북,대전,2574,78,74,70,36,117,2949,2543,70,88,87,31,132,2951
2020-01-07,전북,부산,260,10,35,50,56,8,419,289,10,32,43,96,5,475
2020-01-07,전북,서울,974,27,53,45,27,30,1156,990,13,54,36,23,22,1138
2020-01-07,전북,세종,534,15,14,16,23,18,620,546,9,19,10,27,17,628
2020-01-07,전북,울산,44,0,7,6,10,1,68,47,0,7,3,14,0,71
2020-01-07,전북,전남,3756,205,461,487,1089,107,6105,3834,243,509,508,1116,123,6333
2020-01-07,전북,전북,14012,538,881,689,569,587,17276,14012,538,881,689,569,587,17276
2020-01-07,전북,충남,10440,473,1603,1092,1196,341,15145,10703,466,1576,951,1199,328,15223
2020-01-07,전북,충북,1490,97,154,265,232,43,2281,1506,109,199,270,226,43,2353
2020-01-07,충남,강원,325,2,30,35,60,9,461,289,6,31,25,26,12,389
2020-01-07,충남,경기,30675,1339,2722,2358,3557,1605,42256,31393,1455,2802,2410,3845,1601,43506
2020-01-07,충남,경남,1326,56,186,374,526,38,2506,1011,44,153,234,203,33,1678
2020-01-07,충남,경북,2698,112,331,459,703,93,4396,2548,133,369,554,549,93,4246
2020-01-07,충남,광주,3354,140,556,602,384,79,5115,3211,118,535,469,293,72,4698
2020-01-07,충남,대구,976,56,135,164,165,30,1526,1246,69,158,213,237,35,1958
2020-01-07,충남,대전,13379,359,467,200,183,1000,15588,14568,391,506,235,212,1160,17072
2020-01-07,충남,부산,111,7,27,77,209,2,433,129,14,30,70,149,4,396
2020-01-07,충남,서울,20110,550,2312,1251,944,790,25957,20152,452,2316,798,612,741,25071
2020-01-07,충남,세종,3902,110,155,84,112,184,4547,5019,137,137,99,109,275,5776
2020-01-07,충남,울산,104,7,19,49,130,6,315,101,8,25,50,139,3,326
2020-01-07,충남,전남,3371,85,455,512,997,82,5502,3195,73,410,707,1195,87,5667
2020-01-07,충남,전북,10703,466,1576,951,1199,328,15223,10440,473,1603,1092,1196,341,15145
2020-01-07,충남,충남,81900,3204,8049,6639,9087,3938,112817,81900,3204,8049,6639,9087,3938,112817
2020-01-07,충남,충북,12160,650,874,944,1185,771,16584,10880,586,830,796,1206,671,14969
2020-01-07,충북,강원,3927,205,283,207,214,224,5060,4050,202,288,176,247,246,5209
2020-01-07,충북,경기,22668,1972,2668,2704,2678,1094,33784,23395,2012,2831,2836,2923,1152,35149
2020-01-07,충북,경남,1173,72,204,476,599,33,2557,894,48,159,261,250,25,1637
2020-01-07,충북,경북,4020,220,549,634,731,151,6305,4235,203,515,671,708,172,6504
2020-01-07,충북,광주,569,22,92,182,91,13,969,504,14,68,96,60,17,759
2020-01-07,충북,대구,1196,82,167,239,135,28,1847,1499,87,233,264,365,46,2494
2020-01-07,충북,대전,9073,355,386,175,87,702,10778,9917,438,427,193,117,770,11862
2020-01-07,충북,부산,98,15,17,108,162,5,405,97,15,15,83,197,3,410
2020-01-07,충북,서울,11153,609,1158,754,558,440,14672,11390,483,1138,713,576,463,14763
2020-01-07,충북,세종,296,21,17,11,13,13,371,326,16,22,21,10,21,416
2020-01-07,충북,울산,25,1,4,19,39,0,88,15,5,3,30,54,1,108
2020-01-07,충북,전남,318,20,48,99,244,8,737,331,28,30,96,242,8,735
2020-01-07,충북,전북,1506,109,199,270,226,43,2353,1490,97,154,265,232,43,2281
2020-01-07,충북,충남,10880,586,830,796,1206,671,14969,12160,650,874,944,1185,771,16584
2020-01-07,충북,충북,32540,1774,2212,2081,2174,2058,42839,32540,1774,2212,2081,2174,2058,42839
2020-01-08,강원,강원,55984,1950,2941,1246,1388,4056,67565,55984,1950,2941,1246,1388,4056,67565
2020-01-08,강원,경기,14604,508,1249,593,580,737,18271,15961,556,1270,639,761,787,19974
2020-01-08,강원,경남,152,4,11,15,18,5,205,92,2,7,17,8,1,127
2020-01-08,강원,경북,405,23,38,16,23,7,512,407,17,31,25,17,12,509
2020-01-08,강원,광주,66,3,23,12,12,4,120,59,1,20,8,4,0,92
2020-01-08,강원,대구,204,1,11,8,8,4,236,274,10,26,22,23,3,358
2020-01-08,강원,대전,107,4,37,6,1,3,158,140,5,35,2,1,6,189
2020-01-08,강원,부산,6,0,2,1,2,0,11,2,0,0,1,3,0,6
2020-01-08,강원,서울,517,16,282,8,20,31,874,642,14,244,13,11,17,941
2020-01-08,강원,세종,10,0,0,0,0,1,11,9,0,0,0,0,1,10
2020-01-08,강원,울산,4,0,0,0,0,0,4,1,0,0,0,0,0,1
2020-01-08,강원,전남,48,0,5,2,6,2,63,42,0,1,3,9,1,56
2020-01-08,강원,전북,133,3,13,9,15,2,175,119,4,12,14,13,4,166
2020-01-08,강원,충남,261,8,29,19,32,12,361,330,5,39,34,66,10,484
2020-01-08,강원,충북,4133,197,272,205,308,244,5359,4268,186,269,206,217,241,5387
2020-01-08,경기,강원,15961,556,1270,639,761,787,19974,14604,508,1249,593,580,737,18271
2020-01-08,경기,경기,399725,22384,24299,18164,20560,30944,516076,399725,22384,24299,18164,20560,30944,516076
2020-01-08,경기,경남,2365,84,349,876,622,63,4359,1540,68,259,532,401,56,2856
2020-01-08,경기,경북,3838,185,467,844,590,108,6032,3644,149,481,915,511,96,5796
2020-01-08,경기,광주,861,31,186,350,160,18,1606,645,23,138,242,122,11,1181
2020-01-08,경기,대구,1759,90,211,413,253,53,2779,2308,123,206,472,462,73,3644
2020-01-08,경기,대전,1783,95,217,111,42,49,2297,1780,96,200,99,46,76,2297
2020-01-08,경기,부산,191,19,59,190,128,4,591,210,19,26,152,283,8,698
2020-01-08,경기,서울,137807,7110,9087,4887,2728,9686,171305,137423,6707,9263,4648,2607,9554,170202
2020-01-08,경기,세종,47,1,3,4,3,1,59,50,4,4,3,5,0,66
2020-01-08,경기,울산,39,0,7,28,29,1,104,29,2,9,49,95,1,185
2020-01-08,경기,전남,694,16,97,180,159,21,1167,594,17,74,121,143,22,971
2020-01-08,경기,전북,1144,47,168,132,179,31,1701,1097,44,157,143,192,36,1669
2020-01-08,경기,충남,32614,1469,2872,2496,3980,1689,45120,32255,1386,2734,2424,3578,1592,43969
2020-01-08,경기,충북,24190,2179,2847,3018,2916,1179,36329,23693,2056,2758,2753,2816,1177,35253
2020-01-08,경남,강원,92,2,7,17,8,1,127,152,4,11,15,18,5,205
2020-01-08,경남,경기,1540,68,259,532,401,56,2856,2365,84,349,876,622,63,4359
2020-01-08,경남,경남,186309,10094,10289,6958,10804,14228,238682,186309,10094,10289,6958,10804,14228,238682
2020-01-08,경남,경북,9176,646,1000,830,1741,392,13785,11754,852,1221,1211,2576,493,18107
2020-01-08,경남,광주,979,63,126,203,146,23,1540,995,50,141,145,102,31,1464
2020-01-08,경남,대구,12662,764,1021,1085,1765,559,17856,10375,543,765,457,489,466,13095
2020-01-08,경남,대전,583,29,98,80,28,25,843,814,20,100,114,55,39,1142
2020-01-08,경남,부산,84862,2721,2962,1567,3787,6091,101990,83960,2793,3079,1653,4085,6136,101706
2020-01-08,경남,서울,1455,37,424,287,151,46,2400,2171,49,442,180,115,64,3021
2020-01-08,경남,세종,164,2,16,12,4,3,201,241,2,25,17,14,6,305
2020-01-08,경남,울산,9495,642,739,479,626,614,12595,8872,561,733,463,595,565,11789
2020-01-08,경남,전남,5274,253,481,473,1275,219,7975,5301,268,438,406,1129,205,7747
2020-01-08,경남,전북,986,22,126,94,136,33,1397,964,40,112,102,125,29,1372
2020-01-08,경남,충남,939,46,122,215,208,33,1563,1354,69,166,330,577,33,2529
2020-01-08,경남,충북,865,48,129,276,226,28,1572,1260,78,206,468,589,44,2645
2020-01-08,경북,강원,407,17,31,25,17,12,509,405,23,38,16,23,7,512
2020-01-08,경북,경기,3644,149,481,915,511,96,5796,3838,185,467,844,590,108,6032
2020-01-08,경북,경남,11754,852,1221,1211,2576,493,18107,9176,646,1000,830,1741,392,13785
2020-01-08,경북,경북,69698,3675,4279,2905,3826,3717,88100,69698,3675,4279,2905,3826,3717,88100
2020-01-08,경북,광주,718,54,129,207,117,16,1241,765,56,103,155,88,15,1182
2020-01-08,경북,대구,68971,2878,2931,1484,1983,3882,82129,71353,3037,3359,1814,2533,3910,86006
2020-01-08,경북,대전,1516,52,129,112,84,63,1956,1565,57,127,144,64,61,2018
2020-01-08,경북,부산,3822,124,323,194,548,188,5199,4055,129,345,182,766,174,5651
2020-01-08,경북,서울,2171,103,342,374,126,56,3172,2506,83,346,210,111,77,3333
2020-01-08,경북,세종,278,3,19,18,12,8,338,277,8,18,18,6,10,337
2020-01-08,경북,울산,4605,182,363,393,982,262,6787,4557,183,349,335,1163,264,6851
2020-01-08,경북,전남,921,36,62,119,407,27,1572,935,34,72,84,576,26,1727
2020-01-08,경북,전북,1455,78,181,202,203,45,2164,1353,84,175,150,218,28,2008
2020-01-08,경북,충남,2700,123,385,561,530,90,4389,2900,99,409,510,720,110,4748
2020-01-08,경북,충북,4379,213,527,668,782,161,6730,4324,220,530,628,821,158,6681
2020-01-08,광주,강원,59,1,20,8,4,0,92,66,3,23,12,12,4,120
2020-01-08,광주,경기,645,23,138,242,122,11,1181,861,31,186,350,160,18,1606
2020-01-08,광주,경남,995,50,141,145,102,31,1464,979,63,126,203,146,23,1540
2020-01-08,광주,경북,765,56,103,155,88,15,1182,718,54,129,207,117,16,1241
2020-01-08,광주,광주,11862,448,654,364,188,543,14059,11862,448,654,364,188,543,14059
2020-01-08,광주,대구,556,26,100,78,28,16,804,583,24,112,67,31,15,832
2020-01-08,광주,대전,427,14,15,20,14,11,501,479,21,15,26,16,13,570
2020-01-08,광주,부산,397,13,43,38,67,2,560,412,15,63,95,120,10,715
2020-01-08,광주,서울,558,16,19,66,15,23,697,681,21,27,45,15,15,804
2020-01-08,광주,세종,139,2,9,5,2,1,158,154,5,7,10,2,7,185
2020-01-08,광주,울산,51,0,11,2,6,3,73,39,1,12,5,13,2,72
2020-01-08,광주,전남,30728,906,1183,766,1436,1206,36225,29814,892,1021,582,1284,1193,34786
2020-01-08,광주,전북,6890,420,570,347,328,246,8801,7153,436,543,327,320,261,9040
2020-01-08,광주,충남,3389,110,563,461,304,82,4909,3586,117,573,630,386,86,5378
2020-01-08,광주,충북,509,29,65,102,53,18,776,584,32,93,176,99,23,1007
2020-01-08,대구,강원,274,10,26,22,23,3,358,204,1,11,8,8,4,236
2020-01-08,대구,경기,2308,123,206,472,462,73,3644,1759,90,211,413,253,53,2779
2020-01-08,대구,경남,10375,543,765,457,489,466,13095,12662,764,1021,1085,1765,559,17856
2020-01-08,대구,경북,71353,3037,3359,1814,2533,3910,86006,68971,2878,2931,1484,1983,3882,82129
2020-01-08,대구,광주,583,24,112,67,31,15,832,556,26,100,78,28,16,804
2020-01-08,대구,대구,58696,2227,1830,821,882,3988,68444,58696,2227,1830,821,882,3988,68444
2020-01-08,대구,대전,839,40,56,72,43,34,1084,618,35,35,55,22,21,786
2020-01-08,대구,부산,622,52,112,66,154,18,1024,2669,99,232,90,233,111,3434
2020-01-08,대구,서울,1944,61,193,236,119,54,2607,1536,46,142,130,48,42,1944
2020-01-08,대구,세종,220,1,12,7,5,6,251,140,1,7,1,4,3,156
2020-01-08,대구,울산,1271,59,146,82,149,57,1764,1207,58,139,75,187,53,1719
2020-01-08,대구,전남,453,18,40,28,53,10,602,446,23,42,34,80,12,637
2020-01-08,대구,전북,353,7,33,14,21,4,432,321,13,37,17,33,7,428
2020-01-08,대구,충남,1302,68,144,192,246,38,1990,998,73,115,160,168,21,1535
2020-01-08,대구,충북,1573,78,204,280,377,55,2567,1189,91,166,208,107,40,1801
2020-01-08,대전,강원,140,5,35,2,1,6,189,107,4,37,6,1,3,158
2020-01-08,대전,경기,1780,96,200,99,46,76,2297,1783,95,217,111,42,49,2297
2020-01-08,대전,경남,814,20,100,114,55,39,1142,583,29,98,80,28,25,843
2020-01-08,대전,경북,1565,57,127,144,64,61,2018,1516,52,129,112,84,63,1956
2020-01-08,대전,광주,479,21,15,26,16,13,570,427,14,15,20,14,11,501
2020-01-08,대전,대구,618,35,35,55,22,21,786,839,40,56,72,43,34,1084
2020-01-08,대전,대전,12873,370,384,191,171,1005,14994,12873,370,384,191,171,1005,14994
2020-01-08,대전,부산,63,3,8,16,11,3,104,50,4,5,23,24,0,106
2020-01-08,대전,서울,1518,32,204,32,11,68,1865,1499,37,202,33,8,60,1839
2020-01-08,대전,세종,3201,76,82,25,93,276,3753,3252,87,75,35,82,257,3788
2020-01-08,대전,울산,87,10,9,17,27,0,150,68,1,9,8,15,0,101
2020-01-08,대전,전남,245,4,9,22,28,3,311,261,9,9,20,20,6,325
2020-01-08,대전,전북,2596,88,83,76,35,129,3007,2559,80,91,81,38,121,2970
2020-01-08,대전,충남,15053,419,511,215,190,1187,17575,13493,434,473,227,200,1034,15861
2020-01-08,대전,충북,10323,459,446,180,123,809,12340,9299,404,391,163,92,730,11079
2020-01-08,부산,강원,2,0,0,1,3,0,6,6,0,2,1,2,0,11
2020-01-08,부산,경기,210,19,26,152,283,8,698,191,19,59,190,128,4,591
2020-01-08,부산,경남,83960,2793,3079,1653,4085,6136,101706,84862,2721,2962,1567,3787,6091,101990
2020-01-08,부산,경북,4055,129,345,182,766,174,5651,3822,124,323,194,548,188,5199
2020-01-08,부산,광주,412,15,63,95,120,10,715,397,13,43,38,67,2,560
2020-01-08,부산,대구,2669,99,232,90,233,111,3434,622,52,112,66,154,18,1024
2020-01-08,부산,대전,50,4,5,23,24,0,106,63,3,8,16,11,3,104
2020-01-08,부산,부산,38287,677,631,566,1729,2839,44729,38287,677,631,566,1729,2839,44729
2020-01-08,부산,서울,161,15,26,73,50,5,330,154,8,25,60,35,6,288
2020-01-08,부산,세종,16,0,2,1,4,1,24,14,0,1,2,0,0,17
2020-01-08,부산,울산,15922,370,480,614,2373,1072,20831,15956,419,415,423,2301,1131,20645
2020-01-08,부산,전남,1761,77,130,189,495,57,2709,1656,62,125,141,514,50,2548
2020-01-08,부산,전북,300,8,31,36,101,7,483,260,8,33,30,66,7,404
2020-01-08,부산,충남,111,9,23,49,138,2,332,114,13,27,84,167,0,405
2020-01-08,부산,충북,85,13,18,70,192,3,381,94,9,26,130,167,4,430
2020-01-08,서울,강원,642,14,244,13,11,17,941,517,16,282,8,20,31,874
2020-01-08,서울,경기,137423,6707,9263,4648,2607,9554,170202,137807,7110,9087,4887,2728,9686,171305
2020-01-08,서울,경남,2171,49,442,180,115,64,3021,1455,37,424,287,151,46,2400
2020-01-08,서울,경북,2506,83,346,210,111,77,3333,2171,103,342,374,126,56,3172
2020-01-08,서울,광주,681,21,27,45,15,15,804,558,16,19,66,15,23,697
2020-01-08,서울,대구,1536,46,142,130,48,42,1944,1944,61,193,236,119,54,2607
2020-01-08,서울,대전,1499,37,202,33,8,60,1839,1518,32,204,32,11,68,1865
2020-01-08,서울,부산,154,8,25,60,35,6,288,161,15,26,73,50,5,330
2020-01-08,서울,서울,162,6,11,2,2,16,199,162,6,11,2,2,16,199
2020-01-08,서울,세종,28,2,0,1,0,1,32,44,0,0,0,0,1,45
2020-01-08,서울,울산,39,1,2,4,4,1,51,22,2,5,11,18,1,59
2020-01-08,서울,전남,737,6,31,28,42,19,863,643,5,22,63,66,13,812
2020-01-08,서울,전북,1129,22,43,26,26,35,1281,970,30,42,40,16,30,1128
2020-01-08,서울,충남,21400,457,2321,811,653,863,26505,21563,601,2326,1275,1033,831,27629
2020-01-08,서울,충북,12084,556,1126,745,578,476,15565,11757,640,1175,757,625,443,15397
2020-01-08,세종,강원,9,0,0,0,0,1,10,10,0,0,0,0,1,11
2020-01-08,세종,경기,50,4,4,3,5,0,66,47,1,3,4,3,1,59
2020-01-08,세종,경남,241,2,25,17,14,6,305,164,2,16,12,4,3,201
2020-01-08,세종,경북,277,8,18,18,6,10,337,278,3,19,18,12,8,338
2020-01-08,세종,광주,154,5,7,10,2,7,185,139,2,9,5,2,1,158
2020-01-08,세종,대구,140,1,7,1,4,3,156,220,1,12,7,5,6,251
2020-01-08,세종,대전,3252,87,75,35,82,257,3788,3201,76,82,25,93,276,3753
2020-01-08,세종,부산,14,0,1,2,0,0,17,16,0,2,1,4,1,24
2020-01-08,세종,서울,44,0,0,0,0,1,45,28,2,0,1,0,1,32
2020-01-08,세종,세종,211,21,1,2,0,19,254,211,21,1,2,0,19,254
2020-01-08,세종,울산,8,0,0,2,1,0,11,7,0,0,1,3,0,11
2020-01-08,세종,전남,153,3,0,11,22,3,192,132,2,4,6,19,4,167
2020-01-08,세종,전북,593,21,22,13,26,22,697,564,10,17,12,23,20,646
2020-01-08,세종,충남,5127,146,158,111,127,260,5929,4047,143,129,111,123,213,4766
2020-01-08,세종,충북,291,8,16,13,14,21,363,301,15,15,10,8,15,364
2020-01-08,울산,강원,1,0,0,0,0,0,1,4,0,0,0,0,0,4
2020-01-08,울산,경기,29,2,9,49,95,1,185,39,0,7,28,29,1,104
2020-01-08,울산,경남,8872,561,733,463,595,565,11789,9495,642,739,479,626,614,12595
2020-01-08,울산,경북,4557,183,349,335,1163,264,6851,4605,182,363,393,982,262,6787
2020-01-08,울산,광주,39,1,12,5,13,2,72,51,0,11,2,6,3,73
2020-01-08,울산,대구,1207,58,139,75,187,53,1719,1271,59,146,82,149,57,1764
2020-01-08,울산,대전,68,1,9,8,15,0,101,87,10,9,17,27,0,150
2020-01-08,울산,부산,15956,419,415,423,2301,1131,20645,15922,370,480,614,2373,1072,20831
2020-01-08,울산,서울,22,2,5,11,18,1,59,39,1,2,4,4,1,51
2020-01-08,울산,세종,7,0,0,1,3,0,11,8,0,0,2,1,0,11
2020-01-08,울산,울산,8064,253,547,247,550,702,10363,8064,253,547,247,550,702,10363
2020-01-08,울산,전남,170,17,22,27,13,8,257,145,10,25,11,45,3,239
2020-01-08,울산,전북,51,0,7,3,13,0,74,42,2,7,2,4,1,58
2020-01-08,울산,충남,88,3,15,49,114,6,275,103,7,14,42,140,3,309
2020-01-08,울산,충북,18,3,5,19,43,0,88,16,0,3,13,34,0,66
2020-01-08,전남,강원,42,0,1,3,9,1,56,48,0,5,2,6,2,63
2020-01-08,전남,경기,594,17,74,121,143,22,971,694,16,97,180,159,21,1167
2020-01-08,전남,경남,5301,268,438,406,1129,205,7747,5274,253,481,473,1275,219,7975
2020-01-08,전남,경북,935,34,72,84,576,26,1727,921,36,62,119,407,27,1572
2020-01-08,전남,광주,29814,892,1021,582,1284,1193,34786,30728,906,1183,766,1436,1206,36225
2020-01-08,전남,대구,446,23,42,34,80,12,637,453,18,40,28,53,10,602
2020-01-08,전남,대전,261,9,9,20,20,6,325,245,4,9,22,28,3,311
2020-01-08,전남,부산,1656,62,125,141,514,50,2548,1761,77,130,189,495,57,2709
2020-01-08,전남,서울,643,5,22,63,66,13,812,737,6,31,28,42,19,863
2020-01-08,전남,세종,132,2,4,6,19,4,167,153,3,0,11,22,3,192
2020-01-08,전남,울산,145,10,25,11,45,3,239,170,17,22,27,13,8,257
2020-01-08,전남,전남,40819,1202,1554,1376,3603,1671,50225,40819,1202,1554,1376,3603,1671,50225
2020-01-08,전남,전북,4016,255,473,480,1055,135,6414,4023,206,480,538,1049,134,6430
2020-01-08,전남,충남,3308,97,416,690,1206,89,5806,3613,69,470,512,1043,105,5812
2020-01-08,전남,충북,302,17,31,87,262,7,706,347,15,62,88,242,4,758
2020-01-08,전북,강원,119,4,12,14,13,4,166,133,3,13,9,15,2,175
2020-01-08,전북,경기,1097,44,157,143,192,36,1669,1144,47,168,132,179,31,1701
2020-01-08,전북,경남,964,40,112,102,125,29,1372,986,22,126,94,136,33,1397
2020-01-08,전북,경북,1353,84,175,150,218,28,2008,1455,78,181,202,203,45,2164
2020-01-08,전북,광주,7153,436,543,327,320,261,9040,6890,420,570,347,328,246,8801
2020-01-08,전북,대구,321,13,37,17,33,7,428,353,7,33,14,21,4,432
2020-01-08,전북,대전,2559,80,91,81,38,121,2970,2596,88,83,76,35,129,3007
2020-01-08,전북,부산,260,8,33,30,66,7,404,300,8,31,36,101,7,483
2020-01-08,전북,서울,970,30,42,40,16,30,1128,1129,22,43,26,26,35,1281
2020-01-08,전북,세종,564,10,17,12,23,20,646,593,21,22,13,26,22,697
2020-01-08,전북,울산,42,2,7,2,4,1,58,51,0,7,3,13,0,74
2020-01-08,전북,전남,4023,206,480,538,1049,134,6430,4016,255,473,480,1055,135,6414
2020-01-08,전북,전북,13995,536,858,728,614,548,17279,13995,536,858,728,614,548,17279
2020-01-08,전북,충남,11005,462,1542,1066,1237,349,15661,11230,451,1482,991,1238,350,15742
2020-01-08,전북,충북,1517,116,208,260,238,61,2400,1613,116,217,260,224,49,2479
2020-01-08,충남,강원,330,5,39,34,66,10,484,261,8,29,19,32,12,361
2020-01-08,충남,경기,32255,1386,2734,2424,3578,1592,43969,32614,1469,2872,2496,3980,1689,45120
2020-01-08,충남,경남,1354,69,166,330,577,33,2529,939,46,122,215,208,33,1563
2020-01-08,충남,경북,2900,99,409,510,720,110,4748,2700,123,385,561,530,90,4389
2020-01-08,충남,광주,3586,117,573,630,386,86,5378,3389,110,563,461,304,82,4909
2020-01-08,충남,대구,998,73,115,160,168,21,1535,1302,68,144,192,246,38,1990
2020-01-08,충남,대전,13493,434,473,227,200,1034,15861,15053,419,511,215,190,1187,17575
2020-01-08,충남,부산,114,13,27,84,167,0,405,111,9,23,49,138,2,332
2020-01-08,충남,서울,21563,601,2326,1275,1033,831,27629,21400,457,2321,811,653,863,26505
2020-01-08,충남,세종,4047,143,129,111,123,213,4766,5127,146,158,111,127,260,5929
2020-01-08,충남,울산,103,7,14,42,140,3,309,88,3,15,49,114,6,275
2020-01-08,충남,전남,3613,69,470,512,1043,105,5812,3308,97,416,690,1206,89,5806
2020-01-08,충남,전북,11230,451,1482,991,1238,350,15742,11005,462,1542,1066,1237,349,15661
2020-01-08,충남,충남,84654,3246,7927,6943,9249,4094,116113,84654,3246,7927,6943,9249,4094,116113
2020-01-08,충남,충북,12687,621,882,934,1308,744,17176,11461,614,880,808,1277,640,15680
2020-01-08,충북,강원,4268,186,269,206,217,241,5387,4133,197,272,205,308,244,5359
2020-01-08,충북,경기,23693,2056,2758,2753,2816,1177,35253,24190,2179,2847,3018,2916,1179,36329
2020-01-08,충북,경남,1260,78,206,468,589,44,2645,865,48,129,276,226,28,1572
2020-01-08,충북,경북,4324,220,530,628,821,158,6681,4379,213,527,668,782,161,6730
2020-01-08,충북,광주,584,32,93,176,99,23,1007,509,29,65,102,53,18,776
2020-01-08,충북,대구,1189,91,166,208,107,40,1801,1573,78,204,280,377,55,2567
2020-01-08,충북,대전,9299,404,391,163,92,730,11079,10323,459,446,180,123,809,12340
2020-01-08,충북,부산,94,9,26,130,167,4,430,85,13,18,70,192,3,381
2020-01-08,충북,서울,11757,640,1175,757,625,443,15397,12084,556,1126,745,578,476,15565
2020-01-08,충북,세종,301,15,15,10,8,15,364,291,8,16,13,14,21,363
2020-01-08,충북,울산,16,0,3,13,34,0,66,18,3,5,19,43,0,88
2020-01-08,충북,전남,347,15,62,88,242,4,758,302,17,31,87,262,7,706
2020-01-08,충북,전북,1613,116,217,260,224,49,2479,1517,116,208,260,238,61,2400
2020-01-08,충북,충남,11461,614,880,808,1277,640,15680,12687,621,882,934,1308,744,17176
2020-01-08,충북,충북,33803,1764,2252,2148,2209,2083,44259,33803,1764,2252,2148,2209,2083,44259
2020-01-09,강원,강원,64485,2268,3316,1335,1840,4336,77580,64485,2268,3316,1335,1840,4336,77580
2020-01-09,강원,경기,16958,626,1309,605,670,852,21020,19117,650,1286,701,821,941,23516
2020-01-09,강원,경남,164,5,17,12,21,7,226,104,1,6,16,9,4,140
2020-01-09,강원,경북,464,24,46,17,19,14,584,465,19,40,30,33,12,599
2020-01-09,강원,광주,81,2,22,4,8,4,121,82,2,14,6,6,1,111
2020-01-09,강원,대구,220,3,9,13,10,0,255,303,10,33,26,16,11,399
2020-01-09,강원,대전,145,5,31,2,0,6,189,184,9,31,4,1,8,237
2020-01-09,강원,부산,4,0,0,1,4,0,9,6,0,1,0,2,0,9
2020-01-09,강원,서울,652,20,278,10,22,28,1010,780,15,226,10,6,26,1063
2020-01-09,강원,세종,10,0,0,0,0,0,10,6,1,0,0,0,0,7
2020-01-09,강원,울산,1,0,1,0,0,0,2,1,0,1,1,0,1,4
2020-01-09,강원,전남,53,0,8,2,14,3,80,51,2,5,8,14,0,80
2020-01-09,강원,전북,121,1,11,10,15,6,164,131,4,13,12,20,2,182
2020-01-09,강원,충남,294,6,15,20,43,9,387,419,11,20,43,83,13,589
2020-01-09,강원,충북,4606,258,319,213,287,287,5970,4875,215,307,213,236,275,6121
2020-01-09,경기,강원,19117,650,1286,701,821,941,23516,16958,626,1309,605,670,852,21020
2020-01-09,경기,경기,418886,23734,25948,18991,24458,31604,543621,418886,23734,25948,18991,24458,31604,543621
2020-01-09,경기,경남,2478,108,329,824,624,75,4438,1757,75,251,609,423,53,3168
2020-01-09,경기,경북,3814,192,495,823,591,119,6034,3944,204,519,932,574,109,6282
2020-01-09,경기,광주,774,36,190,336,182,15,1533,735,31,168,268,108,23,1333
2020-01-09,경기,대구,1883,116,245,397,271,55,2967,2579,136,245,493,507,64,4024
2020-01-09,경기,대전,1966,101,225,116,48,80,2536,1921,122,227,110,39,86,2505
2020-01-09,경기,부산,175,36,37,210,152,6,616,230,21,26,163,303,3,746
2020-01-09,경기,서울,147295,7577,10276,5383,3290,9757,183578,142976,7067,9760,4965,2973,9699,177440
2020-01-09,경기,세종,43,2,2,7,4,2,60,47,3,3,6,4,1,64
2020-01-09,경기,울산,39,0,5,12,29,1,86,44,5,12,40,86,2,189
2020-01-09,경기,전남,691,18,116,179,155,20,1179,731,19,86,144,149,19,1148
2020-01-09,경기,전북,1254,48,184,162,186,43,1877,1243,41,162,184,203,44,1877
2020-01-09,경기,충남,35756,1542,3025,2623,4509,1883,49338,34868,1500,2837,2483,4204,1693,47585
2020-01-09,경기,충북,26860,2271,3155,3327,3250,1322,40185,25856,2177,3056,2881,3221,1227,38418
2020-01-09,경남,강원,104,1,6,16,9,4,140,164,5,17,12,21,7,226
2020-01-09,경남,경기,1757,75,251,609,423,53,3168,2478,108,329,824,624,75,4438
2020-01-09,경남,경남,192548,10581,10747,7222,12615,14716,248429,192548,10581,10747,7222,12615,14716,248429
2020-01-09,경남,경북,10199,643,1073,895,1908,444,15162,12954,905,1322,1297,2701,563,19742
2020-01-09,경남,광주,1095,42,162,217,157,20,1693,1113,35,165,177,98,32,1620
2020-01-09,경남,대구,13551,813,1059,1091,1852,527,18893,11251,563,824,447,491,459,14035
2020-01-09,경남,대전,739,26,109,82,35,20,1011,1037,34,117,123,56,25,1392
2020-01-09,경남,부산,87926,2775,3063,1817,4500,6154,106235,87147,2886,3199,1870,4801,6111,106014
2020-01-09,경남,서울,1600,35,485,280,162,39,2601,2246,62,467,212,118,59,3164
2020-01-09,경남,세종,178,1,17,12,9,7,224,246,4,22,20,13,4,309
2020-01-09,경남,울산,9966,661,751,492,632,608,13110,9603,605,753,481,634,577,12653
2020-01-09,경남,전남,5705,293,499,471,1337,246,8551,5718,296,492,431,1279,231,8447
2020-01-09,경남,전북,1209,49,127,106,158,43,1692,1220,53,137,109,158,37,1714
2020-01-09,경남,충남,1291,50,146,249,243,33,2012,1719,69,187,367,604,57,3003
2020-01-09,경남,충북,1005,55,159,291,270,32,1812,1380,73,222,503,628,38,2844
2020-01-09,경북,강원,465,19,40,30,33,12,599,464,24,46,17,19,14,584
2020-01-09,경북,경기,3944,204,519,932,574,109,6282,3814,192,495,823,591,119,6034
2020-01-09,경북,경남,12954,905,1322,1297,2701,563,19742,10199,643,1073,895,1908,444,15162
2020-01-09,경북,경북,74466,4046,4692,2980,4284,4103,94571,74466,4046,4692,2980,4284,4103,94571
2020-01-09,경북,광주,918,53,138,218,142,11,1480,880,55,134,187,93,16,1365
2020-01-09,경북,대구,72303,3030,3079,1586,2644,4013,86655,75845,3254,3526,1871,3027,4106,91629
2020-01-09,경북,대전,1638,68,125,122,107,73,2133,1716,63,126,149,59,77,2190
2020-01-09,경북,부산,4163,145,323,205,676,206,5718,4607,146,376,222,834,227,6412
2020-01-09,경북,서울,2530,131,366,440,141,72,3680,2445,95,311,226,111,60,3248
2020-01-09,경북,세종,288,4,16,25,11,5,349,259,11,17,19,9,10,325
2020-01-09,경북,울산,4881,197,377,428,1071,275,7229,4761,199,363,365,1199,292,7179
2020-01-09,경북,전남,1084,55,87,160,421,25,1832,1038,36,110,109,584,32,1909
2020-01-09,경북,전북,1751,86,193,185,214,56,2485,1532,79,189,144,209,49,2202
2020-01-09,경북,충남,3006,146,404,625,574,116,4871,3147,133,404,524,767,104,5079
2020-01-09,경북,충북,5054,267,637,720,825,185,7688,4771,232,593,636,935,175,7342
2020-01-09,광주,강원,82,2,14,6,6,1,111,81,2,22,4,8,4,121
2020-01-09,광주,경기,735,31,168,268,108,23,1333,774,36,190,336,182,15,1533
2020-01-09,광주,경남,1113,35,165,177,98,32,1620,1095,42,162,217,157,20,1693
2020-01-09,광주,경북,880,55,134,187,93,16,1365,918,53,138,218,142,11,1480
2020-01-09,광주,광주,12488,507,641,493,214,519,14862,12488,507,641,493,214,519,14862
2020-01-09,광주,대구,598,27,95,111,36,14,881,650,25,106,89,32,15,917
2020-01-09,광주,대전,397,24,16,25,11,17,490,513,21,20,34,15,7,610
2020-01-09,광주,부산,420,14,46,55,63,13,611,422,24,52,79,120,14,711
2020-01-09,광주,서울,619,21,27,73,24,23,787,725,27,25,50,18,28,873
2020-01-09,광주,세종,132,2,10,7,3,2,156,185,2,5,9,2,4,207
2020-01-09,광주,울산,40,3,13,4,9,1,70,37,0,7,9,17,3,73
2020-01-09,광주,전남,33297,966,1289,736,1669,1311,39268,31708,970,1106,730,1523,1266,37303
2020-01-09,광주,전북,7741,409,557,352,346,258,9663,7835,452,481,317,322,286,9693
2020-01-09,광주,충남,3842,130,562,498,300,82,5414,3941,145,581,594,392,100,5753
2020-01-09,광주,충북,531,27,66,107,73,15,819,591,37,90,189,114,10,1031
2020-01-09,대구,강원,303,10,33,26,16,11,399,220,3,9,13,10,0,255
2020-01-09,대구,경기,2579,136,245,493,507,64,4024,1883,116,245,397,271,55,2967
2020-01-09,대구,경남,11251,563,824,447,491,459,14035,13551,813,1059,1091,1852,527,18893
2020-01-09,대구,경북,75845,3254,3526,1871,3027,4106,91629,72303,3030,3079,1586,2644,4013,86655
2020-01-09,대구,광주,650,25,106,89,32,15,917,598,27,95,111,36,14,881
2020-01-09,대구,대구,59653,2266,1891,918,1075,4012,69815,59653,2266,1891,918,1075,4012,69815
2020-01-09,대구,대전,928,52,60,89,40,36,1205,647,44,57,41,17,24,830
2020-01-09,대구,부산,613,59,113,57,155,15,1012,2854,111,224,98,237,115,3639
2020-01-09,대구,서울,2212,76,228,252,136,61,2965,1499,63,159,152,49,40,1962
2020-01-09,대구,세종,204,1,13,9,12,10,249,171,3,3,7,5,6,195
2020-01-09,대구,울산,1344,62,153,67,147,52,1825,1274,56,145,73,181,50,1779
2020-01-09,대구,전남,488,14,49,37,67,19,674,476,17,45,42,71,12,663
2020-01-09,대구,전북,372,20,50,16,20,10,488,362,13,40,19,23,11,468
2020-01-09,대구,충남,1519,70,175,224,254,52,2294,1115,73,139,177,208,34,1746
2020-01-09,대구,충북,1831,111,231,283,415,64,2935,1279,101,167,251,145,37,1980
2020-01-09,대전,강원,184,9,31,4,1,8,237,145,5,31,2,0,6,189
2020-01-09,대전,경기,1921,122,227,110,39,86,2505,1966,101,225,116,48,80,2536
2020-01-09,대전,경남,1037,34,117,123,56,25,1392,739,26,109,82,35,20,1011
2020-01-09,대전,경북,1716,63,126,149,59,77,2190,1638,68,125,122,107,73,2133
2020-01-09,대전,광주,513,21,20,34,15,7,610,397,24,16,25,11,17,490
2020-01-09,대전,대구,647,44,57,41,17,24,830,928,52,60,89,40,36,1205
2020-01-09,대전,대전,13418,416,512,310,98,1068,15822,13418,416,512,310,98,1068,15822
2020-01-09,대전,부산,62,8,8,14,26,1,119,70,6,10,18,19,2,125
2020-01-09,대전,서울,1738,53,218,41,11,66,2127,1696,46,202,48,9,70,2071
2020-01-09,대전,세종,3359,98,77,41,64,280,3919,3328,107,82,36,117,262,3932
2020-01-09,대전,울산,88,7,11,25,28,3,162,89,5,14,10,31,3,152
2020-01-09,대전,전남,306,6,5,26,22,10,375,268,6,8,20,24,6,332
2020-01-09,대전,전북,3190,87,106,87,51,120,3641,3033,104,97,92,43,122,3491
2020-01-09,대전,충남,16158,487,529,338,249,1206,18967,14432,465,477,336,216,1078,17004
2020-01-09,대전,충북,10872,453,508,198,159,840,13030,9951,390,448,167,138,793,11887
2020-01-09,부산,강원,6,0,1,0,2,0,9,4,0,0,1,4,0,9
2020-01-09,부산,경기,230,21,26,163,303,3,746,175,36,37,210,152,6,616
2020-01-09,부산,경남,87147,2886,3199,1870,4801,6111,106014,87926,2775,3063,1817,4500,6154,106235
2020-01-09,부산,경북,4607,146,376,222,834,227,6412,4163,145,323,205,676,206,5718
2020-01-09,부산,광주,422,24,52,79,120,14,711,420,14,46,55,63,13,611
2020-01-09,부산,대구,2854,111,224,98,237,115,3639,613,59,113,57,155,15,1012
2020-01-09,부산,대전,70,6,10,18,19,2,125,62,8,8,14,26,1,119
2020-01-09,부산,부산,40046,756,646,601,1952,2795,46796,40046,756,646,601,1952,2795,46796
2020-01-09,부산,서울,186,13,19,80,95,4,397,152,15,13,64,44,3,291
2020-01-09,부산,세종,6,1,0,5,7,0,19,9,1,1,0,2,0,13
2020-01-09,부산,울산,16339,404,516,630,2512,1125,21526,16459,408,455,452,2397,1169,21340
2020-01-09,부산,전남,1943,92,164,169,500,63,2931,1784,78,123,177,581,54,2797
2020-01-09,부산,전북,300,18,41,47,118,6,530,299,7,44,42,61,6,459
2020-01-09,부산,충남,183,16,29,72,210,0,510,144,13,32,86,236,2,513
2020-01-09,부산,충북,107,13,28,85,197,4,434,96,17,18,125,199,4,459
2020-01-09,서울,강원,780,15,226,10,6,26,1063,652,20,278,10,22,28,1010
2020-01-09,서울,경기,142976,7067,9760,4965,2973,9699,177440,147295,7577,10276,5383,3290,9757,183578
2020-01-09,서울,경남,2246,62,467,212,118,59,3164,1600,35,485,280,162,39,2601
2020-01-09,서울,경북,2445,95,311,226,111,60,3248,2530,131,366,440,141,72,3680
2020-01-09,서울,광주,725,27,25,50,18,28,873,619,21,27,73,24,23,787
2020-01-09,서울,대구,1499,63,159,152,49,40,1962,2212,76,228,252,136,61,2965
2020-01-09,서울,대전,1696,46,202,48,9,70,2071,1738,53,218,41,11,66,2127
2020-01-09,서울,부산,152,15,13,64,44,3,291,186,13,19,80,95,4,397
2020-01-09,서울,서울,184,7,11,2,0,12,216,184,7,11,2,0,12,216
2020-01-09,서울,세종,28,0,0,0,0,0,28,41,1,1,0,0,4,47
2020-01-09,서울,울산,16,1,1,2,1,3,24,25,0,1,15,16,0,57
2020-01-09,서울,전남,770,14,30,53,34,18,919,758,25,29,80,53,24,969
2020-01-09,서울,전북,1196,26,64,29,28,39,1382,1120,24,67,41,29,44,1325
2020-01-09,서울,충남,24066,580,2460,809,753,881,29549,24146,647,2575,1395,1132,870,30765
2020-01-09,서울,충북,13559,641,1242,805,698,572,17517,12815,685,1235,932,773,523,16963
2020-01-09,세종,강원,6,1,0,0,0,0,7,10,0,0,0,0,0,10
2020-01-09,세종,경기,47,3,3,6,4,1,64,43,2,2,7,4,2,60
2020-01-09,세종,경남,246,4,22,20,13,4,309,178,1,17,12,9,7,224
2020-01-09,세종,경북,259,11,17,19,9,10,325,288,4,16,25,11,5,349
2020-01-09,세종,광주,185,2,5,9,2,4,207,132,2,10,7,3,2,156
2020-01-09,세종,대구,171,3,3,7,5,6,195,204,1,13,9,12,10,249
2020-01-09,세종,대전,3328,107,82,36,117,262,3932,3359,98,77,41,64,280,3919
2020-01-09,세종,부산,9,1,1,0,2,0,13,6,1,0,5,7,0,19
2020-01-09,세종,서울,41,1,1,0,0,4,47,28,0,0,0,0,0,28
2020-01-09,세종,세종,240,20,0,3,1,19,283,240,20,0,3,1,19,283
2020-01-09,세종,울산,7,0,0,2,1,0,10,6,0,0,2,3,0,11
2020-01-09,세종,전남,172,3,7,8,12,3,205,152,3,3,9,16,1,184
2020-01-09,세종,전북,751,20,31,11,43,20,876,658,13,18,14,55,20,778
2020-01-09,세종,충남,5738,153,161,92,157,321,6622,4292,134,157,89,132,232,5036
2020-01-09,세종,충북,354,13,24,18,14,19,442,288,17,19,12,7,22,365
2020-01-09,울산,강원,1,0,1,1,0,1,4,1,0,1,0,0,0,2
2020-01-09,울산,경기,44,5,12,40,86,2,189,39,0,5,12,29,1,86
2020-01-09,울산,경남,9603,605,753,481,634,577,12653,9966,661,751,492,632,608,13110
2020-01-09,울산,경북,4761,199,363,365,1199,292,7179,4881,197,377,428,1071,275,7229
2020-01-09,울산,광주,37,0,7,9,17,3,73,40,3,13,4,9,1,70
2020-01-09,울산,대구,1274,56,145,73,181,50,1779,1344,62,153,67,147,52,1825
2020-01-09,울산,대전,89,5,14,10,31,3,152,88,7,11,25,28,3,162
2020-01-09,울산,부산,16459,408,455,452,2397,1169,21340,16339,404,516,630,2512,1125,21526
2020-01-09,울산,서울,25,0,1,15,16,0,57,16,1,1,2,1,3,24
2020-01-09,울산,세종,6,0,0,2,3,0,11,7,0,0,2,1,0,10
2020-01-09,울산,울산,8139,306,639,281,628,740,10733,8139,306,639,281,628,740,10733
2020-01-09,울산,전남,175,12,16,17,21,6,247,164,11,18,16,40,3,252
2020-01-09,울산,전북,54,0,7,4,16,1,82,34,0,10,4,7,1,56
2020-01-09,울산,충남,112,5,29,48,133,6,333,104,5,20,43,136,2,310
2020-01-09,울산,충북,40,3,5,24,58,1,131,21,0,4,24,35,2,86
2020-01-09,전남,강원,51,2,5,8,14,0,80,53,0,8,2,14,3,80
2020-01-09,전남,경기,731,19,86,144,149,19,1148,691,18,116,179,155,20,1179
2020-01-09,전남,경남,5718,296,492,431,1279,231,8447,5705,293,499,471,1337,246,8551
2020-01-09,전남,경북,1038,36,110,109,584,32,1909,1084,55,87,160,421,25,1832
2020-01-09,전남,광주,31708,970,1106,730,1523,1266,37303,33297,966,1289,736,1669,1311,39268
2020-01-09,전남,대구,476,17,45,42,71,12,663,488,14,49,37,67,19,674
2020-01-09,전남,대전,268,6,8,20,24,6,332,306,6,5,26,22,10,375
2020-01-09,전남,부산,1784,78,123,177,581,54,2797,1943,92,164,169,500,63,2931
2020-01-09,전남,서울,758,25,29,80,53,24,969,770,14,30,53,34,18,919
2020-01-09,전남,세종,152,3,3,9,16,1,184,172,3,7,8,12,3,205
2020-01-09,전남,울산,164,11,18,16,40,3,252,175,12,16,17,21,6,247
2020-01-09,전남,전남,44551,1303,1724,1540,4245,1843,55206,44551,1303,1724,1540,4245,1843,55206
2020-01-09,전남,전북,4637,287,504,603,1319,126,7476,4532,262,492,548,1265,135,7234
2020-01-09,전남,충남,3987,127,474,810,1266,97,6761,4136,99,524,560,1147,107,6573
2020-01-09,전남,충북,319,8,55,108,278,6,774,386,12,45,112,268,14,837
2020-01-09,전북,강원,131,4,13,12,20,2,182,121,1,11,10,15,6,164
2020-01-09,전북,경기,1243,41,162,184,203,44,1877,1254,48,184,162,186,43,1877
2020-01-09,전북,경남,1220,53,137,109,158,37,1714,1209,49,127,106,158,43,1692
2020-01-09,전북,경북,1532,79,189,144,209,49,2202,1751,86,193,185,214,56,2485
2020-01-09,전북,광주,7835,452,481,317,322,286,9693,7741,409,557,352,346,258,9663
2020-01-09,전북,대구,362,13,40,19,23,11,468,372,20,50,16,20,10,488
2020-01-09,전북,대전,3033,104,97,92,43,122,3491,3190,87,106,87,51,120,3641
2020-01-09,전북,부산,299,7,44,42,61,6,459,300,18,41,47,118,6,530
2020-01-09,전북,서울,1120,24,67,41,29,44,1325,1196,26,64,29,28,39,1382
2020-01-09,전북,세종,658,13,18,14,55,20,778,751,20,31,11,43,20,876
2020-01-09,전북,울산,34,0,10,4,7,1,56,54,0,7,4,16,1,82
2020-01-09,전북,전남,4532,262,492,548,1265,135,7234,4637,287,504,603,1319,126,7476
2020-01-09,전북,전북,15941,614,927,525,721,568,19296,15941,614,927,525,721,568,19296
2020-01-09,전북,충남,12472,537,1624,1145,1329,424,17531,12225,513,1568,992,1289,410,16997
2020-01-09,전북,충북,1736,117,210,287,274,63,2687,1793,128,240,304,300,53,2818
2020-01-09,충남,강원,419,11,20,43,83,13,589,294,6,15,20,43,9,387
2020-01-09,충남,경기,34868,1500,2837,2483,4204,1693,47585,35756,1542,3025,2623,4509,1883,49338
2020-01-09,충남,경남,1719,69,187,367,604,57,3003,1291,50,146,249,243,33,2012
2020-01-09,충남,경북,3147,133,404,524,767,104,5079,3006,146,404,625,574,116,4871
2020-01-09,충남,광주,3941,145,581,594,392,100,5753,3842,130,562,498,300,82,5414
2020-01-09,충남,대구,1115,73,139,177,208,34,1746,1519,70,175,224,254,52,2294
2020-01-09,충남,대전,14432,465,477,336,216,1078,17004,16158,487,529,338,249,1206,18967
2020-01-09,충남,부산,144,13,32,86,236,2,513,183,16,29,72,210,0,510
2020-01-09,충남,서울,24146,647,2575,1395,1132,870,30765,24066,580,2460,809,753,881,29549
2020-01-09,충남,세종,4292,134,157,89,132,232,5036,5738,153,161,92,157,321,6622
2020-01-09,충남,울산,104,5,20,43,136,2,310,112,5,29,48,133,6,333
2020-01-09,충남,전남,4136,99,524,560,1147,107,6573,3987,127,474,810,1266,97,6761
2020-01-09,충남,전북,12225,513,1568,992,1289,410,16997,12472,537,1624,1145,1329,424,17531
2020-01-09,충남,충남,95747,3644,8578,7085,10019,4603,129676,95747,3644,8578,7085,10019,4603,129676
2020-01-09,충남,충북,13567,685,926,976,1381,798,18333,12137,671,901,870,1370,686,16635
2020-01-09,충북,강원,4875,215,307,213,236,275,6121,4606,258,319,213,287,287,5970
2020-01-09,충북,경기,25856,2177,3056,2881,3221,1227,38418,26860,2271,3155,3327,3250,1322,40185
2020-01-09,충북,경남,1380,73,222,503,628,38,2844,1005,55,159,291,270,32,1812
2020-01-09,충북,경북,4771,232,593,636,935,175,7342,5054,267,637,720,825,185,7688
2020-01-09,충북,광주,591,37,90,189,114,10,1031,531,27,66,107,73,15,819
2020-01-09,충북,대구,1279,101,167,251,145,37,1980,1831,111,231,283,415,64,2935
2020-01-09,충북,대전,9951,390,448,167,138,793,11887,10872,453,508,198,159,840,13030
2020-01-09,충북,부산,96,17,18,125,199,4,459,107,13,28,85,197,4,434
2020-01-09,충북,서울,12815,685,1235,932,773,523,16963,13559,641,1242,805,698,572,17517
2020-01-09,충북,세종,288,17,19,12,7,22,365,354,13,24,18,14,19,442
2020-01-09,충북,울산,21,0,4,24,35,2,86,40,3,5,24,58,1,131
2020-01-09,충북,전남,386,12,45,112,268,14,837,319,8,55,108,278,6,774
2020-01-09,충북,전북,1793,128,240,304,300,53,2818,1736,117,210,287,274,63,2687
2020-01-09,충북,충남,12137,671,901,870,1370,686,16635,13567,685,926,976,1381,798,18333
2020-01-09,충북,충북,35774,1992,2418,2212,2690,2085,47171,35774,1992,2418,2212,2690,2085,47171
2020-01-10,강원,강원,78954,2398,3515,1397,2123,4999,93386,78954,2398,3515,1397,2123,4999,93386
2020-01-10,강원,경기,22025,643,1376,623,747,1036,26450,29418,684,1351,677,834,1247,34211
2020-01-10,강원,경남,224,5,10,14,18,7,278,204,1,5,13,13,5,241
2020-01-10,강원,경북,597,22,49,15,23,27,733,636,19,43,20,21,29,768
2020-01-10,강원,광주,143,1,25,6,9,4,188,130,1,20,10,4,1,166
2020-01-10,강원,대구,327,8,12,9,8,7,371,497,5,15,20,19,13,569
2020-01-10,강원,대전,213,1,37,9,1,12,273,251,5,39,7,2,8,312
2020-01-10,강원,부산,14,0,1,0,2,0,17,5,0,1,1,0,0,7
2020-01-10,강원,서울,819,14,316,11,33,31,1224,967,10,284,16,8,31,1316
2020-01-10,강원,세종,6,1,0,0,1,0,8,15,1,0,0,2,0,18
2020-01-10,강원,울산,0,0,0,0,0,0,0,3,0,0,0,1,0,4
2020-01-10,강원,전남,63,0,3,6,11,2,85,91,3,1,4,16,0,115
2020-01-10,강원,전북,189,3,15,11,13,3,234,225,10,15,20,17,4,291
2020-01-10,강원,충남,354,8,29,24,40,13,468,713,10,31,50,69,33,906
2020-01-10,강원,충북,5616,216,292,198,327,293,6942,6415,207,292,199,268,318,7699
2020-01-10,경기,강원,29418,684,1351,677,834,1247,34211,22025,643,1376,623,747,1036,26450
2020-01-10,경기,경기,437665,23801,25759,20068,23220,32459,562972,437665,23801,25759,20068,23220,32459,562972
2020-01-10,경기,경남,3749,103,415,822,624,114,5827,2688,68,326,605,409,82,4178
2020-01-10,경기,경북,5355,193,564,795,566,157,7630,5197,205,501,943,586,158,7590
2020-01-10,경기,광주,1255,30,210,343,157,35,2030,921,21,165,264,129,34,1534
2020-01-10,경기,대구,2728,117,230,403,251,93,3822,3448,132,236,487,477,102,4882
2020-01-10,경기,대전,2840,118,231,129,50,150,3518,2277,108,203,97,50,111,2846
2020-01-10,경기,부산,232,22,60,214,136,7,671,257,23,32,169,268,5,754
2020-01-10,경기,서울,143371,7528,8921,5047,3525,9835,178227,141980,7223,9767,4855,3252,9535,176612
2020-01-10,경기,세종,70,2,4,5,5,3,89,72,2,4,4,0,1,83
2020-01-10,경기,울산,57,2,3,12,22,0,96,50,3,10,37,99,1,200
2020-01-10,경기,전남,1129,24,117,187,185,30,1672,978,18,89,159,156,26,1426
2020-01-10,경기,전북,2105,51,167,149,206,58,2736,1566,49,159,170,172,59,2175
2020-01-10,경기,충남,43288,1717,3178,2633,4644,2239,57699,44023,1611,2929,2442,4066,2177,57248
2020-01-10,경기,충북,31761,2275,3117,3217,3326,1647,45343,31490,2200,2930,2908,3460,1588,44576
2020-01-10,경남,강원,204,1,5,13,13,5,241,224,5,10,14,18,7,278
2020-01-10,경남,경기,2688,68,326,605,409,82,4178,3749,103,415,822,624,114,5827
2020-01-10,경남,경남,208823,10500,10796,7109,12858,15654,265740,208823,10500,10796,7109,12858,15654,265740
2020-01-10,경남,경북,12387,673,1142,871,1795,589,17457,15853,929,1387,1291,2729,728,22917
2020-01-10,경남,광주,1592,74,147,196,126,50,2185,1494,69,173,178,89,36,2039
2020-01-10,경남,대구,16258,830,1081,1072,1624,663,21528,12642,592,878,435,506,569,15622
2020-01-10,경남,대전,1029,22,102,76,45,48,1322,1341,29,115,128,67,64,1744
2020-01-10,경남,부산,95663,2822,3240,1809,4695,6634,114863,90601,2874,3244,1911,4808,6424,109862
2020-01-10,경남,서울,2028,46,506,266,152,67,3065,2829,66,533,178,138,76,3820
2020-01-10,경남,세종,279,1,17,6,8,14,325,384,2,21,13,11,13,444
2020-01-10,경남,울산,11093,663,722,494,703,696,14371,10512,593,776,454,695,674,13704
2020-01-10,경남,전남,6630,258,505,491,1250,274,9408,7469,285,520,449,1277,332,10332
2020-01-10,경남,전북,1719,48,134,105,201,56,2263,1640,56,134,116,178,61,2185
2020-01-10,경남,충남,1485,54,127,246,209,46,2167,2501,61,185,339,530,95,3711
2020-01-10,경남,충북,1402,61,159,291,269,49,2231,2181,79,269,523,639,70,3761
2020-01-10,경북,강원,636,19,43,20,21,29,768,597,22,49,15,23,27,733
2020-01-10,경북,경기,5197,205,501,943,586,158,7590,5355,193,564,795,566,157,7630
2020-01-10,경북,경남,15853,929,1387,1291,2729,728,22917,12387,673,1142,871,1795,589,17457
2020-01-10,경북,경북,81454,3994,4757,2958,4656,4507,102326,81454,3994,4757,2958,4656,4507,102326
2020-01-10,경북,광주,1228,53,131,240,146,45,1843,1091,53,115,213,102,38,1612
2020-01-10,경북,대구,79189,3107,3086,1572,2876,4296,94126,78885,3246,3484,1930,3170,4241,94956
2020-01-10,경북,대전,2210,71,142,103,86,93,2705,1974,60,132,131,74,98,2469
2020-01-10,경북,부산,5588,123,356,236,633,246,7182,5411,127,417,236,894,211,7296
2020-01-10,경북,서울,2984,102,370,401,117,104,4078,3354,103,366,260,141,116,4340
2020-01-10,경북,세종,376,11,24,18,12,16,457,350,10,18,15,10,21,424
2020-01-10,경북,울산,5717,177,389,416,1051,322,8072,5822,169,369,344,1238,345,8287
2020-01-10,경북,전남,1288,39,98,120,476,39,2060,1398,45,76,112,600,42,2273
2020-01-10,경북,전북,2023,92,199,184,236,72,2806,1845,80,178,144,233,55,2535
2020-01-10,경북,충남,3620,155,414,613,564,129,5495,4272,148,403,529,805,151,6308
2020-01-10,경북,충북,6196,235,600,726,803,266,8826,6127,249,644,687,947,252,8906
2020-01-10,광주,강원,130,1,20,10,4,1,166,143,1,25,6,9,4,188
2020-01-10,광주,경기,921,21,165,264,129,34,1534,1255,30,210,343,157,35,2030
2020-01-10,광주,경남,1494,69,173,178,89,36,2039,1592,74,147,196,126,50,2185
2020-01-10,광주,경북,1091,53,115,213,102,38,1612,1228,53,131,240,146,45,1843
2020-01-10,광주,광주,13528,520,719,402,232,593,15994,13528,520,719,402,232,593,15994
2020-01-10,광주,대구,797,24,109,91,29,21,1071,761,30,113,71,28,12,1015
2020-01-10,광주,대전,555,19,14,25,15,23,651,584,20,24,25,22,17,692
2020-01-10,광주,부산,602,20,48,38,54,11,773,597,17,56,82,115,13,880
2020-01-10,광주,서울,779,14,24,76,29,17,939,1077,21,27,47,11,28,1211
2020-01-10,광주,세종,163,0,8,4,1,4,180,256,1,6,6,3,9,281
2020-01-10,광주,울산,63,1,7,0,6,3,80,74,1,7,9,10,1,102
2020-01-10,광주,전남,35014,1027,1304,749,1819,1406,41319,36050,1002,1133,694,1797,1421,42097
2020-01-10,광주,전북,8936,457,588,373,347,305,11006,9183,474,561,336,364,309,11227
2020-01-10,광주,충남,4888,122,641,453,258,121,6483,5579,140,618,608,369,162,7476
2020-01-10,광주,충북,684,29,65,119,64,18,979,915,41,97,175,83,28,1339
2020-01-10,대구,강원,497,5,15,20,19,13,569,327,8,12,9,8,7,371
2020-01-10,대구,경기,3448,132,236,487,477,102,4882,2728,117,230,403,251,93,3822
2020-01-10,대구,경남,12642,592,878,435,506,569,15622,16258,830,1081,1072,1624,663,21528
2020-01-10,대구,경북,78885,3246,3484,1930,3170,4241,94956,79189,3107,3086,1572,2876,4296,94126
2020-01-10,대구,광주,761,30,113,71,28,12,1015,797,24,109,91,29,21,1071
2020-01-10,대구,대구,61964,2317,1890,890,1017,4096,72174,61964,2317,1890,890,1017,4096,72174
2020-01-10,대구,대전,1110,50,60,72,43,37,1372,882,31,33,61,17,38,1062
2020-01-10,대구,부산,713,60,115,73,185,18,1164,3192,103,270,86,302,124,4077
2020-01-10,대구,서울,2675,94,209,261,110,74,3423,2091,67,156,126,57,70,2567
2020-01-10,대구,세종,330,1,22,9,9,13,384,248,0,6,3,6,14,277
2020-01-10,대구,울산,1358,52,138,75,152,53,1828,1689,54,148,78,173,58,2200
2020-01-10,대구,전남,559,17,44,48,49,20,737,703,15,45,40,77,20,900
2020-01-10,대구,전북,404,13,40,20,18,16,511,496,10,45,26,26,16,619
2020-01-10,대구,충남,1664,84,164,213,277,54,2456,1818,63,126,164,185,72,2428
2020-01-10,대구,충북,2164,96,198,274,411,71,3214,1959,81,163,254,133,61,2651
2020-01-10,대전,강원,251,5,39,7,2,8,312,213,1,37,9,1,12,273
2020-01-10,대전,경기,2277,108,203,97,50,111,2846,2840,118,231,129,50,150,3518
2020-01-10,대전,경남,1341,29,115,128,67,64,1744,1029,22,102,76,45,48,1322
2020-01-10,대전,경북,1974,60,132,131,74,98,2469,2210,71,142,103,86,93,2705
2020-01-10,대전,광주,584,20,24,25,22,17,692,555,19,14,25,15,23,651
2020-01-10,대전,대구,882,31,33,61,17,38,1062,1110,50,60,72,43,37,1372
2020-01-10,대전,대전,14117,446,480,469,200,1113,16825,14117,446,480,469,200,1113,16825
2020-01-10,대전,부산,88,7,6,17,24,1,143,98,3,11,16,23,3,154
2020-01-10,대전,서울,1830,42,217,33,11,88,2221,2143,50,229,46,12,87,2567
2020-01-10,대전,세종,3645,110,81,31,103,284,4254,3561,106,93,29,210,288,4287
2020-01-10,대전,울산,99,1,9,20,20,4,153,134,2,13,12,22,5,188
2020-01-10,대전,전남,338,4,10,19,24,5,400,409,6,14,24,28,17,498
2020-01-10,대전,전북,3557,88,116,79,49,167,4056,3605,95,92,79,53,166,4090
2020-01-10,대전,충남,16568,533,586,260,253,1295,19495,15925,476,538,218,257,1168,18582
2020-01-10,대전,충북,11474,476,491,206,164,857,13668,10827,427,443,164,153,839,12853
2020-01-10,부산,강원,5,0,1,1,0,0,7,14,0,1,0,2,0,17
2020-01-10,부산,경기,257,23,32,169,268,5,754,232,22,60,214,136,7,671
2020-01-10,부산,경남,90601,2874,3244,1911,4808,6424,109862,95663,2822,3240,1809,4695,6634,114863
2020-01-10,부산,경북,5411,127,417,236,894,211,7296,5588,123,356,236,633,246,7182
2020-01-10,부산,광주,597,17,56,82,115,13,880,602,20,48,38,54,11,773
2020-01-10,부산,대구,3192,103,270,86,302,124,4077,713,60,115,73,185,18,1164
2020-01-10,부산,대전,98,3,11,16,23,3,154,88,7,6,17,24,1,143
2020-01-10,부산,부산,43059,795,745,762,1942,3041,50344,43059,795,745,762,1942,3041,50344
2020-01-10,부산,서울,210,18,19,57,79,5,388,148,8,27,62,45,5,295
2020-01-10,부산,세종,22,0,0,2,5,2,31,24,1,1,1,1,0,28
2020-01-10,부산,울산,17338,425,527,670,2562,1162,22684,19107,411,473,475,2351,1302,24119
2020-01-10,부산,전남,2222,106,164,194,527,87,3300,2248,82,133,131,531,98,3223
2020-01-10,부산,전북,427,14,44,34,97,16,632,362,8,35,49,88,6,548
2020-01-10,부산,충남,181,18,31,58,150,4,442,182,13,30,77,201,10,513
2020-01-10,부산,충북,148,11,22,83,230,9,503,128,17,27,141,164,1,478
2020-01-10,서울,강원,967,10,284,16,8,31,1316,819,14,316,11,33,31,1224
2020-01-10,서울,경기,141980,7223,9767,4855,3252,9535,176612,143371,7528,8921,5047,3525,9835,178227
2020-01-10,서울,경남,2829,66,533,178,138,76,3820,2028,46,506,266,152,67,3065
2020-01-10,서울,경북,3354,103,366,260,141,116,4340,2984,102,370,401,117,104,4078
2020-01-10,서울,광주,1077,21,27,47,11,28,1211,779,14,24,76,29,17,939
2020-01-10,서울,대구,2091,67,156,126,57,70,2567,2675,94,209,261,110,74,3423
2020-01-10,서울,대전,2143,50,229,46,12,87,2567,1830,42,217,33,11,88,2221
2020-01-10,서울,부산,148,8,27,62,45,5,295,210,18,19,57,79,5,388
2020-01-10,서울,서울,188,6,8,4,3,11,220,188,6,8,4,3,11,220
2020-01-10,서울,세종,43,0,0,0,0,1,44,62,1,0,0,0,4,67
2020-01-10,서울,울산,25,0,0,6,1,2,34,29,2,4,9,13,0,57
2020-01-10,서울,전남,1098,8,22,35,29,30,1222,940,16,37,70,49,25,1137
2020-01-10,서울,전북,1784,21,48,23,17,64,1957,1376,26,49,36,25,49,1561
2020-01-10,서울,충남,28206,539,2565,862,698,1132,34002,27423,623,2484,1315,1097,1098,34040
2020-01-10,서울,충북,14589,597,1256,844,717,688,18691,15435,705,1242,851,838,719,19790
2020-01-10,세종,강원,15,1,0,0,2,0,18,6,1,0,0,1,0,8
2020-01-10,세종,경기,72,2,4,4,0,1,83,70,2,4,5,5,3,89
2020-01-10,세종,경남,384,2,21,13,11,13,444,279,1,17,6,8,14,325
2020-01-10,세종,경북,350,10,18,15,10,21,424,376,11,24,18,12,16,457
2020-01-10,세종,광주,256,1,6,6,3,9,281,163,0,8,4,1,4,180
2020-01-10,세종,대구,248,0,6,3,6,14,277,330,1,22,9,9,13,384
2020-01-10,세종,대전,3561,106,93,29,210,288,4287,3645,110,81,31,103,284,4254
2020-01-10,세종,부산,24,1,1,1,1,0,28,22,0,0,2,5,2,31
2020-01-10,세종,서울,62,1,0,0,0,4,67,43,0,0,0,0,1,44
2020-01-10,세종,세종,263,21,4,2,0,22,312,263,21,4,2,0,22,312
2020-01-10,세종,울산,10,0,0,3,1,1,15,11,0,0,3,5,0,19
2020-01-10,세종,전남,232,4,3,12,10,2,263,221,3,5,5,18,6,258
2020-01-10,세종,전북,857,25,26,12,26,32,978,808,23,22,24,34,22,933
2020-01-10,세종,충남,6342,164,169,111,156,386,7328,5463,159,157,109,148,288,6324
2020-01-10,세종,충북,360,13,22,18,15,31,459,332,23,18,9,8,22,412
2020-01-10,울산,강원,3,0,0,0,1,0,4,0,0,0,0,0,0,0
2020-01-10,울산,경기,50,3,10,37,99,1,200,57,2,3,12,22,0,96
2020-01-10,울산,경남,10512,593,776,454,695,674,13704,11093,663,722,494,703,696,14371
2020-01-10,울산,경북,5822,169,369,344,1238,345,8287,5717,177,389,416,1051,322,8072
2020-01-10,울산,광주,74,1,7,9,10,1,102,63,1,7,0,6,3,80
2020-01-10,울산,대구,1689,54,148,78,173,58,2200,1358,52,138,75,152,53,1828
2020-01-10,울산,대전,134,2,13,12,22,5,188,99,1,9,20,20,4,153
2020-01-10,울산,부산,19107,411,473,475,2351,1302,24119,17338,425,527,670,2562,1162,22684
2020-01-10,울산,서울,29,2,4,9,13,0,57,25,0,0,6,1,2,34
2020-01-10,울산,세종,11,0,0,3,5,0,19,10,0,0,3,1,1,15
2020-01-10,울산,울산,8599,300,564,307,595,798,11163,8599,300,564,307,595,798,11163
2020-01-10,울산,전남,229,13,27,19,27,8,323,246,19,29,11,47,6,358
2020-01-10,울산,전북,59,0,10,5,19,3,96,70,1,7,4,3,0,85
2020-01-10,울산,충남,127,4,22,51,102,6,312,150,5,22,48,127,3,355
2020-01-10,울산,충북,20,4,3,24,46,1,98,25,4,4,14,40,1,88
2020-01-10,전남,강원,91,3,1,4,16,0,115,63,0,3,6,11,2,85
2020-01-10,전남,경기,978,18,89,159,156,26,1426,1129,24,117,187,185,30,1672
2020-01-10,전남,경남,7469,285,520,449,1277,332,10332,6630,258,505,491,1250,274,9408
2020-01-10,전남,경북,1398,45,76,112,600,42,2273,1288,39,98,120,476,39,2060
2020-01-10,전남,광주,36050,1002,1133,694,1797,1421,42097,35014,1027,1304,749,1819,1406,41319
2020-01-10,전남,대구,703,15,45,40,77,20,900,559,17,44,48,49,20,737
2020-01-10,전남,대전,409,6,14,24,28,17,498,338,4,10,19,24,5,400
2020-01-10,전남,부산,2248,82,133,131,531,98,3223,2222,106,164,194,527,87,3300
2020-01-10,전남,서울,940,16,37,70,49,25,1137,1098,8,22,35,29,30,1222
2020-01-10,전남,세종,221,3,5,5,18,6,258,232,4,3,12,10,2,263
2020-01-10,전남,울산,246,19,29,11,47,6,358,229,13,27,19,27,8,323
2020-01-10,전남,전남,49719,1296,1791,1752,4440,2025,61023,49719,1296,1791,1752,4440,2025,61023
2020-01-10,전남,전북,6198,284,523,531,1372,176,9084,5472,219,478,581,1307,158,8215
2020-01-10,전남,충남,5524,90,543,731,1085,121,8094,5816,78,530,559,1063,153,8199
2020-01-10,전남,충북,528,13,47,106,277,19,990,575,13,53,109,264,11,1025
2020-01-10,전북,강원,225,10,15,20,17,4,291,189,3,15,11,13,3,234
2020-01-10,전북,경기,1566,49,159,170,172,59,2175,2105,51,167,149,206,58,2736
2020-01-10,전북,경남,1640,56,134,116,178,61,2185,1719,48,134,105,201,56,2263
2020-01-10,전북,경북,1845,80,178,144,233,55,2535,2023,92,199,184,236,72,2806
2020-01-10,전북,광주,9183,474,561,336,364,309,11227,8936,457,588,373,347,305,11006
2020-01-10,전북,대구,496,10,45,26,26,16,619,404,13,40,20,18,16,511
2020-01-10,전북,대전,3605,95,92,79,53,166,4090,3557,88,116,79,49,167,4056
2020-01-10,전북,부산,362,8,35,49,88,6,548,427,14,44,34,97,16,632
2020-01-10,전북,서울,1376,26,49,36,25,49,1561,1784,21,48,23,17,64,1957
2020-01-10,전북,세종,808,23,22,24,34,22,933,857,25,26,12,26,32,978
2020-01-10,전북,울산,70,1,7,4,3,0,85,59,0,10,5,19,3,96
2020-01-10,전북,전남,5472,219,478,581,1307,158,8215,6198,284,523,531,1372,176,9084
2020-01-10,전북,전북,17121,656,996,527,719,684,20703,17121,656,996,527,719,684,20703
2020-01-10,전북,충남,15507,532,1609,1092,1339,556,20635,16888,473,1624,994,1424,631,22034
2020-01-10,전북,충북,2167,108,193,281,266,74,3089,2331,115,241,259,280,78,3304
2020-01-10,충남,강원,713,10,31,50,69,33,906,354,8,29,24,40,13,468
2020-01-10,충남,경기,44023,1611,2929,2442,4066,2177,57248,43288,1717,3178,2633,4644,2239,57699
2020-01-10,충남,경남,2501,61,185,339,530,95,3711,1485,54,127,246,209,46,2167
2020-01-10,충남,경북,4272,148,403,529,805,151,6308,3620,155,414,613,564,129,5495
2020-01-10,충남,광주,5579,140,618,608,369,162,7476,4888,122,641,453,258,121,6483
2020-01-10,충남,대구,1818,63,126,164,185,72,2428,1664,84,164,213,277,54,2456
2020-01-10,충남,대전,15925,476,538,218,257,1168,18582,16568,533,586,260,253,1295,19495
2020-01-10,충남,부산,182,13,30,77,201,10,513,181,18,31,58,150,4,442
2020-01-10,충남,서울,27423,623,2484,1315,1097,1098,34040,28206,539,2565,862,698,1132,34002
2020-01-10,충남,세종,5463,159,157,109,148,288,6324,6342,164,169,111,156,386,7328
2020-01-10,충남,울산,150,5,22,48,127,3,355,127,4,22,51,102,6,312
2020-01-10,충남,전남,5816,78,530,559,1063,153,8199,5524,90,543,731,1085,121,8094
2020-01-10,충남,전북,16888,473,1624,994,1424,631,22034,15507,532,1609,1092,1339,556,20635
2020-01-10,충남,충남,109981,3740,8631,6880,10038,5233,144503,109981,3740,8631,6880,10038,5233,144503
2020-01-10,충남,충북,14907,675,956,950,1400,899,19787,13484,657,922,824,1333,769,17989
2020-01-10,충북,강원,6415,207,292,199,268,318,7699,5616,216,292,198,327,293,6942
2020-01-10,충북,경기,31490,2200,2930,2908,3460,1588,44576,31761,2275,3117,3217,3326,1647,45343
2020-01-10,충북,경남,2181,79,269,523,639,70,3761,1402,61,159,291,269,49,2231
2020-01-10,충북,경북,6127,249,644,687,947,252,8906,6196,235,600,726,803,266,8826
2020-01-10,충북,광주,915,41,97,175,83,28,1339,684,29,65,119,64,18,979
2020-01-10,충북,대구,1959,81,163,254,133,61,2651,2164,96,198,274,411,71,3214
2020-01-10,충북,대전,10827,427,443,164,153,839,12853,11474,476,491,206,164,857,13668
2020-01-10,충북,부산,128,17,27,141,164,1,478,148,11,22,83,230,9,503
2020-01-10,충북,서울,15435,705,1242,851,838,719,19790,14589,597,1256,844,717,688,18691
2020-01-10,충북,세종,332,23,18,9,8,22,412,360,13,22,18,15,31,459
2020-01-10,충북,울산,25,4,4,14,40,1,88,20,4,3,24,46,1,98
2020-01-10,충북,전남,575,13,53,109,264,11,1025,528,13,47,106,277,19,990
2020-01-10,충북,전북,2331,115,241,259,280,78,3304,2167,108,193,281,266,74,3089
2020-01-10,충북,충남,13484,657,922,824,1333,769,17989,14907,675,956,950,1400,899,19787
2020-01-10,충북,충북,39061,1964,2412,2092,2784,2354,50667,39061,1964,2412,2092,2784,2354,50667
2020-01-11,강원,강원,101517,1473,3049,706,1485,4990,113220,101517,1473,3049,706,1485,4990,113220
2020-01-11,강원,경기,32393,371,1272,324,387,1416,36163,45312,385,1199,339,457,1808,49500
2020-01-11,강원,경남,270,1,19,4,3,6,303,181,0,7,7,1,8,204
2020-01-11,강원,경북,774,14,37,11,8,36,880,812,14,37,12,4,21,900
2020-01-11,강원,광주,112,2,23,1,7,1,146,143,0,19,9,1,2,174
2020-01-11,강원,대구,351,1,10,6,4,10,382,678,5,27,5,4,13,732
2020-01-11,강원,대전,246,1,30,2,1,10,290,340,1,32,4,2,12,391
2020-01-11,강원,부산,2,0,1,0,2,0,5,9,0,1,0,1,0,11
2020-01-11,강원,서울,1032,10,437,5,10,41,1535,1422,11,373,7,9,40,1862
2020-01-11,강원,세종,7,0,0,1,0,1,9,11,1,0,0,1,0,13
2020-01-11,강원,울산,2,0,1,1,0,0,4,4,0,0,0,0,0,4
2020-01-11,강원,전남,56,1,6,0,3,1,67,68,1,2,0,3,2,76
2020-01-11,강원,전북,211,3,12,2,7,7,242,242,2,9,12,3,7,275
2020-01-11,강원,충남,422,2,29,15,19,20,507,716,5,33,31,32,25,842
2020-01-11,강원,충북,6111,147,235,113,183,320,7109,7128,142,238,122,149,347,8126
2020-01-11,경기,강원,45312,385,1199,339,457,1808,49500,32393,371,1272,324,387,1416,36163
2020-01-11,경기,경기,380531,10503,12827,9422,13659,24318,451260,380531,10503,12827,9422,13659,24318,451260
2020-01-11,경기,경남,3695,49,318,513,392,139,5106,2347,33,217,303,199,87,3186
2020-01-11,경기,경북,6969,80,321,397,308,252,8327,5255,72,271,399,313,182,6492
2020-01-11,경기,광주,1336,13,168,184,83,34,1818,1047,10,112,96,55,25,1345
2020-01-11,경기,대구,2976,31,172,257,127,93,3656,3281,44,191,249,169,100,4034
2020-01-11,경기,대전,3403,55,199,87,38,157,3939,3192,54,198,66,29,147,3686
2020-01-11,경기,부산,291,14,42,129,85,14,575,268,7,23,107,98,13,516
2020-01-11,경기,서울,137360,4215,6066,2797,2202,7966,160606,131755,3603,5872,2289,1927,7618,153064
2020-01-11,경기,세종,69,1,3,1,2,4,80,120,3,2,3,1,3,132
2020-01-11,경기,울산,55,2,4,6,8,0,75,41,1,2,10,33,1,88
2020-01-11,경기,전남,1435,12,110,99,119,36,1811,1111,17,68,78,60,33,1367
2020-01-11,경기,전북,2817,19,175,73,97,96,3277,2084,21,125,68,92,69,2459
2020-01-11,경기,충남,46173,712,1916,1110,2109,2109,54129,47090,699,1911,1089,2243,2081,55113
2020-01-11,경기,충북,34832,960,1519,1542,1864,1598,42315,32261,882,1452,1315,2046,1501,39457
2020-01-11,경남,강원,181,0,7,7,1,8,204,270,1,19,4,3,6,303
2020-01-11,경남,경기,2347,33,217,303,199,87,3186,3695,49,318,513,392,139,5106
2020-01-11,경남,경남,198875,5919,6516,3915,7889,13148,236262,198875,5919,6516,3915,7889,13148,236262
2020-01-11,경남,경북,17545,309,701,468,915,831,20769,20648,416,884,681,1344,927,24900
2020-01-11,경남,광주,1754,23,125,107,79,58,2146,1924,21,158,79,57,50,2289
2020-01-11,경남,대구,19527,407,869,475,698,872,22848,16999,302,642,255,256,673,19127
2020-01-11,경남,대전,1313,13,97,38,23,41,1525,1835,20,113,96,42,77,2183
2020-01-11,경남,부산,98102,1578,2374,1358,2201,6193,111806,93542,1565,2315,1169,2121,5983,106695
2020-01-11,경남,서울,2110,26,535,128,77,56,2932,3362,35,609,132,82,103,4323
2020-01-11,경남,세종,250,2,7,2,7,14,282,428,2,19,5,11,16,481
2020-01-11,경남,울산,12324,372,485,262,257,721,14421,12193,346,510,238,272,685,14244
2020-01-11,경남,전남,8539,150,331,326,637,337,10320,8415,150,363,258,668,350,10204
2020-01-11,경남,전북,2702,33,109,54,142,93,3133,2215,36,119,40,136,76,2622
2020-01-11,경남,충남,1515,19,71,94,87,56,1842,2594,31,110,185,271,82,3273
2020-01-11,경남,충북,1690,28,114,126,146,65,2169,2353,43,178,287,362,63,3286
2020-01-11,경북,강원,812,14,37,12,4,21,900,774,14,37,11,8,36,880
2020-01-11,경북,경기,5255,72,271,399,313,182,6492,6969,80,321,397,308,252,8327
2020-01-11,경북,경남,20648,416,884,681,1344,927,24900,17545,309,701,468,915,831,20769
2020-01-11,경북,경북,87605,2292,2956,1733,2618,4159,101363,87605,2292,2956,1733,2618,4159,101363
2020-01-11,경북,광주,1168,25,115,123,75,34,1540,1132,23,67,109,53,29,1413
2020-01-11,경북,대구,78447,1762,2160,1068,1984,3941,89362,83620,1794,2367,1227,2060,4095,95163
2020-01-11,경북,대전,2758,31,107,58,45,111,3110,2952,32,86,97,36,127,3330
2020-01-11,경북,부산,8209,73,317,103,243,353,9298,9491,76,360,80,302,390,10699
2020-01-11,경북,서울,3450,47,394,169,76,117,4253,4700,41,385,156,76,153,5511
2020-01-11,경북,세종,389,2,12,9,8,14,434,452,6,12,7,6,26,509
2020-01-11,경북,울산,7535,76,240,253,690,402,9196,7973,79,234,164,768,409,9627
2020-01-11,경북,전남,1582,33,55,53,232,40,1995,1517,29,65,67,356,42,2076
2020-01-11,경북,전북,2488,47,121,91,128,78,2953,2148,48,101,63,109,74,2543
2020-01-11,경북,충남,4026,71,185,261,305,157,5005,4814,59,216,276,405,163,5933
2020-01-11,경북,충북,7638,118,339,294,456,287,9132,8114,123,368,350,603,287,9845
2020-01-11,광주,강원,143,0,19,9,1,2,174,112,2,23,1,7,1,146
2020-01-11,광주,경기,1047,10,112,96,55,25,1345,1336,13,168,184,83,34,1818
2020-01-11,광주,경남,1924,21,158,79,57,50,2289,1754,23,125,107,79,58,2146
2020-01-11,광주,경북,1132,23,67,109,53,29,1413,1168,25,115,123,75,34,1540
2020-01-11,광주,광주,12692,330,525,177,185,512,14421,12692,330,525,177,185,512,14421
2020-01-11,광주,대구,812,15,82,65,14,20,1008,847,10,94,52,12,20,1035
2020-01-11,광주,대전,737,13,12,14,8,26,810,818,6,19,21,13,22,899
2020-01-11,광주,부산,694,5,48,19,34,15,815,673,3,65,45,47,13,846
2020-01-11,광주,서울,927,14,25,44,13,24,1047,1336,11,26,39,9,33,1454
2020-01-11,광주,세종,193,0,5,3,0,5,206,292,0,7,1,4,8,312
2020-01-11,광주,울산,64,0,8,1,3,3,79,79,1,8,8,6,3,105
2020-01-11,광주,전남,40729,639,1055,528,1177,1455,45583,38416,664,931,454,1216,1360,43041
2020-01-11,광주,전북,10986,240,354,170,173,374,12297,10750,263,371,186,221,379,12170
2020-01-11,광주,충남,5667,51,607,200,141,140,6806,6158,67,630,317,220,173,7565
2020-01-11,광주,충북,783,16,53,40,25,24,941,942,9,62,86,70,39,1208
2020-01-11,대구,강원,678,5,27,5,4,13,732,351,1,10,6,4,10,382
2020-01-11,대구,경기,3281,44,191,249,169,100,4034,2976,31,172,257,127,93,3656
2020-01-11,대구,경남,16999,302,642,255,256,673,19127,19527,407,869,475,698,872,22848
2020-01-11,대구,경북,83620,1794,2367,1227,2060,4095,95163,78447,1762,2160,1068,1984,3941,89362
2020-01-11,대구,광주,847,10,94,52,12,20,1035,812,15,82,65,14,20,1008
2020-01-11,대구,대구,54649,1255,1212,539,771,3276,61702,54649,1255,1212,539,771,3276,61702
2020-01-11,대구,대전,1558,12,59,39,29,62,1759,1133,10,40,35,16,44,1278
2020-01-11,대구,부산,1073,27,82,38,45,32,1297,4567,48,245,34,92,178,5164
2020-01-11,대구,서울,2938,43,292,124,58,80,3535,2241,25,204,90,38,62,2660
2020-01-11,대구,세종,343,1,10,2,5,12,373,273,0,0,1,3,5,282
2020-01-11,대구,울산,2069,36,128,43,100,95,2471,2289,36,133,35,130,99,2722
2020-01-11,대구,전남,971,8,49,14,31,38,1111,844,5,44,28,16,43,980
2020-01-11,대구,전북,622,5,50,5,7,21,710,542,11,44,8,8,17,630
2020-01-11,대구,충남,1873,25,88,97,95,69,2247,1658,16,69,118,97,60,2018
2020-01-11,대구,충북,2707,44,177,101,174,75,3278,2049,44,139,137,96,76,2541
2020-01-11,대전,강원,340,1,32,4,2,12,391,246,1,30,2,1,10,290
2020-01-11,대전,경기,3192,54,198,66,29,147,3686,3403,55,199,87,38,157,3939
2020-01-11,대전,경남,1835,20,113,96,42,77,2183,1313,13,97,38,23,41,1525
2020-01-11,대전,경북,2952,32,86,97,36,127,3330,2758,31,107,58,45,111,3110
2020-01-11,대전,광주,818,6,19,21,13,22,899,737,13,12,14,8,26,810
2020-01-11,대전,대구,1133,10,40,35,16,44,1278,1558,12,59,39,29,62,1759
2020-01-11,대전,대전,12267,260,261,164,172,838,13962,12267,260,261,164,172,838,13962
2020-01-11,대전,부산,108,2,4,10,7,0,131,116,0,7,8,20,4,155
2020-01-11,대전,서울,2337,29,293,26,11,114,2810,2657,19,280,33,13,116,3118
2020-01-11,대전,세종,3232,77,46,17,108,222,3702,3361,81,47,18,175,230,3912
2020-01-11,대전,울산,158,1,12,12,14,5,202,136,9,12,5,16,4,182
2020-01-11,대전,전남,582,6,5,32,15,19,659,510,6,9,12,14,9,560
2020-01-11,대전,전북,5354,44,90,62,32,215,5797,5003,60,78,33,25,183,5382
2020-01-11,대전,충남,15989,276,365,134,242,920,17926,15577,263,386,111,216,943,17496
2020-01-11,대전,충북,10450,289,363,121,92,695,12010,9887,258,350,109,104,663,11371
2020-01-11,부산,강원,9,0,1,0,1,0,11,2,0,1,0,2,0,5
2020-01-11,부산,경기,268,7,23,107,98,13,516,291,14,42,129,85,14,575
2020-01-11,부산,경남,93542,1565,2315,1169,2121,5983,106695,98102,1578,2374,1358,2201,6193,111806
2020-01-11,부산,경북,9491,76,360,80,302,390,10699,8209,73,317,103,243,353,9298
2020-01-11,부산,광주,673,3,65,45,47,13,846,694,5,48,19,34,15,815
2020-01-11,부산,대구,4567,48,245,34,92,178,5164,1073,27,82,38,45,32,1297
2020-01-11,부산,대전,116,0,7,8,20,4,155,108,2,4,10,7,0,131
2020-01-11,부산,부산,49468,419,438,399,1214,2969,54907,49468,419,438,399,1214,2969,54907
2020-01-11,부산,서울,264,2,15,36,23,11,351,257,4,23,44,28,7,363
2020-01-11,부산,세종,33,0,2,3,7,0,45,29,0,0,1,1,2,33
2020-01-11,부산,울산,19633,209,324,256,1061,1211,22694,21836,213,258,179,1051,1367,24904
2020-01-11,부산,전남,2703,40,120,68,256,91,3278,2426,38,89,54,239,85,2931
2020-01-11,부산,전북,613,2,51,19,43,14,742,464,4,44,15,29,7,563
2020-01-11,부산,충남,189,7,15,11,58,8,288,200,3,16,35,84,7,345
2020-01-11,부산,충북,165,4,20,26,89,6,310,200,10,23,66,77,4,380
2020-01-11,서울,강원,1422,11,373,7,9,40,1862,1032,10,437,5,10,41,1535
2020-01-11,서울,경기,131755,3603,5872,2289,1927,7618,153064,137360,4215,6066,2797,2202,7966,160606
2020-01-11,서울,경남,3362,35,609,132,82,103,4323,2110,26,535,128,77,56,2932
2020-01-11,서울,경북,4700,41,385,156,76,153,5511,3450,47,394,169,76,117,4253
2020-01-11,서울,광주,1336,11,26,39,9,33,1454,927,14,25,44,13,24,1047
2020-01-11,서울,대구,2241,25,204,90,38,62,2660,2938,43,292,124,58,80,3535
2020-01-11,서울,대전,2657,19,280,33,13,116,3118,2337,29,293,26,11,114,2810
2020-01-11,서울,부산,257,4,23,44,28,7,363,264,2,15,36,23,11,351
2020-01-11,서울,서울,192,14,11,2,2,14,235,192,14,11,2,2,14,235
2020-01-11,서울,세종,50,1,1,0,0,2,54,65,0,0,0,0,4,69
2020-01-11,서울,울산,29,0,4,4,0,0,37,25,0,6,5,5,1,42
2020-01-11,서울,전남,1503,9,33,24,23,38,1630,991,7,28,42,13,25,1106
2020-01-11,서울,전북,2819,21,88,12,12,77,3029,1822,24,72,18,10,60,2006
2020-01-11,서울,충남,35736,258,2501,448,441,1303,40687,34517,310,2647,619,645,1279,40017
2020-01-11,서울,충북,17682,247,1157,452,420,689,20647,17225,286,1206,463,595,725,20500
2020-01-11,세종,강원,11,1,0,0,1,0,13,7,0,0,1,0,1,9
2020-01-11,세종,경기,120,3,2,3,1,3,132,69,1,3,1,2,4,80
2020-01-11,세종,경남,428,2,19,5,11,16,481,250,2,7,2,7,14,282
2020-01-11,세종,경북,452,6,12,7,6,26,509,389,2,12,9,8,14,434
2020-01-11,세종,광주,292,0,7,1,4,8,312,193,0,5,3,0,5,206
2020-01-11,세종,대구,273,0,0,1,3,5,282,343,1,10,2,5,12,373
2020-01-11,세종,대전,3361,81,47,18,175,230,3912,3232,77,46,17,108,222,3702
2020-01-11,세종,부산,29,0,0,1,1,2,33,33,0,2,3,7,0,45
2020-01-11,세종,서울,65,0,0,0,0,4,69,50,1,1,0,0,2,54
2020-01-11,세종,세종,320,14,8,0,2,17,361,320,14,8,0,2,17,361
2020-01-11,세종,울산,13,0,1,3,0,0,17,15,0,1,1,1,2,20
2020-01-11,세종,전남,297,2,3,7,7,10,326,178,2,5,4,6,3,198
2020-01-11,세종,전북,1411,11,14,9,10,42,1497,1087,9,17,4,15,30,1162
2020-01-11,세종,충남,7312,112,104,66,104,321,8019,5564,93,102,51,91,202,6103
2020-01-11,세종,충북,339,4,16,4,8,25,396,325,9,9,10,5,24,382
2020-01-11,울산,강원,4,0,0,0,0,0,4,2,0,1,1,0,0,4
2020-01-11,울산,경기,41,1,2,10,33,1,88,55,2,4,6,8,0,75
2020-01-11,울산,경남,12193,346,510,238,272,685,14244,12324,372,485,262,257,721,14421
2020-01-11,울산,경북,7973,79,234,164,768,409,9627,7535,76,240,253,690,402,9196
2020-01-11,울산,광주,79,1,8,8,6,3,105,64,0,8,1,3,3,79
2020-01-11,울산,대구,2289,36,133,35,130,99,2722,2069,36,128,43,100,95,2471
2020-01-11,울산,대전,136,9,12,5,16,4,182,158,1,12,12,14,5,202
2020-01-11,울산,부산,21836,213,258,179,1051,1367,24904,19633,209,324,256,1061,1211,22694
2020-01-11,울산,서울,25,0,6,5,5,1,42,29,0,4,4,0,0,37
2020-01-11,울산,세종,15,0,1,1,1,2,20,13,0,1,3,0,0,17
2020-01-11,울산,울산,6325,145,267,136,319,514,7706,6325,145,267,136,319,514,7706
2020-01-11,울산,전남,293,3,7,10,12,6,331,269,8,10,9,8,9,313
2020-01-11,울산,전북,94,0,8,1,2,0,105,63,0,9,2,3,2,79
2020-01-11,울산,충남,173,4,13,17,55,6,268,150,4,18,19,58,10,259
2020-01-11,울산,충북,34,0,4,6,23,2,69,27,0,2,10,30,0,69
2020-01-11,전남,강원,68,1,2,0,3,2,76,56,1,6,0,3,1,67
2020-01-11,전남,경기,1111,17,68,78,60,33,1367,1435,12,110,99,119,36,1811
2020-01-11,전남,경남,8415,150,363,258,668,350,10204,8539,150,331,326,637,337,10320
2020-01-11,전남,경북,1517,29,65,67,356,42,2076,1582,33,55,53,232,40,1995
2020-01-11,전남,광주,38416,664,931,454,1216,1360,43041,40729,639,1055,528,1177,1455,45583
2020-01-11,전남,대구,844,5,44,28,16,43,980,971,8,49,14,31,38,1111
2020-01-11,전남,대전,510,6,9,12,14,9,560,582,6,5,32,15,19,659
2020-01-11,전남,부산,2426,38,89,54,239,85,2931,2703,40,120,68,256,91,3278
2020-01-11,전남,서울,991,7,28,42,13,25,1106,1503,9,33,24,23,38,1630
2020-01-11,전남,세종,178,2,5,4,6,3,198,297,2,3,7,7,10,326
2020-01-11,전남,울산,269,8,10,9,8,9,313,293,3,7,10,12,6,331
2020-01-11,전남,전남,51820,809,1339,1068,2825,1881,59742,51820,809,1339,1068,2825,1881,59742
2020-01-11,전남,전북,7716,153,382,332,834,215,9632,7514,142,334,377,864,208,9439
2020-01-11,전남,충남,5704,47,405,295,379,137,6967,7003,39,493,299,575,179,8588
2020-01-11,전남,충북,554,10,29,44,131,12,780,636,8,37,53,170,15,919
2020-01-11,전북,강원,242,2,9,12,3,7,275,211,3,12,2,7,7,242
2020-01-11,전북,경기,2084,21,125,68,92,69,2459,2817,19,175,73,97,96,3277
2020-01-11,전북,경남,2215,36,119,40,136,76,2622,2702,33,109,54,142,93,3133
2020-01-11,전북,경북,2148,48,101,63,109,74,2543,2488,47,121,91,128,78,2953
2020-01-11,전북,광주,10750,263,371,186,221,379,12170,10986,240,354,170,173,374,12297
2020-01-11,전북,대구,542,11,44,8,8,17,630,622,5,50,5,7,21,710
2020-01-11,전북,대전,5003,60,78,33,25,183,5382,5354,44,90,62,32,215,5797
2020-01-11,전북,부산,464,4,44,15,29,7,563,613,2,51,19,43,14,742
2020-01-11,전북,서울,1822,24,72,18,10,60,2006,2819,21,88,12,12,77,3029
2020-01-11,전북,세종,1087,9,17,4,15,30,1162,1411,11,14,9,10,42,1497
2020-01-11,전북,울산,63,0,9,2,3,2,79,94,0,8,1,2,0,105
2020-01-11,전북,전남,7514,142,334,377,864,208,9439,7716,153,382,332,834,215,9632
2020-01-11,전북,전북,17209,406,727,319,432,558,19651,17209,406,727,319,432,558,19651
2020-01-11,전북,충남,19932,265,1255,485,621,647,23205,22164,272,1284,509,702,794,25725
2020-01-11,전북,충북,2539,52,114,142,127,92,3066,2952,60,149,115,147,101,3524
2020-01-11,충남,강원,716,5,33,31,32,25,842,422,2,29,15,19,20,507
2020-01-11,충남,경기,47090,699,1911,1089,2243,2081,55113,46173,712,1916,1110,2109,2109,54129
2020-01-11,충남,경남,2594,31,110,185,271,82,3273,1515,19,71,94,87,56,1842
2020-01-11,충남,경북,4814,59,216,276,405,163,5933,4026,71,185,261,305,157,5005
2020-01-11,충남,광주,6158,67,630,317,220,173,7565,5667,51,607,200,141,140,6806
2020-01-11,충남,대구,1658,16,69,118,97,60,2018,1873,25,88,97,95,69,2247
2020-01-11,충남,대전,15577,263,386,111,216,943,17496,15989,276,365,134,242,920,17926
2020-01-11,충남,부산,200,3,16,35,84,7,345,189,7,15,11,58,8,288
2020-01-11,충남,서울,34517,310,2647,619,645,1279,40017,35736,258,2501,448,441,1303,40687
2020-01-11,충남,세종,5564,93,102,51,91,202,6103,7312,112,104,66,104,321,8019
2020-01-11,충남,울산,150,4,18,19,58,10,259,173,4,13,17,55,6,268
2020-01-11,충남,전남,7003,39,493,299,575,179,8588,5704,47,405,295,379,137,6967
2020-01-11,충남,전북,22164,272,1284,509,702,794,25725,19932,265,1255,485,621,647,23205
2020-01-11,충남,충남,117955,1786,6168,3175,4915,4996,138995,117955,1786,6168,3175,4915,4996,138995
2020-01-11,충남,충북,13012,291,512,469,712,704,15700,11521,309,498,348,681,623,13980
2020-01-11,충북,강원,7128,142,238,122,149,347,8126,6111,147,235,113,183,320,7109
2020-01-11,충북,경기,32261,882,1452,1315,2046,1501,39457,34832,960,1519,1542,1864,1598,42315
2020-01-11,충북,경남,2353,43,178,287,362,63,3286,1690,28,114,126,146,65,2169
2020-01-11,충북,경북,8114,123,368,350,603,287,9845,7638,118,339,294,456,287,9132
2020-01-11,충북,광주,942,9,62,86,70,39,1208,783,16,53,40,25,24,941
2020-01-11,충북,대구,2049,44,139,137,96,76,2541,2707,44,177,101,174,75,3278
2020-01-11,충북,대전,9887,258,350,109,104,663,11371,10450,289,363,121,92,695,12010
2020-01-11,충북,부산,200,10,23,66,77,4,380,165,4,20,26,89,6,310
2020-01-11,충북,서울,17225,286,1206,463,595,725,20500,17682,247,1157,452,420,689,20647
2020-01-11,충북,세종,325,9,9,10,5,24,382,339,4,16,4,8,25,396
2020-01-11,충북,울산,27,0,2,10,30,0,69,34,0,4,6,23,2,69
2020-01-11,충북,전남,636,8,37,53,170,15,919,554,10,29,44,131,12,780
2020-01-11,충북,전북,2952,60,149,115,147,101,3524,2539,52,114,142,127,92,3066
2020-01-11,충북,충남,11521,309,498,348,681,623,13980,13012,291,512,469,712,704,15700
2020-01-11,충북,충북,36625,1027,1400,1037,1672,1881,43642,36625,1027,1400,1037,1672,1881,43642
2020-01-12,강원,강원,83184,648,2763,294,517,4334,91740,83184,648,2763,294,517,4334,91740
2020-01-12,강원,경기,45255,223,1184,168,113,1771,48714,27497,182,1092,96,133,1234,30234
2020-01-12,강원,경남,355,1,18,4,2,9,389,166,0,12,6,9,7,200
2020-01-12,강원,경북,903,17,53,6,1,23,1003,694,10,51,8,4,31,798
2020-01-12,강원,광주,154,0,17,3,2,4,180,121,0,14,1,0,4,140
2020-01-12,강원,대구,537,5,37,3,1,11,594,527,4,69,3,0,11,614
2020-01-12,강원,대전,341,3,33,0,0,13,390,240,3,41,1,0,11,296
2020-01-12,강원,부산,14,0,0,0,0,0,14,7,0,1,1,0,0,9
2020-01-12,강원,서울,1632,5,559,3,2,60,2261,871,4,380,3,0,24,1282
2020-01-12,강원,세종,8,0,0,0,0,0,8,15,0,1,0,0,0,16
2020-01-12,강원,울산,4,0,0,0,0,0,4,5,0,0,0,0,0,5
2020-01-12,강원,전남,88,0,4,0,1,1,94,61,0,2,1,3,4,71
2020-01-12,강원,전북,278,1,10,2,1,4,296,231,3,8,5,6,9,262
2020-01-12,강원,충남,677,2,20,5,8,32,744,588,3,27,9,12,21,660
2020-01-12,강원,충북,6305,61,161,29,63,286,6905,5374,50,179,40,45,288,5976
2020-01-12,경기,강원,27497,182,1092,96,133,1234,30234,45255,223,1184,168,113,1771,48714
2020-01-12,경기,경기,303308,4579,6837,3156,4019,18862,340761,303308,4579,6837,3156,4019,18862,340761
2020-01-12,경기,경남,3008,17,209,143,93,107,3577,3102,22,195,129,86,97,3631
2020-01-12,경기,경북,4898,50,218,171,67,186,5590,6876,52,216,204,76,251,7675
2020-01-12,경기,광주,927,5,113,34,13,26,1118,1178,3,98,48,25,31,1383
2020-01-12,경기,대구,2229,22,124,76,36,80,2567,3822,16,127,71,61,136,4233
2020-01-12,경기,대전,2569,19,156,6,4,123,2877,3271,26,160,11,13,151,3632
2020-01-12,경기,부산,243,4,16,36,20,6,325,508,5,13,26,35,15,602
2020-01-12,경기,서울,108737,1615,4080,1072,500,6230,122234,119334,1830,4121,1043,522,6865,133715
2020-01-12,경기,세종,41,0,2,2,0,0,45,69,0,2,1,0,1,73
2020-01-12,경기,울산,26,1,2,1,3,0,33,52,1,3,3,12,1,72
2020-01-12,경기,전남,895,5,76,37,20,31,1064,1494,7,62,69,30,36,1698
2020-01-12,경기,전북,1692,9,117,39,30,63,1950,2721,9,95,50,25,92,2992
2020-01-12,경기,충남,38089,281,1326,465,629,1853,42643,40993,294,1307,363,585,1843,45385
2020-01-12,경기,충북,27507,494,972,505,496,1431,31405,30982,478,965,454,384,1499,34762
2020-01-12,경남,강원,166,0,12,6,9,7,200,355,1,18,4,2,9,389
2020-01-12,경남,경기,3102,22,195,129,86,97,3631,3008,17,209,143,93,107,3577
2020-01-12,경남,경남,165745,2088,3560,946,1646,10403,184388,165745,2088,3560,946,1646,10403,184388
2020-01-12,경남,경북,16051,141,481,155,154,718,17700,21347,230,639,259,215,982,23672
2020-01-12,경남,광주,1799,13,118,46,17,51,2044,1774,6,125,37,16,56,2014
2020-01-12,경남,대구,18590,176,642,236,308,788,20740,15131,109,461,78,54,677,16510
2020-01-12,경남,대전,1380,8,89,31,11,68,1587,1659,10,100,11,4,72,1856
2020-01-12,경남,부산,82992,645,1728,263,610,5037,91275,80440,643,1572,204,592,5074,88525
2020-01-12,경남,서울,2638,30,497,129,65,73,3432,2893,20,527,36,21,90,3587
2020-01-12,경남,세종,341,0,6,2,0,10,359,325,2,16,1,0,19,363
2020-01-12,경남,울산,11716,139,283,50,66,626,12880,11211,112,298,54,70,609,12354
2020-01-12,경남,전남,7709,66,276,124,195,312,8682,8222,83,286,156,205,340,9292
2020-01-12,경남,전북,2083,19,95,34,11,70,2312,2714,18,117,25,7,90,2971
2020-01-12,경남,충남,2040,17,67,47,28,67,2266,2064,16,74,55,44,89,2342
2020-01-12,경남,충북,2095,15,98,56,38,74,2376,2265,16,124,93,65,92,2655
2020-01-12,경북,강원,694,10,51,8,4,31,798,903,17,53,6,1,23,1003
2020-01-12,경북,경기,6876,52,216,204,76,251,7675,4898,50,218,171,67,186,5590
2020-01-12,경북,경남,21347,230,639,259,215,982,23672,16051,141,481,155,154,718,17700
2020-01-12,경북,경북,81520,932,1731,548,481,3698,88910,81520,932,1731,548,481,3698,88910
2020-01-12,경북,광주,1238,24,77,77,13,39,1468,1189,15,51,77,10,41,1383
2020-01-12,경북,대구,67792,589,1252,303,347,3226,73509,70944,665,1543,279,379,3484,77294
2020-01-12,경북,대전,2683,14,78,26,17,125,2943,2642,13,84,13,4,126,2882
2020-01-12,경북,부산,8785,31,283,36,92,353,9580,9420,40,302,39,108,399,10308
2020-01-12,경북,서울,4385,36,344,173,37,146,5121,3621,30,309,57,22,105,4144
2020-01-12,경북,세종,428,1,10,4,1,15,459,361,3,7,4,1,8,384
2020-01-12,경북,울산,8340,29,145,64,200,410,9188,7132,31,151,53,195,336,7898
2020-01-12,경북,전남,1581,23,66,44,82,57,1853,1608,17,54,36,129,45,1889
2020-01-12,경북,전북,1953,31,80,33,48,69,2214,2017,32,70,38,43,83,2283
2020-01-12,경북,충남,4529,29,89,63,106,148,4964,3950,20,110,71,96,144,4391
2020-01-12,경북,충북,8385,69,217,151,155,323,9300,7202,72,269,113,128,297,8081
2020-01-12,광주,강원,121,0,14,1,0,4,140,154,0,17,3,2,4,180
2020-01-12,광주,경기,1178,3,98,48,25,31,1383,927,5,113,34,13,26,1118
2020-01-12,광주,경남,1774,6,125,37,16,56,2014,1799,13,118,46,17,51,2044
2020-01-12,광주,경북,1189,15,51,77,10,41,1383,1238,24,77,77,13,39,1468
2020-01-12,광주,광주,10272,134,446,105,44,367,11368,10272,134,446,105,44,367,11368
2020-01-12,광주,대구,745,14,61,64,13,23,920,766,15,92,32,7,17,929
2020-01-12,광주,대전,591,2,5,3,6,17,624,645,4,9,4,4,22,688
2020-01-12,광주,부산,576,9,58,13,2,12,670,842,5,80,7,6,21,961
2020-01-12,광주,서울,1153,8,19,12,5,28,1225,919,12,18,7,1,18,975
2020-01-12,광주,세종,231,0,1,0,0,6,238,174,0,1,1,1,2,179
2020-01-12,광주,울산,82,1,9,0,0,3,95,60,1,12,1,1,0,75
2020-01-12,광주,전남,33229,269,833,213,192,1098,35834,33137,259,749,316,179,1129,35769
2020-01-12,광주,전북,8630,91,236,53,35,259,9304,9543,110,235,57,28,323,10296
2020-01-12,광주,충남,6028,45,530,129,91,164,6987,5043,31,540,107,50,123,5894
2020-01-12,광주,충북,811,11,44,18,10,29,923,728,11,41,32,5,18,835
2020-01-12,대구,강원,527,4,69,3,0,11,614,537,5,37,3,1,11,594
2020-01-12,대구,경기,3822,16,127,71,61,136,4233,2229,22,124,76,36,80,2567
2020-01-12,대구,경남,15131,109,461,78,54,677,16510,18590,176,642,236,308,788,20740
2020-01-12,대구,경북,70944,665,1543,279,379,3484,77294,67792,589,1252,303,347,3226,73509
2020-01-12,대구,광주,766,15,92,32,7,17,929,745,14,61,64,13,23,920
2020-01-12,대구,대구,39815,387,614,161,191,2272,43440,39815,387,614,161,191,2272,43440
2020-01-12,대구,대전,1502,9,41,7,6,47,1612,1008,3,27,3,0,35,1076
2020-01-12,대구,부산,953,7,36,16,7,40,1059,5224,23,142,25,31,182,5627
2020-01-12,대구,서울,2839,18,197,71,21,89,3235,2053,16,150,10,5,64,2298
2020-01-12,대구,세종,404,1,13,1,0,19,438,231,0,5,0,0,8,244
2020-01-12,대구,울산,2242,15,103,13,48,89,2510,1906,14,103,10,47,71,2151
2020-01-12,대구,전남,900,6,60,7,17,26,1016,959,10,50,20,29,13,1081
2020-01-12,대구,전북,519,1,54,2,2,18,596,615,0,55,5,2,22,699
2020-01-12,대구,충남,2255,17,44,28,28,89,2461,1322,8,31,28,19,45,1453
2020-01-12,대구,충북,3036,20,161,61,58,99,3435,2022,17,97,48,19,62,2265
2020-01-12,대전,강원,240,3,41,1,0,11,296,341,3,33,0,0,13,390
2020-01-12,대전,경기,3271,26,160,11,13,151,3632,2569,19,156,6,4,123,2877
2020-01-12,대전,경남,1659,10,100,11,4,72,1856,1380,8,89,31,11,68,1587
2020-01-12,대전,경북,2642,13,84,13,4,126,2882,2683,14,78,26,17,125,2943
2020-01-12,대전,광주,645,4,9,4,4,22,688,591,2,5,3,6,17,624
2020-01-12,대전,대구,1008,3,27,3,0,35,1076,1502,9,41,7,6,47,1612
2020-01-12,대전,대전,9344,77,120,33,11,613,10198,9344,77,120,33,11,613,10198
2020-01-12,대전,부산,134,0,2,3,0,4,143,193,1,3,4,2,4,207
2020-01-12,대전,서울,2430,10,245,6,1,113,2805,2068,10,237,1,0,106,2422
2020-01-12,대전,세종,2574,22,27,0,4,161,2788,2171,24,26,5,9,134,2369
2020-01-12,대전,울산,141,0,11,1,12,2,167,141,0,10,0,6,2,159
2020-01-12,대전,전남,479,0,15,6,5,7,512,583,0,16,6,6,14,625
2020-01-12,대전,전북,4179,17,67,13,13,177,4466,4737,20,69,25,16,176,5043
2020-01-12,대전,충남,12950,75,242,43,27,780,14117,12285,81,222,50,18,724,13380
2020-01-12,대전,충북,8930,119,263,22,21,561,9916,7987,90,250,24,15,478,8844
2020-01-12,부산,강원,7,0,1,1,0,0,9,14,0,0,0,0,0,14
2020-01-12,부산,경기,508,5,13,26,35,15,602,243,4,16,36,20,6,325
2020-01-12,부산,경남,80440,643,1572,204,592,5074,88525,82992,645,1728,263,610,5037,91275
2020-01-12,부산,경북,9420,40,302,39,108,399,10308,8785,31,283,36,92,353,9580
2020-01-12,부산,광주,842,5,80,7,6,21,961,576,9,58,13,2,12,670
2020-01-12,부산,대구,5224,23,142,25,31,182,5627,953,7,36,16,7,40,1059
2020-01-12,부산,대전,193,1,3,4,2,4,207,134,0,2,3,0,4,143
2020-01-12,부산,부산,47256,137,170,80,299,2656,50598,47256,137,170,80,299,2656,50598
2020-01-12,부산,서울,417,6,12,14,10,6,465,255,2,8,6,6,11,288
2020-01-12,부산,세종,43,0,0,0,0,4,47,36,0,0,0,0,1,37
2020-01-12,부산,울산,20770,90,143,83,299,1149,22534,19291,90,79,48,290,1126,20924
2020-01-12,부산,전남,2929,19,129,29,98,107,3311,2385,24,120,93,134,84,2840
2020-01-12,부산,전북,632,0,81,1,12,20,746,561,0,49,8,12,17,647
2020-01-12,부산,충남,314,3,9,3,6,10,345,202,2,12,12,11,5,244
2020-01-12,부산,충북,277,4,8,12,28,8,337,169,8,12,16,11,6,222
2020-01-12,서울,강원,871,4,380,3,0,24,1282,1632,5,559,3,2,60,2261
2020-01-12,서울,경기,119334,1830,4121,1043,522,6865,133715,108737,1615,4080,1072,500,6230,122234
2020-01-12,서울,경남,2893,20,527,36,21,90,3587,2638,30,497,129,65,73,3432
2020-01-12,서울,경북,3621,30,309,57,22,105,4144,4385,36,344,173,37,146,5121
2020-01-12,서울,광주,919,12,18,7,1,18,975,1153,8,19,12,5,28,1225
2020-01-12,서울,대구,2053,16,150,10,5,64,2298,2839,18,197,71,21,89,3235
2020-01-12,서울,대전,2068,10,237,1,0,106,2422,2430,10,245,6,1,113,2805
2020-01-12,서울,부산,255,2,8,6,6,11,288,417,6,12,14,10,6,465
2020-01-12,서울,서울,182,1,5,1,1,8,198,182,1,5,1,1,8,198
2020-01-12,서울,세종,34,0,0,0,0,1,35,37,0,2,0,0,1,40
2020-01-12,서울,울산,28,0,1,0,0,1,30,27,0,5,0,1,0,33
2020-01-12,서울,전남,974,5,19,14,3,30,1045,1642,6,30,61,45,36,1820
2020-01-12,서울,전북,1441,11,68,3,3,49,1575,2571,19,88,24,6,80,2788
2020-01-12,서울,충남,32958,156,2298,199,162,1337,37110,36156,204,2206,643,279,1360,40848
2020-01-12,서울,충북,15629,129,974,221,101,667,17721,15701,132,1050,238,68,619,17808
2020-01-12,세종,강원,15,0,1,0,0,0,16,8,0,0,0,0,0,8
2020-01-12,세종,경기,69,0,2,1,0,1,73,41,0,2,2,0,0,45
2020-01-12,세종,경남,325,2,16,1,0,19,363,341,0,6,2,0,10,359
2020-01-12,세종,경북,361,3,7,4,1,8,384,428,1,10,4,1,15,459
2020-01-12,세종,광주,174,0,1,1,1,2,179,231,0,1,0,0,6,238
2020-01-12,세종,대구,231,0,5,0,0,8,244,404,1,13,1,0,19,438
2020-01-12,세종,대전,2171,24,26,5,9,134,2369,2574,22,27,0,4,161,2788
2020-01-12,세종,부산,36,0,0,0,0,1,37,43,0,0,0,0,4,47
2020-01-12,세종,서울,37,0,2,0,0,1,40,34,0,0,0,0,1,35
2020-01-12,세종,세종,246,4,0,0,0,7,257,246,4,0,0,0,7,257
2020-01-12,세종,울산,13,0,0,0,0,0,13,16,0,0,0,2,1,19
2020-01-12,세종,전남,193,2,3,5,3,5,211,319,2,1,6,2,6,336
2020-01-12,세종,전북,787,1,6,2,8,39,843,1115,2,8,6,10,53,1194
2020-01-12,세종,충남,5743,44,58,19,20,276,6160,5481,33,59,26,23,238,5860
2020-01-12,세종,충북,311,2,4,3,2,19,341,340,6,2,0,2,20,370
2020-01-12,울산,강원,5,0,0,0,0,0,5,4,0,0,0,0,0,4
2020-01-12,울산,경기,52,1,3,3,12,1,72,26,1,2,1,3,0,33
2020-01-12,울산,경남,11211,112,298,54,70,609,12354,11716,139,283,50,66,626,12880
2020-01-12,울산,경북,7132,31,151,53,195,336,7898,8340,29,145,64,200,410,9188
2020-01-12,울산,광주,60,1,12,1,1,0,75,82,1,9,0,0,3,95
2020-01-12,울산,대구,1906,14,103,10,47,71,2151,2242,15,103,13,48,89,2510
2020-01-12,울산,대전,141,0,10,0,6,2,159,141,0,11,1,12,2,167
2020-01-12,울산,부산,19291,90,79,48,290,1126,20924,20770,90,143,83,299,1149,22534
2020-01-12,울산,서울,27,0,5,0,1,0,33,28,0,1,0,0,1,30
2020-01-12,울산,세종,16,0,0,0,2,1,19,13,0,0,0,0,0,13
2020-01-12,울산,울산,5818,35,148,17,44,407,6469,5818,35,148,17,44,407,6469
2020-01-12,울산,전남,262,2,12,3,3,4,286,299,1,11,4,5,13,333
2020-01-12,울산,전북,86,0,7,0,1,1,95,89,0,9,0,0,0,98
2020-01-12,울산,충남,165,2,7,6,24,2,206,138,0,5,6,19,5,173
2020-01-12,울산,충북,34,0,4,2,2,1,43,32,0,2,0,5,0,39
2020-01-12,전남,강원,61,0,2,1,3,4,71,88,0,4,0,1,1,94
2020-01-12,전남,경기,1494,7,62,69,30,36,1698,895,5,76,37,20,31,1064
2020-01-12,전남,경남,8222,83,286,156,205,340,9292,7709,66,276,124,195,312,8682
2020-01-12,전남,경북,1608,17,54,36,129,45,1889,1581,23,66,44,82,57,1853
2020-01-12,전남,광주,33137,259,749,316,179,1129,35769,33229,269,833,213,192,1098,35834
2020-01-12,전남,대구,959,10,50,20,29,13,1081,900,6,60,7,17,26,1016
2020-01-12,전남,대전,583,0,16,6,6,14,625,479,0,15,6,5,7,512
2020-01-12,전남,부산,2385,24,120,93,134,84,2840,2929,19,129,29,98,107,3311
2020-01-12,전남,서울,1642,6,30,61,45,36,1820,974,5,19,14,3,30,1045
2020-01-12,전남,세종,319,2,1,6,2,6,336,193,2,3,5,3,5,211
2020-01-12,전남,울산,299,1,11,4,5,13,333,262,2,12,3,3,4,286
2020-01-12,전남,전남,45363,457,1057,773,826,1527,50003,45363,457,1057,773,826,1527,50003
2020-01-12,전남,전북,7325,94,189,265,298,201,8372,6937,83,221,169,265,179,7854
2020-01-12,전남,충남,7769,48,426,475,428,215,9361,5293,26,415,125,159,147,6165
2020-01-12,전남,충북,688,4,33,30,61,19,835,543,3,37,36,60,17,696
2020-01-12,전북,강원,231,3,8,5,6,9,262,278,1,10,2,1,4,296
2020-01-12,전북,경기,2721,9,95,50,25,92,2992,1692,9,117,39,30,63,1950
2020-01-12,전북,경남,2714,18,117,25,7,90,2971,2083,19,95,34,11,70,2312
2020-01-12,전북,경북,2017,32,70,38,43,83,2283,1953,31,80,33,48,69,2214
2020-01-12,전북,광주,9543,110,235,57,28,323,10296,8630,91,236,53,35,259,9304
2020-01-12,전북,대구,615,0,55,5,2,22,699,519,1,54,2,2,18,596
2020-01-12,전북,대전,4737,20,69,25,16,176,5043,4179,17,67,13,13,177,4466
2020-01-12,전북,부산,561,0,49,8,12,17,647,632,0,81,1,12,20,746
2020-01-12,전북,서울,2571,19,88,24,6,80,2788,1441,11,68,3,3,49,1575
2020-01-12,전북,세종,1115,2,8,6,10,53,1194,787,1,6,2,8,39,843
2020-01-12,전북,울산,89,0,9,0,0,0,98,86,0,7,0,1,1,95
2020-01-12,전북,전남,6937,83,221,169,265,179,7854,7325,94,189,265,298,201,8372
2020-01-12,전북,전북,14437,149,427,151,113,530,15807,14437,149,427,151,113,530,15807
2020-01-12,전북,충남,20783,119,1018,297,287,758,23262,16838,114,1037,157,216,540,18902
2020-01-12,전북,충북,2842,32,70,117,51,97,3209,2291,37,74,84,40,76,2602
2020-01-12,충남,강원,588,3,27,9,12,21,660,677,2,20,5,8,32,744
2020-01-12,충남,경기,40993,294,1307,363,585,1843,45385,38089,281,1326,465,629,1853,42643
2020-01-12,충남,경남,2064,16,74,55,44,89,2342,2040,17,67,47,28,67,2266
2020-01-12,충남,경북,3950,20,110,71,96,144,4391,4529,29,89,63,106,148,4964
2020-01-12,충남,광주,5043,31,540,107,50,123,5894,6028,45,530,129,91,164,6987
2020-01-12,충남,대구,1322,8,31,28,19,45,1453,2255,17,44,28,28,89,2461
2020-01-12,충남,대전,12285,81,222,50,18,724,13380,12950,75,242,43,27,780,14117
2020-01-12,충남,부산,202,2,12,12,11,5,244,314,3,9,3,6,10,345
2020-01-12,충남,서울,36156,204,2206,643,279,1360,40848,32958,156,2298,199,162,1337,37110
2020-01-12,충남,세종,5481,33,59,26,23,238,5860,5743,44,58,19,20,276,6160
2020-01-12,충남,울산,138,0,5,6,19,5,173,165,2,7,6,24,2,206
2020-01-12,충남,전남,5293,26,415,125,159,147,6165,7769,48,426,475,428,215,9361
2020-01-12,충남,전북,16838,114,1037,157,216,540,18902,20783,119,1018,297,287,758,23262
2020-01-12,충남,충남,106984,856,4820,1382,1611,4371,120024,106984,856,4820,1382,1611,4371,120024
2020-01-12,충남,충북,10560,145,315,195,177,540,11932,10017,145,335,154,229,545,11425
2020-01-12,충북,강원,5374,50,179,40,45,288,5976,6305,61,161,29,63,286,6905
2020-01-12,충북,경기,30982,478,965,454,384,1499,34762,27507,494,972,505,496,1431,31405
2020-01-12,충북,경남,2265,16,124,93,65,92,2655,2095,15,98,56,38,74,2376
2020-01-12,충북,경북,7202,72,269,113,128,297,8081,8385,69,217,151,155,323,9300
2020-01-12,충북,광주,728,11,41,32,5,18,835,811,11,44,18,10,29,923
2020-01-12,충북,대구,2022,17,97,48,19,62,2265,3036,20,161,61,58,99,3435
2020-01-12,충북,대전,7987,90,250,24,15,478,8844,8930,119,263,22,21,561,9916
2020-01-12,충북,부산,169,8,12,16,11,6,222,277,4,8,12,28,8,337
2020-01-12,충북,서울,15701,132,1050,238,68,619,17808,15629,129,974,221,101,667,17721
2020-01-12,충북,세종,340,6,2,0,2,20,370,311,2,4,3,2,19,341
2020-01-12,충북,울산,32,0,2,0,5,0,39,34,0,4,2,2,1,43
2020-01-12,충북,전남,543,3,37,36,60,17,696,688,4,33,30,61,19,835
2020-01-12,충북,전북,2291,37,74,84,40,76,2602,2842,32,70,117,51,97,3209
2020-01-12,충북,충남,10017,145,335,154,229,545,11425,10560,145,315,195,177,540,11932
2020-01-12,충북,충북,31253,414,734,412,454,1656,34923,31253,414,734,412,454,1656,34923
2020-01-13,강원,강원,69266,2116,3162,1259,2143,4687,82633,69266,2116,3162,1259,2143,4687,82633
2020-01-13,강원,경기,21959,585,1326,571,719,968,26128,20853,601,1339,611,813,1014,25231
2020-01-13,강원,경남,235,2,9,14,21,4,285,137,0,7,18,14,5,181
2020-01-13,강원,경북,538,20,54,13,22,13,660,494,16,45,23,31,14,623
2020-01-13,강원,광주,98,1,18,11,14,2,144,114,1,15,12,6,4,152
2020-01-13,강원,대구,242,5,13,6,12,7,285,372,7,22,13,21,8,443
2020-01-13,강원,대전,157,0,35,3,2,10,207,203,2,30,8,1,8,252
2020-01-13,강원,부산,3,0,1,1,3,0,8,4,0,0,1,1,1,7
2020-01-13,강원,서울,665,16,274,6,14,27,1002,725,13,261,8,7,28,1042
2020-01-13,강원,세종,7,0,0,0,1,0,8,12,0,0,0,0,0,12
2020-01-13,강원,울산,5,0,0,0,0,0,5,3,0,0,0,2,0,5
2020-01-13,강원,전남,62,2,2,3,14,5,88,61,3,6,6,17,3,96
2020-01-13,강원,전북,160,3,9,6,19,6,203,201,6,11,20,19,8,265
2020-01-13,강원,충남,391,6,15,16,28,18,474,499,10,27,24,58,19,637
2020-01-13,강원,충북,5132,231,298,204,342,307,6514,5032,194,275,188,256,253,6198
2020-01-13,경기,강원,20853,601,1339,611,813,1014,25231,21959,585,1326,571,719,968,26128
2020-01-13,경기,경기,421211,23237,25129,18735,23167,32108,543587,421211,23237,25129,18735,23167,32108,543587
2020-01-13,경기,경남,2902,70,327,411,388,74,4172,2120,60,230,407,403,67,3287
2020-01-13,경기,경북,4596,165,542,634,476,138,6551,4174,180,480,813,508,157,6312
2020-01-13,경기,광주,803,38,186,239,143,23,1432,810,29,175,197,141,24,1376
2020-01-13,경기,대구,1959,99,215,264,188,67,2792,2844,102,240,336,400,111,4033
2020-01-13,경기,대전,1977,97,232,98,32,105,2541,2464,98,213,97,51,123,3046
2020-01-13,경기,부산,196,7,12,70,91,4,380,246,16,38,91,193,5,589
2020-01-13,경기,서울,141173,7213,8888,4276,3414,9676,174640,148380,6873,9221,4538,3186,10164,182362
2020-01-13,경기,세종,45,3,2,5,6,2,63,59,1,1,3,3,3,70
2020-01-13,경기,울산,44,0,0,6,12,1,63,46,1,8,12,55,1,123
2020-01-13,경기,전남,801,22,124,134,127,32,1240,734,23,87,119,112,25,1100
2020-01-13,경기,전북,1501,48,162,114,140,46,2011,1518,35,170,181,177,32,2113
2020-01-13,경기,충남,40104,1558,2967,2460,4635,2028,53752,36259,1477,2723,2371,4386,1916,49132
2020-01-13,경기,충북,29044,2218,3021,3002,3193,1481,41959,27163,2127,2927,2766,3408,1464,39855
2020-01-13,경남,강원,137,0,7,18,14,5,181,235,2,9,14,21,4,285
2020-01-13,경남,경기,2120,60,230,407,403,67,3287,2902,70,327,411,388,74,4172
2020-01-13,경남,경남,196597,10262,10359,7255,12714,14914,252101,196597,10262,10359,7255,12714,14914,252101
2020-01-13,경남,경북,10917,679,1033,913,1851,511,15904,13530,915,1249,1149,2611,658,20112
2020-01-13,경남,광주,1248,46,149,173,118,26,1760,1388,39,166,165,105,43,1906
2020-01-13,경남,대구,13994,742,980,987,1621,573,18897,11579,533,798,426,453,537,14326
2020-01-13,경남,대전,741,21,97,51,37,35,982,1115,20,105,74,61,48,1423
2020-01-13,경남,부산,87231,2681,2908,1702,4479,6220,105221,89281,2788,3195,1786,4605,6278,107933
2020-01-13,경남,서울,1923,36,445,211,122,54,2791,2688,37,478,99,48,87,3437
2020-01-13,경남,세종,192,0,16,7,7,3,225,335,2,21,9,14,4,385
2020-01-13,경남,울산,10402,631,793,479,642,663,13610,9603,554,781,446,651,596,12631
2020-01-13,경남,전남,6441,284,508,487,1387,304,9411,6120,277,464,399,1367,254,8881
2020-01-13,경남,전북,1492,36,122,89,175,40,1954,1453,43,128,95,137,32,1888
2020-01-13,경남,충남,1426,35,140,210,215,50,2076,1713,41,156,225,395,55,2585
2020-01-13,경남,충북,1354,44,139,245,237,50,2069,1554,79,206,356,485,50,2730
2020-01-13,경북,강원,494,16,45,23,31,14,623,538,20,54,13,22,13,660
2020-01-13,경북,경기,4174,180,480,813,508,157,6312,4596,165,542,634,476,138,6551
2020-01-13,경북,경남,13530,915,1249,1149,2611,658,20112,10917,679,1033,913,1851,511,15904
2020-01-13,경북,경북,74920,3775,4418,2802,4747,4028,94690,74920,3775,4418,2802,4747,4028,94690
2020-01-13,경북,광주,871,54,155,205,112,21,1418,913,53,115,191,78,26,1376
2020-01-13,경북,대구,72474,2943,2879,1525,2780,4075,86676,79023,3112,3308,1896,3411,4249,94999
2020-01-13,경북,대전,1740,66,127,108,69,84,2194,1934,60,130,86,50,76,2336
2020-01-13,경북,부산,4442,112,324,178,556,223,5835,5215,121,336,195,754,260,6881
2020-01-13,경북,서울,2565,78,386,329,114,77,3549,2984,58,346,164,62,98,3712
2020-01-13,경북,세종,290,5,20,19,5,20,359,335,4,19,19,15,10,402
2020-01-13,경북,울산,5159,168,362,394,1074,317,7474,4936,179,338,329,1234,298,7314
2020-01-13,경북,전남,1091,51,80,117,407,47,1793,1080,45,73,91,589,38,1916
2020-01-13,경북,전북,1735,93,202,184,245,66,2525,1557,95,183,170,222,64,2291
2020-01-13,경북,충남,3356,150,366,557,599,146,5174,3333,119,338,434,660,136,5020
2020-01-13,경북,충북,5471,247,566,678,879,211,8052,5415,215,604,571,968,214,7987
2020-01-13,광주,강원,114,1,15,12,6,4,152,98,1,18,11,14,2,144
2020-01-13,광주,경기,810,29,175,197,141,24,1376,803,38,186,239,143,23,1432
2020-01-13,광주,경남,1388,39,166,165,105,43,1906,1248,46,149,173,118,26,1760
2020-01-13,광주,경북,913,53,115,191,78,26,1376,871,54,155,205,112,21,1418
2020-01-13,광주,광주,12749,480,669,386,346,562,15192,12749,480,669,386,346,562,15192
2020-01-13,광주,대구,549,24,92,115,25,10,815,646,36,111,65,27,18,903
2020-01-13,광주,대전,439,18,14,17,11,13,512,535,13,20,20,20,18,626
2020-01-13,광주,부산,455,15,51,38,70,13,642,477,15,52,64,106,10,724
2020-01-13,광주,서울,662,14,23,63,20,16,798,736,20,20,30,19,27,852
2020-01-13,광주,세종,186,1,8,3,2,2,202,168,0,9,4,0,6,187
2020-01-13,광주,울산,62,2,11,3,7,3,88,45,2,9,8,12,2,78
2020-01-13,광주,전남,34922,971,1253,764,1958,1428,41296,31343,904,1038,693,1765,1268,37011
2020-01-13,광주,전북,8492,391,517,356,318,324,10398,8160,432,524,287,323,326,10052
2020-01-13,광주,충남,4232,105,555,462,272,122,5748,3975,112,555,463,311,92,5508
2020-01-13,광주,충북,663,28,71,114,76,19,971,625,32,81,173,87,17,1015
2020-01-13,대구,강원,372,7,22,13,21,8,443,242,5,13,6,12,7,285
2020-01-13,대구,경기,2844,102,240,336,400,111,4033,1959,99,215,264,188,67,2792
2020-01-13,대구,경남,11579,533,798,426,453,537,14326,13994,742,980,987,1621,573,18897
2020-01-13,대구,경북,79023,3112,3308,1896,3411,4249,94999,72474,2943,2879,1525,2780,4075,86676
2020-01-13,대구,광주,646,36,111,65,27,18,903,549,24,92,115,25,10,815
2020-01-13,대구,대구,60784,2270,1831,846,1036,3889,70656,60784,2270,1831,846,1036,3889,70656
2020-01-13,대구,대전,956,36,48,66,34,43,1183,655,30,36,35,24,27,807
2020-01-13,대구,부산,637,54,107,67,131,22,1018,3234,109,205,95,216,127,3986
2020-01-13,대구,서울,2267,41,184,165,99,62,2818,1716,41,142,65,22,42,2028
2020-01-13,대구,세종,286,3,10,4,8,6,317,165,2,1,7,3,9,187
2020-01-13,대구,울산,1455,55,144,77,160,68,1959,1205,57,140,62,166,77,1707
2020-01-13,대구,전남,618,15,49,31,48,11,772,501,17,44,37,82,11,692
2020-01-13,대구,전북,431,13,44,18,20,14,540,333,10,40,14,12,12,421
2020-01-13,대구,충남,1804,54,154,178,271,56,2517,1095,64,116,127,157,34,1593
2020-01-13,대구,충북,2142,98,207,228,354,79,3108,1385,79,143,180,122,53,1962
2020-01-13,대전,강원,203,2,30,8,1,8,252,157,0,35,3,2,10,207
2020-01-13,대전,경기,2464,98,213,97,51,123,3046,1977,97,232,98,32,105,2541
2020-01-13,대전,경남,1115,20,105,74,61,48,1423,741,21,97,51,37,35,982
2020-01-13,대전,경북,1934,60,130,86,50,76,2336,1740,66,127,108,69,84,2194
2020-01-13,대전,광주,535,13,20,20,20,18,626,439,18,14,17,11,13,512
2020-01-13,대전,대구,655,30,36,35,24,27,807,956,36,48,66,34,43,1183
2020-01-13,대전,대전,13771,410,402,390,203,1018,16194,13771,410,402,390,203,1018,16194
2020-01-13,대전,부산,74,6,6,8,17,0,111,83,5,3,14,16,5,126
2020-01-13,대전,서울,1823,34,217,36,11,81,2202,1679,44,206,25,6,77,2037
2020-01-13,대전,세종,3481,111,83,31,111,296,4113,3495,102,95,31,159,302,4184
2020-01-13,대전,울산,110,2,9,6,29,6,162,85,2,11,3,16,3,120
2020-01-13,대전,전남,315,7,6,15,23,7,373,259,10,10,30,21,12,342
2020-01-13,대전,전북,3467,76,87,63,37,161,3891,3137,83,81,83,41,168,3593
2020-01-13,대전,충남,17319,465,618,260,278,1342,20282,14379,425,526,249,262,1112,16953
2020-01-13,대전,충북,11600,467,484,193,137,875,13756,9851,400,406,171,142,771,11741
2020-01-13,부산,강원,4,0,0,1,1,1,7,3,0,1,1,3,0,8
2020-01-13,부산,경기,246,16,38,91,193,5,589,196,7,12,70,91,4,380
2020-01-13,부산,경남,89281,2788,3195,1786,4605,6278,107933,87231,2681,2908,1702,4479,6220,105221
2020-01-13,부산,경북,5215,121,336,195,754,260,6881,4442,112,324,178,556,223,5835
2020-01-13,부산,광주,477,15,52,64,106,10,724,455,15,51,38,70,13,642
2020-01-13,부산,대구,3234,109,205,95,216,127,3986,637,54,107,67,131,22,1018
2020-01-13,부산,대전,83,5,3,14,16,5,126,74,6,6,8,17,0,111
2020-01-13,부산,부산,39669,761,682,729,2036,2991,46868,39669,761,682,729,2036,2991,46868
2020-01-13,부산,서울,195,12,9,37,51,7,311,166,6,11,25,17,1,226
2020-01-13,부산,세종,12,1,2,4,3,1,23,14,1,0,0,1,2,18
2020-01-13,부산,울산,17439,413,502,626,2579,1275,22834,16155,424,439,442,2384,1217,21061
2020-01-13,부산,전남,2141,92,153,199,490,74,3149,1783,68,136,145,520,64,2716
2020-01-13,부산,전북,351,9,28,33,83,10,514,338,9,36,31,56,11,481
2020-01-13,부산,충남,227,15,22,54,106,3,427,163,17,18,56,139,1,394
2020-01-13,부산,충북,127,4,24,71,161,11,398,100,12,20,74,156,8,370
2020-01-13,서울,강원,725,13,261,8,7,28,1042,665,16,274,6,14,27,1002
2020-01-13,서울,경기,148380,6873,9221,4538,3186,10164,182362,141173,7213,8888,4276,3414,9676,174640
2020-01-13,서울,경남,2688,37,478,99,48,87,3437,1923,36,445,211,122,54,2791
2020-01-13,서울,경북,2984,58,346,164,62,98,3712,2565,78,386,329,114,77,3549
2020-01-13,서울,광주,736,20,20,30,19,27,852,662,14,23,63,20,16,798
2020-01-13,서울,대구,1716,41,142,65,22,42,2028,2267,41,184,165,99,62,2818
2020-01-13,서울,대전,1679,44,206,25,6,77,2037,1823,34,217,36,11,81,2202
2020-01-13,서울,부산,166,6,11,25,17,1,226,195,12,9,37,51,7,311
2020-01-13,서울,서울,195,3,10,2,1,10,221,195,3,10,2,1,10,221
2020-01-13,서울,세종,33,1,0,2,0,1,37,41,1,1,2,0,0,45
2020-01-13,서울,울산,41,0,1,1,1,1,45,30,1,0,7,11,0,49
2020-01-13,서울,전남,923,12,43,42,22,21,1063,734,11,31,66,37,21,900
2020-01-13,서울,전북,1395,22,56,22,21,49,1565,1178,28,41,52,17,44,1360
2020-01-13,서울,충남,27446,519,2421,709,668,1103,32866,24858,642,2471,1237,1076,966,31250
2020-01-13,서울,충북,14999,564,1144,714,567,682,18670,12519,672,1196,771,685,571,16414
2020-01-13,세종,강원,12,0,0,0,0,0,12,7,0,0,0,1,0,8
2020-01-13,세종,경기,59,1,1,3,3,3,70,45,3,2,5,6,2,63
2020-01-13,세종,경남,335,2,21,9,14,4,385,192,0,16,7,7,3,225
2020-01-13,세종,경북,335,4,19,19,15,10,402,290,5,20,19,5,20,359
2020-01-13,세종,광주,168,0,9,4,0,6,187,186,1,8,3,2,2,202
2020-01-13,세종,대구,165,2,1,7,3,9,187,286,3,10,4,8,6,317
2020-01-13,세종,대전,3495,102,95,31,159,302,4184,3481,111,83,31,111,296,4113
2020-01-13,세종,부산,14,1,0,0,1,2,18,12,1,2,4,3,1,23
2020-01-13,세종,서울,41,1,1,2,0,0,45,33,1,0,2,0,1,37
2020-01-13,세종,세종,224,21,7,7,2,20,281,224,21,7,7,2,20,281
2020-01-13,세종,울산,11,0,0,3,3,0,17,13,0,0,1,4,0,18
2020-01-13,세종,전남,160,2,4,10,23,5,204,147,1,0,4,13,6,171
2020-01-13,세종,전북,810,22,16,17,30,43,938,707,18,17,17,29,29,817
2020-01-13,세종,충남,6329,142,159,111,191,361,7293,4259,140,160,102,158,246,5065
2020-01-13,세종,충북,343,21,21,11,15,25,436,291,11,22,13,16,22,375
2020-01-13,울산,강원,3,0,0,0,2,0,5,5,0,0,0,0,0,5
2020-01-13,울산,경기,46,1,8,12,55,1,123,44,0,0,6,12,1,63
2020-01-13,울산,경남,9603,554,781,446,651,596,12631,10402,631,793,479,642,663,13610
2020-01-13,울산,경북,4936,179,338,329,1234,298,7314,5159,168,362,394,1074,317,7474
2020-01-13,울산,광주,45,2,9,8,12,2,78,62,2,11,3,7,3,88
2020-01-13,울산,대구,1205,57,140,62,166,77,1707,1455,55,144,77,160,68,1959
2020-01-13,울산,대전,85,2,11,3,16,3,120,110,2,9,6,29,6,162
2020-01-13,울산,부산,16155,424,439,442,2384,1217,21061,17439,413,502,626,2579,1275,22834
2020-01-13,울산,서울,30,1,0,7,11,0,49,41,0,1,1,1,1,45
2020-01-13,울산,세종,13,0,0,1,4,0,18,11,0,0,3,3,0,17
2020-01-13,울산,울산,8136,330,556,235,536,760,10553,8136,330,556,235,536,760,10553
2020-01-13,울산,전남,221,9,15,14,39,8,306,206,14,23,15,57,4,319
2020-01-13,울산,전북,66,0,7,3,9,1,86,48,2,6,5,2,1,64
2020-01-13,울산,충남,150,2,14,47,113,3,329,161,7,11,20,92,2,293
2020-01-13,울산,충북,21,1,5,15,35,2,79,20,0,0,12,32,1,65
2020-01-13,전남,강원,61,3,6,6,17,3,96,62,2,2,3,14,5,88
2020-01-13,전남,경기,734,23,87,119,112,25,1100,801,22,124,134,127,32,1240
2020-01-13,전남,경남,6120,277,464,399,1367,254,8881,6441,284,508,487,1387,304,9411
2020-01-13,전남,경북,1080,45,73,91,589,38,1916,1091,51,80,117,407,47,1793
2020-01-13,전남,광주,31343,904,1038,693,1765,1268,37011,34922,971,1253,764,1958,1428,41296
2020-01-13,전남,대구,501,17,44,37,82,11,692,618,15,49,31,48,11,772
2020-01-13,전남,대전,259,10,10,30,21,12,342,315,7,6,15,23,7,373
2020-01-13,전남,부산,1783,68,136,145,520,64,2716,2141,92,153,199,490,74,3149
2020-01-13,전남,서울,734,11,31,66,37,21,900,923,12,43,42,22,21,1063
2020-01-13,전남,세종,147,1,0,4,13,6,171,160,2,4,10,23,5,204
2020-01-13,전남,울산,206,14,23,15,57,4,319,221,9,15,14,39,8,306
2020-01-13,전남,전남,44477,1285,1737,1740,4410,1930,55579,44477,1285,1737,1740,4410,1930,55579
2020-01-13,전남,전북,4771,262,478,559,1163,154,7387,5153,221,471,586,1170,153,7754
2020-01-13,전남,충남,4156,94,468,726,1185,110,6739,4628,86,521,450,916,116,6717
2020-01-13,전남,충북,413,11,32,93,279,12,840,456,19,45,95,238,12,865
2020-01-13,전북,강원,201,6,11,20,19,8,265,160,3,9,6,19,6,203
2020-01-13,전북,경기,1518,35,170,181,177,32,2113,1501,48,162,114,140,46,2011
2020-01-13,전북,경남,1453,43,128,95,137,32,1888,1492,36,122,89,175,40,1954
2020-01-13,전북,경북,1557,95,183,170,222,64,2291,1735,93,202,184,245,66,2525
2020-01-13,전북,광주,8160,432,524,287,323,326,10052,8492,391,517,356,318,324,10398
2020-01-13,전북,대구,333,10,40,14,12,12,421,431,13,44,18,20,14,540
2020-01-13,전북,대전,3137,83,81,83,41,168,3593,3467,76,87,63,37,161,3891
2020-01-13,전북,부산,338,9,36,31,56,11,481,351,9,28,33,83,10,514
2020-01-13,전북,서울,1178,28,41,52,17,44,1360,1395,22,56,22,21,49,1565
2020-01-13,전북,세종,707,18,17,17,29,29,817,810,22,16,17,30,43,938
2020-01-13,전북,울산,48,2,6,5,2,1,64,66,0,7,3,9,1,86
2020-01-13,전북,전남,5153,221,471,586,1170,153,7754,4771,262,478,559,1163,154,7387
2020-01-13,전북,전북,15923,579,977,623,634,598,19334,15923,579,977,623,634,598,19334
2020-01-13,전북,충남,13686,496,1591,1051,1351,467,18642,13829,479,1550,876,1236,495,18465
2020-01-13,전북,충북,2072,112,163,303,259,63,2972,1853,108,246,269,258,61,2795
2020-01-13,충남,강원,499,10,27,24,58,19,637,391,6,15,16,28,18,474
2020-01-13,충남,경기,36259,1477,2723,2371,4386,1916,49132,40104,1558,2967,2460,4635,2028,53752
2020-01-13,충남,경남,1713,41,156,225,395,55,2585,1426,35,140,210,215,50,2076
2020-01-13,충남,경북,3333,119,338,434,660,136,5020,3356,150,366,557,599,146,5174
2020-01-13,충남,광주,3975,112,555,463,311,92,5508,4232,105,555,462,272,122,5748
2020-01-13,충남,대구,1095,64,116,127,157,34,1593,1804,54,154,178,271,56,2517
2020-01-13,충남,대전,14379,425,526,249,262,1112,16953,17319,465,618,260,278,1342,20282
2020-01-13,충남,부산,163,17,18,56,139,1,394,227,15,22,54,106,3,427
2020-01-13,충남,서울,24858,642,2471,1237,1076,966,31250,27446,519,2421,709,668,1103,32866
2020-01-13,충남,세종,4259,140,160,102,158,246,5065,6329,142,159,111,191,361,7293
2020-01-13,충남,울산,161,7,11,20,92,2,293,150,2,14,47,113,3,329
2020-01-13,충남,전남,4628,86,521,450,916,116,6717,4156,94,468,726,1185,110,6739
2020-01-13,충남,전북,13829,479,1550,876,1236,495,18465,13686,496,1591,1051,1351,467,18642
2020-01-13,충남,충남,99412,3540,8244,6619,9757,4779,132351,99412,3540,8244,6619,9757,4779,132351
2020-01-13,충남,충북,13999,671,910,905,1218,754,18457,12831,648,862,811,1238,681,17071
2020-01-13,충북,강원,5032,194,275,188,256,253,6198,5132,231,298,204,342,307,6514
2020-01-13,충북,경기,27163,2127,2927,2766,3408,1464,39855,29044,2218,3021,3002,3193,1481,41959
2020-01-13,충북,경남,1554,79,206,356,485,50,2730,1354,44,139,245,237,50,2069
2020-01-13,충북,경북,5415,215,604,571,968,214,7987,5471,247,566,678,879,211,8052
2020-01-13,충북,광주,625,32,81,173,87,17,1015,663,28,71,114,76,19,971
2020-01-13,충북,대구,1385,79,143,180,122,53,1962,2142,98,207,228,354,79,3108
2020-01-13,충북,대전,9851,400,406,171,142,771,11741,11600,467,484,193,137,875,13756
2020-01-13,충북,부산,100,12,20,74,156,8,370,127,4,24,71,161,11,398
2020-01-13,충북,서울,12519,672,1196,771,685,571,16414,14999,564,1144,714,567,682,18670
2020-01-13,충북,세종,291,11,22,13,16,22,375,343,21,21,11,15,25,436
2020-01-13,충북,울산,20,0,0,12,32,1,65,21,1,5,15,35,2,79
2020-01-13,충북,전남,456,19,45,95,238,12,865,413,11,32,93,279,12,840
2020-01-13,충북,전북,1853,108,246,269,258,61,2795,2072,112,163,303,259,63,2972
2020-01-13,충북,충남,12831,648,862,811,1238,681,17071,13999,671,910,905,1218,754,18457
2020-01-13,충북,충북,36694,1919,2310,2039,2746,2250,47958,36694,1919,2310,2039,2746,2250,47958
2020-01-14,강원,강원,65755,2336,3350,1694,2551,4484,80170,65755,2336,3350,1694,2551,4484,80170
2020-01-14,강원,경기,18816,616,1420,682,798,910,23242,18635,670,1396,739,896,959,23295
2020-01-14,강원,경남,196,0,16,13,21,4,250,119,2,8,21,9,2,161
2020-01-14,강원,경북,498,23,50,21,40,9,641,466,17,37,33,38,17,608
2020-01-14,강원,광주,95,1,20,14,9,4,143,93,2,16,20,7,2,140
2020-01-14,강원,대구,250,2,22,14,8,8,304,323,6,25,22,16,8,400
2020-01-14,강원,대전,159,1,30,7,1,6,204,170,3,27,3,4,6,213
2020-01-14,강원,부산,3,0,0,1,1,0,5,3,0,1,0,0,0,4
2020-01-14,강원,서울,572,22,275,14,35,18,936,658,18,251,10,8,19,964
2020-01-14,강원,세종,7,0,0,1,0,0,8,13,0,0,0,2,0,15
2020-01-14,강원,울산,3,0,0,0,0,0,3,1,0,0,0,0,0,1
2020-01-14,강원,전남,51,2,2,10,10,4,79,67,0,6,1,20,0,94
2020-01-14,강원,전북,142,3,13,10,17,3,188,146,4,14,21,17,2,204
2020-01-14,강원,충남,390,6,34,30,34,12,506,431,10,38,46,82,17,624
2020-01-14,강원,충북,4904,227,326,254,363,296,6370,4839,206,286,210,299,293,6133
2020-01-14,경기,강원,18635,670,1396,739,896,959,23295,18816,616,1420,682,798,910,23242
2020-01-14,경기,경기,419298,24245,26189,20105,25193,31994,547024,419298,24245,26189,20105,25193,31994,547024
2020-01-14,경기,경남,2500,128,355,895,638,69,4585,1690,71,290,650,446,54,3201
2020-01-14,경기,경북,4084,234,549,836,638,118,6459,3910,224,531,1030,585,113,6393
2020-01-14,경기,광주,775,30,179,333,190,14,1521,679,22,148,285,148,16,1298
2020-01-14,경기,대구,2053,136,243,455,236,55,3178,2642,132,259,524,478,84,4119
2020-01-14,경기,대전,1927,102,202,136,69,91,2527,1965,111,203,143,93,88,2603
2020-01-14,경기,부산,204,29,44,223,175,4,679,255,26,48,193,295,6,823
2020-01-14,경기,서울,139975,7525,9411,5529,3948,9513,175901,144204,7309,9756,5315,3449,9766,179799
2020-01-14,경기,세종,41,3,3,7,2,0,56,59,5,4,5,1,0,74
2020-01-14,경기,울산,33,2,4,18,24,0,81,33,4,11,49,99,3,199
2020-01-14,경기,전남,698,19,121,181,193,13,1225,643,22,98,148,156,13,1080
2020-01-14,경기,전북,1257,58,165,145,202,41,1868,1249,38,154,198,203,37,1879
2020-01-14,경기,충남,36195,1666,3178,2677,4857,1847,50420,35798,1521,2947,2558,4533,1812,49169
2020-01-14,경기,충북,26808,2240,3151,3222,3380,1274,40075,26269,2163,2980,2929,3438,1265,39044
2020-01-14,경남,강원,119,2,8,21,9,2,161,196,0,16,13,21,4,250
2020-01-14,경남,경기,1690,71,290,650,446,54,3201,2500,128,355,895,638,69,4585
2020-01-14,경남,경남,192875,10710,10761,7670,13711,14684,250411,192875,10710,10761,7670,13711,14684,250411
2020-01-14,경남,경북,9997,679,1123,931,1968,467,15165,12445,936,1364,1339,2876,527,19487
2020-01-14,경남,광주,1158,52,149,191,149,29,1728,1101,55,153,177,121,33,1640
2020-01-14,경남,대구,13364,794,1064,1144,1723,557,18646,10955,582,793,462,431,473,13696
2020-01-14,경남,대전,708,30,102,90,43,20,993,976,43,115,138,76,32,1380
2020-01-14,경남,부산,87674,2814,3087,1701,4704,6224,106204,86622,2910,3232,1761,4762,6277,105564
2020-01-14,경남,서울,1425,52,447,322,156,53,2455,2349,67,462,210,119,65,3272
2020-01-14,경남,세종,182,2,11,6,4,3,208,270,4,19,12,9,8,322
2020-01-14,경남,울산,10246,636,755,493,675,632,13437,9642,592,778,479,640,564,12695
2020-01-14,경남,전남,5719,273,484,512,1523,261,8772,5678,279,446,474,1512,240,8629
2020-01-14,경남,전북,1236,39,133,114,173,40,1735,1234,40,143,109,180,36,1742
2020-01-14,경남,충남,1127,45,139,267,255,30,1863,1528,73,177,381,563,44,2766
2020-01-14,경남,충북,1102,62,177,295,250,26,1912,1387,87,227,570,600,39,2910
2020-01-14,경북,강원,466,17,37,33,38,17,608,498,23,50,21,40,9,641
2020-01-14,경북,경기,3910,224,531,1030,585,113,6393,4084,234,549,836,638,118,6459
2020-01-14,경북,경남,12445,936,1364,1339,2876,527,19487,9997,679,1123,931,1968,467,15165
2020-01-14,경북,경북,74413,4002,4682,3144,4876,4103,95220,74413,4002,4682,3144,4876,4103,95220
2020-01-14,경북,광주,811,52,179,233,130,17,1422,799,56,113,212,80,26,1286
2020-01-14,경북,대구,72973,3083,3075,1821,3176,4030,88158,75347,3264,3520,2153,3611,4125,92020
2020-01-14,경북,대전,1659,70,123,125,105,71,2153,1759,60,113,155,89,61,2237
2020-01-14,경북,부산,4264,125,353,220,696,193,5851,4389,135,377,250,880,200,6231
2020-01-14,경북,서울,2469,118,371,450,154,66,3628,2928,112,357,266,138,84,3885
2020-01-14,경북,세종,259,4,15,20,11,16,325,300,7,22,15,6,10,360
2020-01-14,경북,울산,5169,184,397,414,1105,286,7555,4833,168,367,353,1315,288,7324
2020-01-14,경북,전남,1025,57,92,147,454,25,1800,995,56,85,120,552,33,1841
2020-01-14,경북,전북,1685,104,197,213,275,54,2528,1566,100,187,159,238,64,2314
2020-01-14,경북,충남,2995,180,401,624,614,108,4922,3035,141,376,561,833,126,5072
2020-01-14,경북,충북,5007,243,567,781,955,189,7742,5022,247,605,723,1063,181,7841
2020-01-14,광주,강원,93,2,16,20,7,2,140,95,1,20,14,9,4,143
2020-01-14,광주,경기,679,22,148,285,148,16,1298,775,30,179,333,190,14,1521
2020-01-14,광주,경남,1101,55,153,177,121,33,1640,1158,52,149,191,149,29,1728
2020-01-14,광주,경북,799,56,113,212,80,26,1286,811,52,179,233,130,17,1422
2020-01-14,광주,광주,12843,543,695,528,406,548,15563,12843,543,695,528,406,548,15563
2020-01-14,광주,대구,629,52,99,119,42,14,955,654,45,109,83,34,10,935
2020-01-14,광주,대전,401,26,15,30,19,7,498,498,21,17,40,20,13,609
2020-01-14,광주,부산,389,16,56,42,74,8,585,448,15,70,82,132,10,757
2020-01-14,광주,서울,548,19,30,74,32,19,722,647,22,33,60,21,24,807
2020-01-14,광주,세종,140,6,6,3,0,3,158,179,6,10,6,0,3,204
2020-01-14,광주,울산,42,1,9,1,7,0,60,44,2,11,10,6,1,74
2020-01-14,광주,전남,32807,992,1270,795,1945,1316,39125,31919,1008,1117,727,1822,1319,37912
2020-01-14,광주,전북,7718,463,570,374,384,315,9824,8106,490,536,361,377,325,10195
2020-01-14,광주,충남,3670,113,556,525,305,90,5259,3750,153,592,670,372,90,5627
2020-01-14,광주,충북,509,27,74,120,83,12,825,630,31,99,217,127,14,1118
2020-01-14,대구,강원,323,6,25,22,16,8,400,250,2,22,14,8,8,304
2020-01-14,대구,경기,2642,132,259,524,478,84,4119,2053,136,243,455,236,55,3178
2020-01-14,대구,경남,10955,582,793,462,431,473,13696,13364,794,1064,1144,1723,557,18646
2020-01-14,대구,경북,75347,3264,3520,2153,3611,4125,92020,72973,3083,3075,1821,3176,4030,88158
2020-01-14,대구,광주,654,45,109,83,34,10,935,629,52,99,119,42,14,955
2020-01-14,대구,대구,60659,2293,1876,925,1191,4078,71022,60659,2293,1876,925,1191,4078,71022
2020-01-14,대구,대전,878,51,51,108,48,34,1170,636,37,46,66,25,26,836
2020-01-14,대구,부산,642,53,109,71,163,18,1056,2839,100,237,97,271,109,3653
2020-01-14,대구,서울,2186,95,201,304,124,66,2976,1632,71,155,161,48,52,2119
2020-01-14,대구,세종,267,3,16,7,7,6,306,173,2,5,4,4,3,191
2020-01-14,대구,울산,1312,61,141,88,182,60,1844,1339,60,150,77,195,45,1866
2020-01-14,대구,전남,482,18,51,34,50,16,651,469,20,51,52,86,11,689
2020-01-14,대구,전북,352,15,47,20,21,10,465,348,17,42,23,26,6,462
2020-01-14,대구,충남,1449,81,151,220,284,48,2233,1155,66,125,182,174,45,1747
2020-01-14,대구,충북,1770,103,232,276,404,64,2849,1384,97,169,257,133,36,2076
2020-01-14,대전,강원,170,3,27,3,4,6,213,159,1,30,7,1,6,204
2020-01-14,대전,경기,1965,111,203,143,93,88,2603,1927,102,202,136,69,91,2527
2020-01-14,대전,경남,976,43,115,138,76,32,1380,708,30,102,90,43,20,993
2020-01-14,대전,경북,1759,60,113,155,89,61,2237,1659,70,123,125,105,71,2153
2020-01-14,대전,광주,498,21,17,40,20,13,609,401,26,15,30,19,7,498
2020-01-14,대전,대구,636,37,46,66,25,26,836,878,51,51,108,48,34,1170
2020-01-14,대전,대전,13435,436,486,399,344,1115,16215,13435,436,486,399,344,1115,16215
2020-01-14,대전,부산,59,8,9,27,21,1,125,64,3,8,20,13,2,110
2020-01-14,대전,서울,1595,52,203,70,8,62,1990,1704,54,197,52,13,71,2091
2020-01-14,대전,세종,3430,118,96,35,147,278,4104,3400,120,85,38,272,306,4221
2020-01-14,대전,울산,88,5,16,22,26,1,158,93,2,17,18,27,2,159
2020-01-14,대전,전남,259,4,15,38,27,9,352,260,4,16,38,24,5,347
2020-01-14,대전,전북,3044,88,103,114,51,147,3547,3104,90,101,95,48,156,3594
2020-01-14,대전,충남,16154,508,572,290,251,1277,19052,14888,496,543,269,279,1118,17593
2020-01-14,대전,충북,11009,467,498,210,135,847,13166,9903,417,433,172,123,748,11796
2020-01-14,부산,강원,3,0,1,0,0,0,4,3,0,0,1,1,0,5
2020-01-14,부산,경기,255,26,48,193,295,6,823,204,29,44,223,175,4,679
2020-01-14,부산,경남,86622,2910,3232,1761,4762,6277,105564,87674,2814,3087,1701,4704,6224,106204
2020-01-14,부산,경북,4389,135,377,250,880,200,6231,4264,125,353,220,696,193,5851
2020-01-14,부산,광주,448,15,70,82,132,10,757,389,16,56,42,74,8,585
2020-01-14,부산,대구,2839,100,237,97,271,109,3653,642,53,109,71,163,18,1056
2020-01-14,부산,대전,64,3,8,20,13,2,110,59,8,9,27,21,1,125
2020-01-14,부산,부산,39656,754,669,655,1992,2997,46723,39656,754,669,655,1992,2997,46723
2020-01-14,부산,서울,177,11,30,87,84,4,393,178,10,17,67,27,0,299
2020-01-14,부산,세종,19,2,0,5,6,2,34,12,1,2,0,1,0,16
2020-01-14,부산,울산,16305,427,549,614,2650,1148,21693,16435,425,461,440,2453,1214,21428
2020-01-14,부산,전남,1940,87,149,202,539,65,2982,1693,92,137,153,554,53,2682
2020-01-14,부산,전북,347,6,48,50,114,10,575,334,16,34,55,56,7,502
2020-01-14,부산,충남,152,18,28,65,144,7,414,130,12,27,110,175,2,456
2020-01-14,부산,충북,113,10,26,79,204,3,435,116,19,31,139,176,2,483
2020-01-14,서울,강원,658,18,251,10,8,19,964,572,22,275,14,35,18,936
2020-01-14,서울,경기,144204,7309,9756,5315,3449,9766,179799,139975,7525,9411,5529,3948,9513,175901
2020-01-14,서울,경남,2349,67,462,210,119,65,3272,1425,52,447,322,156,53,2455
2020-01-14,서울,경북,2928,112,357,266,138,84,3885,2469,118,371,450,154,66,3628
2020-01-14,서울,광주,647,22,33,60,21,24,807,548,19,30,74,32,19,722
2020-01-14,서울,대구,1632,71,155,161,48,52,2119,2186,95,201,304,124,66,2976
2020-01-14,서울,대전,1704,54,197,52,13,71,2091,1595,52,203,70,8,62,1990
2020-01-14,서울,부산,178,10,17,67,27,0,299,177,11,30,87,84,4,393
2020-01-14,서울,서울,178,11,9,2,3,7,210,178,11,9,2,3,7,210
2020-01-14,서울,세종,38,0,0,1,2,2,43,58,1,4,1,1,4,69
2020-01-14,서울,울산,26,0,5,4,1,0,36,28,1,4,14,14,0,61
2020-01-14,서울,전남,762,9,27,51,40,19,908,715,16,30,101,54,25,941
2020-01-14,서울,전북,1230,19,55,31,26,35,1396,1131,33,55,48,28,37,1332
2020-01-14,서울,충남,24781,561,2440,931,779,909,30401,23841,698,2437,1518,1184,891,30569
2020-01-14,서울,충북,13549,561,1239,875,699,570,17493,12766,718,1235,830,821,501,16871
2020-01-14,세종,강원,13,0,0,0,2,0,15,7,0,0,1,0,0,8
2020-01-14,세종,경기,59,5,4,5,1,0,74,41,3,3,7,2,0,56
2020-01-14,세종,경남,270,4,19,12,9,8,322,182,2,11,6,4,3,208
2020-01-14,세종,경북,300,7,22,15,6,10,360,259,4,15,20,11,16,325
2020-01-14,세종,광주,179,6,10,6,0,3,204,140,6,6,3,0,3,158
2020-01-14,세종,대구,173,2,5,4,4,3,191,267,3,16,7,7,6,306
2020-01-14,세종,대전,3400,120,85,38,272,306,4221,3430,118,96,35,147,278,4104
2020-01-14,세종,부산,12,1,2,0,1,0,16,19,2,0,5,6,2,34
2020-01-14,세종,서울,58,1,4,1,1,4,69,38,0,0,1,2,2,43
2020-01-14,세종,세종,258,18,5,8,3,21,313,258,18,5,8,3,21,313
2020-01-14,세종,울산,11,0,0,3,1,0,15,15,0,1,1,4,0,21
2020-01-14,세종,전남,170,3,1,10,14,5,203,165,0,2,8,9,4,188
2020-01-14,세종,전북,660,17,25,15,31,35,783,641,13,24,16,33,30,757
2020-01-14,세종,충남,5617,162,166,119,167,302,6533,4343,154,138,108,139,246,5128
2020-01-14,세종,충북,335,13,18,16,14,22,418,297,16,19,11,19,20,382
2020-01-14,울산,강원,1,0,0,0,0,0,1,3,0,0,0,0,0,3
2020-01-14,울산,경기,33,4,11,49,99,3,199,33,2,4,18,24,0,81
2020-01-14,울산,경남,9642,592,778,479,640,564,12695,10246,636,755,493,675,632,13437
2020-01-14,울산,경북,4833,168,367,353,1315,288,7324,5169,184,397,414,1105,286,7555
2020-01-14,울산,광주,44,2,11,10,6,1,74,42,1,9,1,7,0,60
2020-01-14,울산,대구,1339,60,150,77,195,45,1866,1312,61,141,88,182,60,1844
2020-01-14,울산,대전,93,2,17,18,27,2,159,88,5,16,22,26,1,158
2020-01-14,울산,부산,16435,425,461,440,2453,1214,21428,16305,427,549,614,2650,1148,21693
2020-01-14,울산,서울,28,1,4,14,14,0,61,26,0,5,4,1,0,36
2020-01-14,울산,세종,15,0,1,1,4,0,21,11,0,0,3,1,0,15
2020-01-14,울산,울산,7926,293,612,390,562,727,10510,7926,293,612,390,562,727,10510
2020-01-14,울산,전남,176,18,20,13,28,2,257,173,18,29,13,44,5,282
2020-01-14,울산,전북,45,1,7,1,20,1,75,49,0,6,4,3,0,62
2020-01-14,울산,충남,127,11,24,61,144,4,371,145,9,20,42,126,3,345
2020-01-14,울산,충북,14,3,3,27,59,1,107,15,3,3,9,36,1,67
2020-01-14,전남,강원,67,0,6,1,20,0,94,51,2,2,10,10,4,79
2020-01-14,전남,경기,643,22,98,148,156,13,1080,698,19,121,181,193,13,1225
2020-01-14,전남,경남,5678,279,446,474,1512,240,8629,5719,273,484,512,1523,261,8772
2020-01-14,전남,경북,995,56,85,120,552,33,1841,1025,57,92,147,454,25,1800
2020-01-14,전남,광주,31919,1008,1117,727,1822,1319,37912,32807,992,1270,795,1945,1316,39125
2020-01-14,전남,대구,469,20,51,52,86,11,689,482,18,51,34,50,16,651
2020-01-14,전남,대전,260,4,16,38,24,5,347,259,4,15,38,27,9,352
2020-01-14,전남,부산,1693,92,137,153,554,53,2682,1940,87,149,202,539,65,2982
2020-01-14,전남,서울,715,16,30,101,54,25,941,762,9,27,51,40,19,908
2020-01-14,전남,세종,165,0,2,8,9,4,188,170,3,1,10,14,5,203
2020-01-14,전남,울산,173,18,29,13,44,5,282,176,18,20,13,28,2,257
2020-01-14,전남,전남,44097,1416,1768,1866,4844,1761,55752,44097,1416,1768,1866,4844,1761,55752
2020-01-14,전남,전북,4723,266,530,645,1246,141,7551,4690,246,533,605,1197,130,7401
2020-01-14,전남,충남,3823,116,471,813,1345,106,6674,4066,82,528,607,1131,125,6539
2020-01-14,전남,충북,401,21,36,125,296,11,890,366,18,57,118,283,10,852
2020-01-14,전북,강원,146,4,14,21,17,2,204,142,3,13,10,17,3,188
2020-01-14,전북,경기,1249,38,154,198,203,37,1879,1257,58,165,145,202,41,1868
2020-01-14,전북,경남,1234,40,143,109,180,36,1742,1236,39,133,114,173,40,1735
2020-01-14,전북,경북,1566,100,187,159,238,64,2314,1685,104,197,213,275,54,2528
2020-01-14,전북,광주,8106,490,536,361,377,325,10195,7718,463,570,374,384,315,9824
2020-01-14,전북,대구,348,17,42,23,26,6,462,352,15,47,20,21,10,465
2020-01-14,전북,대전,3104,90,101,95,48,156,3594,3044,88,103,114,51,147,3547
2020-01-14,전북,부산,334,16,34,55,56,7,502,347,6,48,50,114,10,575
2020-01-14,전북,서울,1131,33,55,48,28,37,1332,1230,19,55,31,26,35,1396
2020-01-14,전북,세종,641,13,24,16,33,30,757,660,17,25,15,31,35,783
2020-01-14,전북,울산,49,0,6,4,3,0,62,45,1,7,1,20,1,75
2020-01-14,전북,전남,4690,246,533,605,1197,130,7401,4723,266,530,645,1246,141,7551
2020-01-14,전북,전북,16058,630,932,710,737,585,19652,16058,630,932,710,737,585,19652
2020-01-14,전북,충남,12430,547,1629,1226,1474,418,17724,12630,558,1619,1111,1473,417,17808
2020-01-14,전북,충북,1816,121,209,293,309,73,2821,1868,115,240,322,271,54,2870
2020-01-14,충남,강원,431,10,38,46,82,17,624,390,6,34,30,34,12,506
2020-01-14,충남,경기,35798,1521,2947,2558,4533,1812,49169,36195,1666,3178,2677,4857,1847,50420
2020-01-14,충남,경남,1528,73,177,381,563,44,2766,1127,45,139,267,255,30,1863
2020-01-14,충남,경북,3035,141,376,561,833,126,5072,2995,180,401,624,614,108,4922
2020-01-14,충남,광주,3750,153,592,670,372,90,5627,3670,113,556,525,305,90,5259
2020-01-14,충남,대구,1155,66,125,182,174,45,1747,1449,81,151,220,284,48,2233
2020-01-14,충남,대전,14888,496,543,269,279,1118,17593,16154,508,572,290,251,1277,19052
2020-01-14,충남,부산,130,12,27,110,175,2,456,152,18,28,65,144,7,414
2020-01-14,충남,서울,23841,698,2437,1518,1184,891,30569,24781,561,2440,931,779,909,30401
2020-01-14,충남,세종,4343,154,138,108,139,246,5128,5617,162,166,119,167,302,6533
2020-01-14,충남,울산,145,9,20,42,126,3,345,127,11,24,61,144,4,371
2020-01-14,충남,전남,4066,82,528,607,1131,125,6539,3823,116,471,813,1345,106,6674
2020-01-14,충남,전북,12630,558,1619,1111,1473,417,17808,12430,547,1629,1226,1474,418,17724
2020-01-14,충남,충남,94983,3816,8645,7609,10876,4592,130521,94983,3816,8645,7609,10876,4592,130521
2020-01-14,충남,충북,13875,676,967,1017,1492,808,18835,12466,678,895,905,1439,727,17110
2020-01-14,충북,강원,4839,206,286,210,299,293,6133,4904,227,326,254,363,296,6370
2020-01-14,충북,경기,26269,2163,2980,2929,3438,1265,39044,26808,2240,3151,3222,3380,1274,40075
2020-01-14,충북,경남,1387,87,227,570,600,39,2910,1102,62,177,295,250,26,1912
2020-01-14,충북,경북,5022,247,605,723,1063,181,7841,5007,243,567,781,955,189,7742
2020-01-14,충북,광주,630,31,99,217,127,14,1118,509,27,74,120,83,12,825
2020-01-14,충북,대구,1384,97,169,257,133,36,2076,1770,103,232,276,404,64,2849
2020-01-14,충북,대전,9903,417,433,172,123,748,11796,11009,467,498,210,135,847,13166
2020-01-14,충북,부산,116,19,31,139,176,2,483,113,10,26,79,204,3,435
2020-01-14,충북,서울,12766,718,1235,830,821,501,16871,13549,561,1239,875,699,570,17493
2020-01-14,충북,세종,297,16,19,11,19,20,382,335,13,18,16,14,22,418
2020-01-14,충북,울산,15,3,3,9,36,1,67,14,3,3,27,59,1,107
2020-01-14,충북,전남,366,18,57,118,283,10,852,401,21,36,125,296,11,890
2020-01-14,충북,전북,1868,115,240,322,271,54,2870,1816,121,209,293,309,73,2821
2020-01-14,충북,충남,12466,678,895,905,1439,727,17110,13875,676,967,1017,1492,808,18835
2020-01-14,충북,충북,35813,2064,2421,2221,2864,2209,47592,35813,2064,2421,2221,2864,2209,47592
2020-01-15,강원,강원,64697,2275,3345,1512,2707,4409,78945,64697,2275,3345,1512,2707,4409,78945
2020-01-15,강원,경기,18416,606,1361,661,766,885,22695,18409,635,1388,744,843,907,22926
2020-01-15,강원,경남,200,3,11,14,23,4,255,122,2,9,18,14,5,170
2020-01-15,강원,경북,498,29,49,35,30,19,660,461,20,31,37,23,11,583
2020-01-15,강원,광주,98,2,25,18,5,2,150,70,0,15,12,5,2,104
2020-01-15,강원,대구,256,4,14,11,14,5,304,298,5,19,22,18,5,367
2020-01-15,강원,대전,193,2,29,6,1,9,240,174,5,33,5,2,2,221
2020-01-15,강원,부산,3,1,1,1,0,0,6,5,0,0,0,2,1,8
2020-01-15,강원,서울,520,9,271,13,31,19,863,716,15,243,13,11,30,1028
2020-01-15,강원,세종,15,0,0,0,0,0,15,10,0,0,0,0,0,10
2020-01-15,강원,울산,3,0,0,0,0,0,3,2,0,0,1,1,0,4
2020-01-15,강원,전남,52,1,4,12,14,1,84,38,1,9,7,20,1,76
2020-01-15,강원,전북,156,4,16,19,15,5,215,134,7,13,20,17,2,193
2020-01-15,강원,충남,353,8,30,31,32,16,470,497,11,31,45,74,10,668
2020-01-15,강원,충북,4982,219,304,239,359,293,6396,4897,208,310,242,295,272,6224
2020-01-15,경기,강원,18409,635,1388,744,843,907,22926,18416,606,1361,661,766,885,22695
2020-01-15,경기,경기,423922,23814,25951,19804,24477,32142,550110,423922,23814,25951,19804,24477,32142,550110
2020-01-15,경기,경남,2538,118,389,872,677,70,4664,1875,72,279,581,419,57,3283
2020-01-15,경기,경북,4129,202,534,808,628,116,6417,4161,222,520,1000,615,123,6641
2020-01-15,경기,광주,797,42,186,373,179,17,1594,699,28,158,285,140,9,1319
2020-01-15,경기,대구,1968,95,249,443,260,53,3068,2723,120,247,493,496,73,4152
2020-01-15,경기,대전,2078,119,220,138,69,85,2709,2037,106,220,138,95,86,2682
2020-01-15,경기,부산,159,28,45,214,187,7,640,223,29,46,155,315,3,771
2020-01-15,경기,서울,138329,7543,9404,5376,3851,9492,173995,140540,7099,9623,4966,3409,9715,175352
2020-01-15,경기,세종,39,0,2,6,1,1,49,44,3,6,1,2,6,62
2020-01-15,경기,울산,28,0,5,13,21,1,68,44,1,5,37,68,2,157
2020-01-15,경기,전남,777,15,107,209,204,17,1329,647,25,81,145,177,27,1102
2020-01-15,경기,전북,1283,49,180,133,200,41,1886,1210,54,179,154,214,35,1846
2020-01-15,경기,충남,37237,1625,3034,2734,4601,1877,51108,36531,1568,2880,2666,4271,1813,49729
2020-01-15,경기,충북,28755,2353,3247,3401,3545,1348,42649,26916,2202,3015,2927,3492,1219,39771
2020-01-15,경남,강원,122,2,9,18,14,5,170,200,3,11,14,23,4,255
2020-01-15,경남,경기,1875,72,279,581,419,57,3283,2538,118,389,872,677,70,4664
2020-01-15,경남,경남,196947,10489,10681,7421,13957,14899,254394,196947,10489,10681,7421,13957,14899,254394
2020-01-15,경남,경북,10015,668,1095,987,1904,394,15063,12909,894,1364,1392,2786,526,19871
2020-01-15,경남,광주,1165,56,146,204,161,33,1765,1193,57,155,182,132,32,1751
2020-01-15,경남,대구,13670,811,1047,1115,1850,538,19031,10935,596,836,479,490,490,13826
2020-01-15,경남,대전,792,29,108,86,38,29,1082,999,35,120,129,64,38,1385
2020-01-15,경남,부산,89415,2753,3141,1825,4823,6312,108269,87772,2827,3228,1835,4924,6168,106754
2020-01-15,경남,서울,1598,43,443,300,140,48,2572,2182,48,452,200,124,59,3065
2020-01-15,경남,세종,211,4,10,13,7,4,249,251,2,25,14,13,3,308
2020-01-15,경남,울산,10346,667,743,523,650,649,13578,9943,608,814,459,679,605,13108
2020-01-15,경남,전남,6011,266,506,547,1541,248,9119,6132,281,487,490,1518,250,9158
2020-01-15,경남,전북,1274,35,146,110,189,36,1790,1276,30,159,106,170,42,1783
2020-01-15,경남,충남,1236,54,144,253,263,35,1985,1643,71,194,350,586,45,2889
2020-01-15,경남,충북,1150,65,160,273,316,31,1995,1461,87,230,543,660,31,3012
2020-01-15,경북,강원,461,20,31,37,23,11,583,498,29,49,35,30,19,660
2020-01-15,경북,경기,4161,222,520,1000,615,123,6641,4129,202,534,808,628,116,6417
2020-01-15,경북,경남,12909,894,1364,1392,2786,526,19871,10015,668,1095,987,1904,394,15063
2020-01-15,경북,경북,73583,3896,4570,3171,5001,4030,94251,73583,3896,4570,3171,5001,4030,94251
2020-01-15,경북,광주,869,53,155,203,133,24,1437,830,57,109,202,95,21,1314
2020-01-15,경북,대구,73502,3027,3104,1767,3078,4068,88546,75697,3276,3549,2135,3569,4157,92383
2020-01-15,경북,대전,1795,57,133,136,97,66,2284,1839,55,127,142,84,70,2317
2020-01-15,경북,부산,4137,111,327,214,653,188,5630,4441,126,373,187,786,205,6118
2020-01-15,경북,서울,2495,102,352,412,179,79,3619,2615,79,340,215,120,75,3444
2020-01-15,경북,세종,252,5,26,17,11,7,318,290,7,11,19,13,10,350
2020-01-15,경북,울산,5091,168,382,455,1059,287,7442,4854,166,389,359,1277,269,7314
2020-01-15,경북,전남,958,47,79,145,447,32,1708,1115,39,92,94,603,24,1967
2020-01-15,경북,전북,1709,86,225,202,297,62,2581,1464,115,178,164,240,50,2211
2020-01-15,경북,충남,3054,176,428,643,616,94,5011,3211,140,421,539,834,99,5244
2020-01-15,경북,충북,5163,245,618,722,918,195,7861,5115,248,640,685,974,214,7876
2020-01-15,광주,강원,70,0,15,12,5,2,104,98,2,25,18,5,2,150
2020-01-15,광주,경기,699,28,158,285,140,9,1319,797,42,186,373,179,17,1594
2020-01-15,광주,경남,1193,57,155,182,132,32,1751,1165,56,146,204,161,33,1765
2020-01-15,광주,경북,830,57,109,202,95,21,1314,869,53,155,203,133,24,1437
2020-01-15,광주,광주,12868,470,662,480,355,535,15370,12868,470,662,480,355,535,15370
2020-01-15,광주,대구,615,38,87,121,30,15,906,599,43,110,97,31,17,897
2020-01-15,광주,대전,461,15,19,39,17,12,563,492,17,22,38,17,14,600
2020-01-15,광주,부산,401,19,45,39,77,7,588,431,20,60,77,107,9,704
2020-01-15,광주,서울,586,14,30,71,26,13,740,687,24,32,56,20,18,837
2020-01-15,광주,세종,132,1,8,11,2,2,156,140,4,7,8,3,2,164
2020-01-15,광주,울산,49,0,13,0,8,2,72,52,2,11,6,16,1,88
2020-01-15,광주,전남,32907,995,1264,974,2139,1340,39619,32256,979,1158,902,1996,1305,38596
2020-01-15,광주,전북,7941,434,559,363,392,300,9989,8125,454,510,333,399,323,10144
2020-01-15,광주,충남,3671,122,560,507,288,90,5238,3602,135,556,634,388,80,5395
2020-01-15,광주,충북,588,25,73,120,87,11,904,683,28,112,176,125,14,1138
2020-01-15,대구,강원,298,5,19,22,18,5,367,256,4,14,11,14,5,304
2020-01-15,대구,경기,2723,120,247,493,496,73,4152,1968,95,249,443,260,53,3068
2020-01-15,대구,경남,10935,596,836,479,490,490,13826,13670,811,1047,1115,1850,538,19031
2020-01-15,대구,경북,75697,3276,3549,2135,3569,4157,92383,73502,3027,3104,1767,3078,4068,88546
2020-01-15,대구,광주,599,43,110,97,31,17,897,615,38,87,121,30,15,906
2020-01-15,대구,대구,60652,2271,1873,1021,1164,4086,71067,60652,2271,1873,1021,1164,4086,71067
2020-01-15,대구,대전,949,40,55,87,44,27,1202,719,38,41,68,24,26,916
2020-01-15,대구,부산,618,56,103,62,153,20,1012,2971,103,246,95,242,111,3768
2020-01-15,대구,서울,2121,68,191,264,125,53,2822,1571,48,145,135,52,33,1984
2020-01-15,대구,세종,265,4,15,5,4,9,302,190,1,3,6,6,7,213
2020-01-15,대구,울산,1381,64,164,83,156,56,1904,1333,63,154,74,192,53,1869
2020-01-15,대구,전남,461,16,56,40,45,10,628,463,22,43,42,75,10,655
2020-01-15,대구,전북,368,11,44,17,26,14,480,363,11,38,28,23,11,474
2020-01-15,대구,충남,1449,78,154,205,271,51,2208,1100,91,135,181,188,31,1726
2020-01-15,대구,충북,1823,104,224,273,424,52,2900,1307,92,165,233,134,48,1979
2020-01-15,대전,강원,174,5,33,5,2,2,221,193,2,29,6,1,9,240
2020-01-15,대전,경기,2037,106,220,138,95,86,2682,2078,119,220,138,69,85,2709
2020-01-15,대전,경남,999,35,120,129,64,38,1385,792,29,108,86,38,29,1082
2020-01-15,대전,경북,1839,55,127,142,84,70,2317,1795,57,133,136,97,66,2284
2020-01-15,대전,광주,492,17,22,38,17,14,600,461,15,19,39,17,12,563
2020-01-15,대전,대구,719,38,41,68,24,26,916,949,40,55,87,44,27,1202
2020-01-15,대전,대전,13738,432,488,252,295,1007,16212,13738,432,488,252,295,1007,16212
2020-01-15,대전,부산,64,2,12,21,23,2,124,68,3,4,22,14,1,112
2020-01-15,대전,서울,1648,46,203,56,15,71,2039,1736,40,199,42,15,73,2105
2020-01-15,대전,세종,3402,108,91,33,58,303,3995,3408,118,91,41,133,300,4091
2020-01-15,대전,울산,96,2,10,16,24,4,152,105,4,12,15,19,1,156
2020-01-15,대전,전남,274,10,10,32,30,4,360,291,16,16,30,21,3,377
2020-01-15,대전,전북,3208,89,111,101,42,156,3707,3157,92,94,87,50,139,3619
2020-01-15,대전,충남,16234,487,565,298,295,1229,19108,14732,504,543,280,310,1132,17501
2020-01-15,대전,충북,11342,493,520,215,162,862,13594,10216,391,437,182,144,774,12144
2020-01-15,부산,강원,5,0,0,0,2,1,8,3,1,1,1,0,0,6
2020-01-15,부산,경기,223,29,46,155,315,3,771,159,28,45,214,187,7,640
2020-01-15,부산,경남,87772,2827,3228,1835,4924,6168,106754,89415,2753,3141,1825,4823,6312,108269
2020-01-15,부산,경북,4441,126,373,187,786,205,6118,4137,111,327,214,653,188,5630
2020-01-15,부산,광주,431,20,60,77,107,9,704,401,19,45,39,77,7,588
2020-01-15,부산,대구,2971,103,246,95,242,111,3768,618,56,103,62,153,20,1012
2020-01-15,부산,대전,68,3,4,22,14,1,112,64,2,12,21,23,2,124
2020-01-15,부산,부산,39857,753,743,720,2179,2817,47069,39857,753,743,720,2179,2817,47069
2020-01-15,부산,서울,212,14,24,69,82,6,407,155,11,26,73,22,5,292
2020-01-15,부산,세종,8,0,2,1,5,1,17,11,0,0,0,4,1,16
2020-01-15,부산,울산,16638,426,509,649,2570,1144,21936,16534,428,443,413,2444,1153,21415
2020-01-15,부산,전남,1926,98,158,196,571,59,3008,1756,80,112,147,586,53,2734
2020-01-15,부산,전북,345,10,42,37,99,13,546,267,8,41,41,61,8,426
2020-01-15,부산,충남,128,12,24,50,166,4,384,116,10,22,84,169,2,403
2020-01-15,부산,충북,133,13,30,92,202,2,472,92,17,34,118,157,5,423
2020-01-15,서울,강원,716,15,243,13,11,30,1028,520,9,271,13,31,19,863
2020-01-15,서울,경기,140540,7099,9623,4966,3409,9715,175352,138329,7543,9404,5376,3851,9492,173995
2020-01-15,서울,경남,2182,48,452,200,124,59,3065,1598,43,443,300,140,48,2572
2020-01-15,서울,경북,2615,79,340,215,120,75,3444,2495,102,352,412,179,79,3619
2020-01-15,서울,광주,687,24,32,56,20,18,837,586,14,30,71,26,13,740
2020-01-15,서울,대구,1571,48,145,135,52,33,1984,2121,68,191,264,125,53,2822
2020-01-15,서울,대전,1736,40,199,42,15,73,2105,1648,46,203,56,15,71,2039
2020-01-15,서울,부산,155,11,26,73,22,5,292,212,14,24,69,82,6,407
2020-01-15,서울,서울,225,3,15,4,4,11,262,225,3,15,4,4,11,262
2020-01-15,서울,세종,35,0,0,1,0,2,38,28,1,2,0,1,0,32
2020-01-15,서울,울산,26,1,1,1,1,1,31,22,1,2,12,19,1,57
2020-01-15,서울,전남,830,13,31,49,40,38,1001,743,10,31,84,49,23,940
2020-01-15,서울,전북,1219,23,46,30,26,37,1381,1182,21,50,52,25,36,1366
2020-01-15,서울,충남,22219,516,2363,852,755,860,27565,23132,663,2359,1420,1178,865,29617
2020-01-15,서울,충북,13415,580,1234,846,730,530,17335,12624,635,1216,851,854,478,16658
2020-01-15,세종,강원,10,0,0,0,0,0,10,15,0,0,0,0,0,15
2020-01-15,세종,경기,44,3,6,1,2,6,62,39,0,2,6,1,1,49
2020-01-15,세종,경남,251,2,25,14,13,3,308,211,4,10,13,7,4,249
2020-01-15,세종,경북,290,7,11,19,13,10,350,252,5,26,17,11,7,318
2020-01-15,세종,광주,140,4,7,8,3,2,164,132,1,8,11,2,2,156
2020-01-15,세종,대구,190,1,3,6,6,7,213,265,4,15,5,4,9,302
2020-01-15,세종,대전,3408,118,91,41,133,300,4091,3402,108,91,33,58,303,3995
2020-01-15,세종,부산,11,0,0,0,4,1,16,8,0,2,1,5,1,17
2020-01-15,세종,서울,28,1,2,0,1,0,32,35,0,0,1,0,2,38
2020-01-15,세종,세종,271,20,3,3,1,20,318,271,20,3,3,1,20,318
2020-01-15,세종,울산,7,0,0,2,0,0,9,15,0,0,2,3,0,20
2020-01-15,세종,전남,175,1,3,11,21,4,215,160,4,1,14,20,3,202
2020-01-15,세종,전북,743,24,22,11,29,30,859,715,15,17,14,42,28,831
2020-01-15,세종,충남,5779,167,146,110,172,330,6704,4402,158,137,96,162,232,5187
2020-01-15,세종,충북,335,10,19,13,10,24,411,277,12,23,13,14,20,359
2020-01-15,울산,강원,2,0,0,1,1,0,4,3,0,0,0,0,0,3
2020-01-15,울산,경기,44,1,5,37,68,2,157,28,0,5,13,21,1,68
2020-01-15,울산,경남,9943,608,814,459,679,605,13108,10346,667,743,523,650,649,13578
2020-01-15,울산,경북,4854,166,389,359,1277,269,7314,5091,168,382,455,1059,287,7442
2020-01-15,울산,광주,52,2,11,6,16,1,88,49,0,13,0,8,2,72
2020-01-15,울산,대구,1333,63,154,74,192,53,1869,1381,64,164,83,156,56,1904
2020-01-15,울산,대전,105,4,12,15,19,1,156,96,2,10,16,24,4,152
2020-01-15,울산,부산,16534,428,443,413,2444,1153,21415,16638,426,509,649,2570,1144,21936
2020-01-15,울산,서울,22,1,2,12,19,1,57,26,1,1,1,1,1,31
2020-01-15,울산,세종,15,0,0,2,3,0,20,7,0,0,2,0,0,9
2020-01-15,울산,울산,8257,306,557,286,605,686,10697,8257,306,557,286,605,686,10697
2020-01-15,울산,전남,180,11,21,11,32,1,256,191,14,24,7,48,7,291
2020-01-15,울산,전북,53,0,7,5,11,1,77,48,1,6,3,8,1,67
2020-01-15,울산,충남,105,3,18,49,119,4,298,107,3,19,46,135,3,313
2020-01-15,울산,충북,25,4,8,24,48,0,109,21,3,3,17,36,1,81
2020-01-15,전남,강원,38,1,9,7,20,1,76,52,1,4,12,14,1,84
2020-01-15,전남,경기,647,25,81,145,177,27,1102,777,15,107,209,204,17,1329
2020-01-15,전남,경남,6132,281,487,490,1518,250,9158,6011,266,506,547,1541,248,9119
2020-01-15,전남,경북,1115,39,92,94,603,24,1967,958,47,79,145,447,32,1708
2020-01-15,전남,광주,32256,979,1158,902,1996,1305,38596,32907,995,1264,974,2139,1340,39619
2020-01-15,전남,대구,463,22,43,42,75,10,655,461,16,56,40,45,10,628
2020-01-15,전남,대전,291,16,16,30,21,3,377,274,10,10,32,30,4,360
2020-01-15,전남,부산,1756,80,112,147,586,53,2734,1926,98,158,196,571,59,3008
2020-01-15,전남,서울,743,10,31,84,49,23,940,830,13,31,49,40,38,1001
2020-01-15,전남,세종,160,4,1,14,20,3,202,175,1,3,11,21,4,215
2020-01-15,전남,울산,191,14,24,7,48,7,291,180,11,21,11,32,1,256
2020-01-15,전남,전남,45141,1465,1857,2094,4792,1762,57111,45141,1465,1857,2094,4792,1762,57111
2020-01-15,전남,전북,4909,261,459,658,1409,144,7840,4673,248,482,650,1348,139,7540
2020-01-15,전남,충남,4123,117,466,790,1293,82,6871,4035,116,506,553,1077,110,6397
2020-01-15,전남,충북,365,21,40,99,274,13,812,364,16,54,114,277,12,837
2020-01-15,전북,강원,134,7,13,20,17,2,193,156,4,16,19,15,5,215
2020-01-15,전북,경기,1210,54,179,154,214,35,1846,1283,49,180,133,200,41,1886
2020-01-15,전북,경남,1276,30,159,106,170,42,1783,1274,35,146,110,189,36,1790
2020-01-15,전북,경북,1464,115,178,164,240,50,2211,1709,86,225,202,297,62,2581
2020-01-15,전북,광주,8125,454,510,333,399,323,10144,7941,434,559,363,392,300,9989
2020-01-15,전북,대구,363,11,38,28,23,11,474,368,11,44,17,26,14,480
2020-01-15,전북,대전,3157,92,94,87,50,139,3619,3208,89,111,101,42,156,3707
2020-01-15,전북,부산,267,8,41,41,61,8,426,345,10,42,37,99,13,546
2020-01-15,전북,서울,1182,21,50,52,25,36,1366,1219,23,46,30,26,37,1381
2020-01-15,전북,세종,715,15,17,14,42,28,831,743,24,22,11,29,30,859
2020-01-15,전북,울산,48,1,6,3,8,1,67,53,0,7,5,11,1,77
2020-01-15,전북,전남,4673,248,482,650,1348,139,7540,4909,261,459,658,1409,144,7840
2020-01-15,전북,전북,16181,624,992,591,741,659,19788,16181,624,992,591,741,659,19788
2020-01-15,전북,충남,12762,551,1526,1201,1408,414,17862,12583,531,1549,989,1421,432,17505
2020-01-15,전북,충북,1885,113,206,323,290,64,2881,1889,130,249,303,281,65,2917
2020-01-15,충남,강원,497,11,31,45,74,10,668,353,8,30,31,32,16,470
2020-01-15,충남,경기,36531,1568,2880,2666,4271,1813,49729,37237,1625,3034,2734,4601,1877,51108
2020-01-15,충남,경남,1643,71,194,350,586,45,2889,1236,54,144,253,263,35,1985
2020-01-15,충남,경북,3211,140,421,539,834,99,5244,3054,176,428,643,616,94,5011
2020-01-15,충남,광주,3602,135,556,634,388,80,5395,3671,122,560,507,288,90,5238
2020-01-15,충남,대구,1100,91,135,181,188,31,1726,1449,78,154,205,271,51,2208
2020-01-15,충남,대전,14732,504,543,280,310,1132,17501,16234,487,565,298,295,1229,19108
2020-01-15,충남,부산,116,10,22,84,169,2,403,128,12,24,50,166,4,384
2020-01-15,충남,서울,23132,663,2359,1420,1178,865,29617,22219,516,2363,852,755,860,27565
2020-01-15,충남,세종,4402,158,137,96,162,232,5187,5779,167,146,110,172,330,6704
2020-01-15,충남,울산,107,3,19,46,135,3,313,105,3,18,49,119,4,298
2020-01-15,충남,전남,4035,116,506,553,1077,110,6397,4123,117,466,790,1293,82,6871
2020-01-15,충남,전북,12583,531,1549,989,1421,432,17505,12762,551,1526,1201,1408,414,17862
2020-01-15,충남,충남,95718,3735,8385,7073,10988,4535,130434,95718,3735,8385,7073,10988,4535,130434
2020-01-15,충남,충북,15235,699,1021,1035,1677,843,20510,12544,642,922,852,1401,719,17080
2020-01-15,충북,강원,4897,208,310,242,295,272,6224,4982,219,304,239,359,293,6396
2020-01-15,충북,경기,26916,2202,3015,2927,3492,1219,39771,28755,2353,3247,3401,3545,1348,42649
2020-01-15,충북,경남,1461,87,230,543,660,31,3012,1150,65,160,273,316,31,1995
2020-01-15,충북,경북,5115,248,640,685,974,214,7876,5163,245,618,722,918,195,7861
2020-01-15,충북,광주,683,28,112,176,125,14,1138,588,25,73,120,87,11,904
2020-01-15,충북,대구,1307,92,165,233,134,48,1979,1823,104,224,273,424,52,2900
2020-01-15,충북,대전,10216,391,437,182,144,774,12144,11342,493,520,215,162,862,13594
2020-01-15,충북,부산,92,17,34,118,157,5,423,133,13,30,92,202,2,472
2020-01-15,충북,서울,12624,635,1216,851,854,478,16658,13415,580,1234,846,730,530,17335
2020-01-15,충북,세종,277,12,23,13,14,20,359,335,10,19,13,10,24,411
2020-01-15,충북,울산,21,3,3,17,36,1,81,25,4,8,24,48,0,109
2020-01-15,충북,전남,364,16,54,114,277,12,837,365,21,40,99,274,13,812
2020-01-15,충북,전북,1889,130,249,303,281,65,2917,1885,113,206,323,290,64,2881
2020-01-15,충북,충남,12544,642,922,852,1401,719,17080,15235,699,1021,1035,1677,843,20510
2020-01-15,충북,충북,37580,2086,2429,2249,2881,2276,49501,37580,2086,2429,2249,2881,2276,49501
2020-01-16,강원,강원,66224,2298,3461,1380,2459,4330,80152,66224,2298,3461,1380,2459,4330,80152
2020-01-16,강원,경기,18242,605,1367,626,820,866,22526,19322,662,1351,738,856,875,23804
2020-01-16,강원,경남,175,1,8,17,24,5,230,115,1,9,24,6,3,158
2020-01-16,강원,경북,505,22,43,34,26,18,648,456,16,35,27,29,12,575
2020-01-16,강원,광주,84,0,24,10,13,0,131,78,2,13,12,2,1,108
2020-01-16,강원,대구,226,6,14,13,12,9,280,317,9,31,26,14,7,404
2020-01-16,강원,대전,182,2,32,4,2,7,229,188,0,30,5,4,6,233
2020-01-16,강원,부산,8,0,1,1,0,0,10,2,0,0,1,1,0,4
2020-01-16,강원,서울,615,18,263,8,17,23,944,706,16,233,11,7,21,994
2020-01-16,강원,세종,8,0,0,1,0,0,9,8,0,0,0,0,0,8
2020-01-16,강원,울산,2,0,0,1,0,0,3,1,0,0,0,0,0,1
2020-01-16,강원,전남,47,1,9,12,16,2,87,60,1,3,9,24,0,97
2020-01-16,강원,전북,160,3,24,18,18,7,230,142,10,22,28,23,5,230
2020-01-16,강원,충남,379,10,25,27,35,14,490,457,11,31,43,68,17,627
2020-01-16,강원,충북,4915,227,300,251,346,266,6305,5011,199,294,232,281,303,6320
2020-01-16,경기,강원,19322,662,1351,738,856,875,23804,18242,605,1367,626,820,866,22526
2020-01-16,경기,경기,426401,23722,26255,20337,24632,32476,553823,426401,23722,26255,20337,24632,32476,553823
2020-01-16,경기,경남,2690,108,372,862,633,71,4736,2030,83,273,555,423,65,3429
2020-01-16,경기,경북,4103,210,554,834,581,124,6406,4186,225,495,988,575,143,6612
2020-01-16,경기,광주,774,31,183,348,174,21,1531,705,33,152,301,140,19,1350
2020-01-16,경기,대구,2108,120,237,405,283,60,3213,2830,126,262,508,493,69,4288
2020-01-16,경기,대전,2044,95,218,138,62,92,2649,2121,106,196,113,65,87,2688
2020-01-16,경기,부산,194,22,41,204,158,2,621,251,18,39,174,303,7,792
2020-01-16,경기,서울,146369,7559,9762,5548,3877,9836,182951,143812,7153,9795,5119,3513,9712,179104
2020-01-16,경기,세종,48,1,4,5,1,2,61,53,3,7,6,2,3,74
2020-01-16,경기,울산,27,3,3,10,20,2,65,52,4,14,43,90,1,204
2020-01-16,경기,전남,735,23,105,178,187,19,1247,797,17,85,166,142,12,1219
2020-01-16,경기,전북,1295,58,176,127,215,44,1915,1304,55,162,190,209,49,1969
2020-01-16,경기,충남,36957,1565,3070,2601,4640,1918,50751,37050,1505,2887,2496,4341,1822,50101
2020-01-16,경기,충북,27333,2246,3095,3401,3373,1315,40763,26780,2181,3014,2954,3511,1288,39728
2020-01-16,경남,강원,115,1,9,24,6,3,158,175,1,8,17,24,5,230
2020-01-16,경남,경기,2030,83,273,555,423,65,3429,2690,108,372,862,633,71,4736
2020-01-16,경남,경남,196989,10595,10654,7914,14095,14857,255104,196989,10595,10654,7914,14095,14857,255104
2020-01-16,경남,경북,10400,663,1058,953,1981,455,15510,12800,877,1302,1366,2759,547,19651
2020-01-16,경남,광주,1201,54,149,221,158,31,1814,1149,50,157,174,127,28,1685
2020-01-16,경남,대구,14055,811,1148,1127,1770,576,19487,11056,579,841,488,508,462,13934
2020-01-16,경남,대전,782,31,96,102,38,22,1071,993,34,115,148,66,37,1393
2020-01-16,경남,부산,90084,2720,3051,2015,4817,6384,109071,88350,2849,3214,2016,5046,6242,107717
2020-01-16,경남,서울,1833,54,452,295,157,49,2840,2376,50,473,210,118,69,3296
2020-01-16,경남,세종,208,2,13,5,6,5,239,273,6,23,15,16,9,342
2020-01-16,경남,울산,10194,652,778,514,692,623,13453,9635,608,807,495,729,614,12888
2020-01-16,경남,전남,5913,286,567,507,1501,257,9031,5979,306,490,482,1386,247,8890
2020-01-16,경남,전북,1297,41,133,109,168,32,1780,1258,38,124,112,151,33,1716
2020-01-16,경남,충남,1240,53,160,316,246,40,2055,1745,67,205,365,579,59,3020
2020-01-16,경남,충북,1150,53,163,277,249,22,1914,1553,86,224,545,642,37,3087
2020-01-16,경북,강원,456,16,35,27,29,12,575,505,22,43,34,26,18,648
2020-01-16,경북,경기,4186,225,495,988,575,143,6612,4103,210,554,834,581,124,6406
2020-01-16,경북,경남,12800,877,1302,1366,2759,547,19651,10400,663,1058,953,1981,455,15510
2020-01-16,경북,경북,75136,4007,4670,3352,5162,4068,96395,75136,4007,4670,3352,5162,4068,96395
2020-01-16,경북,광주,954,72,153,241,141,18,1579,891,45,98,240,97,19,1390
2020-01-16,경북,대구,74215,2964,3061,1573,3162,4045,89020,76989,3110,3525,1944,3611,4178,93357
2020-01-16,경북,대전,1790,62,129,114,90,79,2264,1802,53,134,153,70,79,2291
2020-01-16,경북,부산,4313,148,343,212,648,176,5840,4615,137,374,205,755,190,6276
2020-01-16,경북,서울,2666,111,354,461,148,81,3821,2768,89,335,248,136,92,3668
2020-01-16,경북,세종,256,4,20,21,17,13,331,263,11,21,21,10,11,337
2020-01-16,경북,울산,5022,166,377,491,1123,300,7479,4952,172,369,350,1330,305,7478
2020-01-16,경북,전남,1036,51,99,163,439,21,1809,974,59,109,113,573,33,1861
2020-01-16,경북,전북,1825,98,204,197,233,52,2609,1609,96,200,162,236,51,2354
2020-01-16,경북,충남,3096,142,404,611,597,100,4950,3401,145,382,523,843,98,5392
2020-01-16,경북,충북,5293,238,553,699,904,205,7892,5110,246,600,682,956,194,7788
2020-01-16,광주,강원,78,2,13,12,2,1,108,84,0,24,10,13,0,131
2020-01-16,광주,경기,705,33,152,301,140,19,1350,774,31,183,348,174,21,1531
2020-01-16,광주,경남,1149,50,157,174,127,28,1685,1201,54,149,221,158,31,1814
2020-01-16,광주,경북,891,45,98,240,97,19,1390,954,72,153,241,141,18,1579
2020-01-16,광주,광주,13213,487,693,408,413,533,15747,13213,487,693,408,413,533,15747
2020-01-16,광주,대구,654,32,100,109,36,17,948,669,36,113,83,37,10,948
2020-01-16,광주,대전,471,20,10,32,26,15,574,529,20,21,37,16,9,632
2020-01-16,광주,부산,429,15,48,47,74,9,622,432,23,51,85,125,10,726
2020-01-16,광주,서울,616,28,31,96,26,18,815,771,21,29,50,12,17,900
2020-01-16,광주,세종,125,2,8,9,2,1,147,170,4,3,5,4,3,189
2020-01-16,광주,울산,40,1,6,2,2,2,53,33,0,11,7,13,1,65
2020-01-16,광주,전남,33889,1028,1298,878,1983,1330,40406,32506,988,1116,833,1867,1280,38590
2020-01-16,광주,전북,7929,446,557,379,343,297,9951,8078,476,537,365,368,307,10131
2020-01-16,광주,충남,4066,107,550,510,335,77,5645,4151,146,593,590,448,99,6027
2020-01-16,광주,충북,611,43,64,117,91,18,944,691,35,95,161,123,16,1121
2020-01-16,대구,강원,317,9,31,26,14,7,404,226,6,14,13,12,9,280
2020-01-16,대구,경기,2830,126,262,508,493,69,4288,2108,120,237,405,283,60,3213
2020-01-16,대구,경남,11056,579,841,488,508,462,13934,14055,811,1148,1127,1770,576,19487
2020-01-16,대구,경북,76989,3110,3525,1944,3611,4178,93357,74215,2964,3061,1573,3162,4045,89020
2020-01-16,대구,광주,669,36,113,83,37,10,948,654,32,100,109,36,17,948
2020-01-16,대구,대구,61093,2185,1912,861,1091,4085,71227,61093,2185,1912,861,1091,4085,71227
2020-01-16,대구,대전,972,44,60,74,45,36,1231,720,30,52,61,21,24,908
2020-01-16,대구,부산,625,60,125,67,202,22,1101,3008,113,244,104,244,112,3825
2020-01-16,대구,서울,2425,88,224,289,119,74,3219,1734,63,146,149,54,42,2188
2020-01-16,대구,세종,275,3,13,11,8,6,316,171,2,5,4,7,5,194
2020-01-16,대구,울산,1334,65,144,98,184,60,1885,1344,66,147,90,232,44,1923
2020-01-16,대구,전남,479,11,50,45,46,10,641,487,20,46,44,61,11,669
2020-01-16,대구,전북,374,12,47,18,16,7,474,375,14,43,23,28,4,487
2020-01-16,대구,충남,1514,82,153,219,243,51,2262,1142,74,121,184,173,41,1735
2020-01-16,대구,충북,1818,101,206,273,403,47,2848,1367,85,164,231,131,35,2013
2020-01-16,대전,강원,188,0,30,5,4,6,233,182,2,32,4,2,7,229
2020-01-16,대전,경기,2121,106,196,113,65,87,2688,2044,95,218,138,62,92,2649
2020-01-16,대전,경남,993,34,115,148,66,37,1393,782,31,96,102,38,22,1071
2020-01-16,대전,경북,1802,53,134,153,70,79,2291,1790,62,129,114,90,79,2264
2020-01-16,대전,광주,529,20,21,37,16,9,632,471,20,10,32,26,15,574
2020-01-16,대전,대구,720,30,52,61,21,24,908,972,44,60,74,45,36,1231
2020-01-16,대전,대전,13559,417,477,317,297,1050,16117,13559,417,477,317,297,1050,16117
2020-01-16,대전,부산,73,6,10,25,21,3,138,79,5,13,19,18,0,134
2020-01-16,대전,서울,1760,29,210,60,14,55,2128,1746,41,217,38,17,59,2118
2020-01-16,대전,세종,3447,118,89,28,40,329,4051,3448,121,101,38,82,310,4100
2020-01-16,대전,울산,77,0,8,19,35,2,141,87,1,9,21,24,0,142
2020-01-16,대전,전남,300,7,10,31,31,9,388,312,10,15,20,24,5,386
2020-01-16,대전,전북,3237,83,108,90,46,152,3716,3129,105,83,97,54,166,3634
2020-01-16,대전,충남,16326,507,565,286,370,1236,19290,14824,459,527,254,367,1161,17592
2020-01-16,대전,충북,11240,456,500,228,195,873,13492,10068,397,464,192,167,776,12064
2020-01-16,부산,강원,2,0,0,1,1,0,4,8,0,1,1,0,0,10
2020-01-16,부산,경기,251,18,39,174,303,7,792,194,22,41,204,158,2,621
2020-01-16,부산,경남,88350,2849,3214,2016,5046,6242,107717,90084,2720,3051,2015,4817,6384,109071
2020-01-16,부산,경북,4615,137,374,205,755,190,6276,4313,148,343,212,648,176,5840
2020-01-16,부산,광주,432,23,51,85,125,10,726,429,15,48,47,74,9,622
2020-01-16,부산,대구,3008,113,244,104,244,112,3825,625,60,125,67,202,22,1101
2020-01-16,부산,대전,79,5,13,19,18,0,134,73,6,10,25,21,3,138
2020-01-16,부산,부산,40396,737,675,928,2340,2969,48045,40396,737,675,928,2340,2969,48045
2020-01-16,부산,서울,191,17,19,65,73,6,371,167,11,19,72,43,7,319
2020-01-16,부산,세종,12,2,0,2,2,0,18,13,1,2,1,1,0,18
2020-01-16,부산,울산,16457,385,513,667,2586,1134,21742,16728,395,403,434,2451,1152,21563
2020-01-16,부산,전남,1825,74,143,210,564,64,2880,1829,77,134,176,611,61,2888
2020-01-16,부산,전북,323,9,38,41,98,7,516,320,12,36,46,67,12,493
2020-01-16,부산,충남,157,8,18,66,168,3,420,141,12,30,83,204,6,476
2020-01-16,부산,충북,126,15,24,71,233,1,470,125,19,23,130,154,3,454
2020-01-16,서울,강원,706,16,233,11,7,21,994,615,18,263,8,17,23,944
2020-01-16,서울,경기,143812,7153,9795,5119,3513,9712,179104,146369,7559,9762,5548,3877,9836,182951
2020-01-16,서울,경남,2376,50,473,210,118,69,3296,1833,54,452,295,157,49,2840
2020-01-16,서울,경북,2768,89,335,248,136,92,3668,2666,111,354,461,148,81,3821
2020-01-16,서울,광주,771,21,29,50,12,17,900,616,28,31,96,26,18,815
2020-01-16,서울,대구,1734,63,146,149,54,42,2188,2425,88,224,289,119,74,3219
2020-01-16,서울,대전,1746,41,217,38,17,59,2118,1760,29,210,60,14,55,2128
2020-01-16,서울,부산,167,11,19,72,43,7,319,191,17,19,65,73,6,371
2020-01-16,서울,서울,206,9,7,3,6,11,242,206,9,7,3,6,11,242
2020-01-16,서울,세종,35,1,2,1,0,2,41,35,1,1,1,0,2,40
2020-01-16,서울,울산,18,2,2,6,1,0,29,17,3,6,11,18,0,55
2020-01-16,서울,전남,784,9,37,55,28,22,935,850,20,31,107,62,26,1096
2020-01-16,서울,전북,1239,28,82,32,21,36,1438,1243,32,67,46,32,34,1454
2020-01-16,서울,충남,24255,574,2433,858,777,888,29785,25001,698,2526,1522,1204,871,31822
2020-01-16,서울,충북,13535,544,1159,782,705,522,17247,13552,653,1183,862,842,523,17615
2020-01-16,세종,강원,8,0,0,0,0,0,8,8,0,0,1,0,0,9
2020-01-16,세종,경기,53,3,7,6,2,3,74,48,1,4,5,1,2,61
2020-01-16,세종,경남,273,6,23,15,16,9,342,208,2,13,5,6,5,239
2020-01-16,세종,경북,263,11,21,21,10,11,337,256,4,20,21,17,13,331
2020-01-16,세종,광주,170,4,3,5,4,3,189,125,2,8,9,2,1,147
2020-01-16,세종,대구,171,2,5,4,7,5,194,275,3,13,11,8,6,316
2020-01-16,세종,대전,3448,121,101,38,82,310,4100,3447,118,89,28,40,329,4051
2020-01-16,세종,부산,13,1,2,1,1,0,18,12,2,0,2,2,0,18
2020-01-16,세종,서울,35,1,1,1,0,2,40,35,1,2,1,0,2,41
2020-01-16,세종,세종,255,17,1,4,1,31,309,255,17,1,4,1,31,309
2020-01-16,세종,울산,9,0,0,2,2,0,13,14,1,1,3,5,0,24
2020-01-16,세종,전남,163,4,12,11,28,13,231,173,3,4,9,28,7,224
2020-01-16,세종,전북,732,20,23,10,44,37,866,689,16,21,13,53,34,826
2020-01-16,세종,충남,5951,153,183,131,154,342,6914,4486,144,152,112,155,224,5273
2020-01-16,세종,충북,347,13,16,18,10,30,434,301,12,17,18,16,24,388
2020-01-16,울산,강원,1,0,0,0,0,0,1,2,0,0,1,0,0,3
2020-01-16,울산,경기,52,4,14,43,90,1,204,27,3,3,10,20,2,65
2020-01-16,울산,경남,9635,608,807,495,729,614,12888,10194,652,778,514,692,623,13453
2020-01-16,울산,경북,4952,172,369,350,1330,305,7478,5022,166,377,491,1123,300,7479
2020-01-16,울산,광주,33,0,11,7,13,1,65,40,1,6,2,2,2,53
2020-01-16,울산,대구,1344,66,147,90,232,44,1923,1334,65,144,98,184,60,1885
2020-01-16,울산,대전,87,1,9,21,24,0,142,77,0,8,19,35,2,141
2020-01-16,울산,부산,16728,395,403,434,2451,1152,21563,16457,385,513,667,2586,1134,21742
2020-01-16,울산,서울,17,3,6,11,18,0,55,18,2,2,6,1,0,29
2020-01-16,울산,세종,14,1,1,3,5,0,24,9,0,0,2,2,0,13
2020-01-16,울산,울산,8126,308,570,340,667,757,10768,8126,308,570,340,667,757,10768
2020-01-16,울산,전남,176,9,18,19,35,6,263,231,13,17,13,70,8,352
2020-01-16,울산,전북,52,1,8,4,9,0,74,37,0,7,3,6,1,54
2020-01-16,울산,충남,122,10,20,57,116,4,329,119,3,11,45,111,5,294
2020-01-16,울산,충북,24,0,2,15,51,0,92,33,5,3,8,36,0,85
2020-01-16,전남,강원,60,1,3,9,24,0,97,47,1,9,12,16,2,87
2020-01-16,전남,경기,797,17,85,166,142,12,1219,735,23,105,178,187,19,1247
2020-01-16,전남,경남,5979,306,490,482,1386,247,8890,5913,286,567,507,1501,257,9031
2020-01-16,전남,경북,974,59,109,113,573,33,1861,1036,51,99,163,439,21,1809
2020-01-16,전남,광주,32506,988,1116,833,1867,1280,38590,33889,1028,1298,878,1983,1330,40406
2020-01-16,전남,대구,487,20,46,44,61,11,669,479,11,50,45,46,10,641
2020-01-16,전남,대전,312,10,15,20,24,5,386,300,7,10,31,31,9,388
2020-01-16,전남,부산,1829,77,134,176,611,61,2888,1825,74,143,210,564,64,2880
2020-01-16,전남,서울,850,20,31,107,62,26,1096,784,9,37,55,28,22,935
2020-01-16,전남,세종,173,3,4,9,28,7,224,163,4,12,11,28,13,231
2020-01-16,전남,울산,231,13,17,13,70,8,352,176,9,18,19,35,6,263
2020-01-16,전남,전남,45385,1405,1840,1853,4782,1859,57124,45385,1405,1840,1853,4782,1859,57124
2020-01-16,전남,전북,5107,292,502,690,1310,136,8037,4794,248,492,626,1271,148,7579
2020-01-16,전남,충남,4262,121,483,807,1293,135,7101,4073,101,510,578,1031,97,6390
2020-01-16,전남,충북,371,21,45,116,294,8,855,417,26,44,118,269,8,882
2020-01-16,전북,강원,142,10,22,28,23,5,230,160,3,24,18,18,7,230
2020-01-16,전북,경기,1304,55,162,190,209,49,1969,1295,58,176,127,215,44,1915
2020-01-16,전북,경남,1258,38,124,112,151,33,1716,1297,41,133,109,168,32,1780
2020-01-16,전북,경북,1609,96,200,162,236,51,2354,1825,98,204,197,233,52,2609
2020-01-16,전북,광주,8078,476,537,365,368,307,10131,7929,446,557,379,343,297,9951
2020-01-16,전북,대구,375,14,43,23,28,4,487,374,12,47,18,16,7,474
2020-01-16,전북,대전,3129,105,83,97,54,166,3634,3237,83,108,90,46,152,3716
2020-01-16,전북,부산,320,12,36,46,67,12,493,323,9,38,41,98,7,516
2020-01-16,전북,서울,1243,32,67,46,32,34,1454,1239,28,82,32,21,36,1438
2020-01-16,전북,세종,689,16,21,13,53,34,826,732,20,23,10,44,37,866
2020-01-16,전북,울산,37,0,7,3,6,1,54,52,1,8,4,9,0,74
2020-01-16,전북,전남,4794,248,492,626,1271,148,7579,5107,292,502,690,1310,136,8037
2020-01-16,전북,전북,16266,633,1001,764,703,627,19994,16266,633,1001,764,703,627,19994
2020-01-16,전북,충남,13736,550,1633,1162,1470,440,18991,12981,522,1643,985,1480,428,18039
2020-01-16,전북,충북,1896,123,221,329,300,54,2923,1853,128,274,345,263,70,2933
2020-01-16,충남,강원,457,11,31,43,68,17,627,379,10,25,27,35,14,490
2020-01-16,충남,경기,37050,1505,2887,2496,4341,1822,50101,36957,1565,3070,2601,4640,1918,50751
2020-01-16,충남,경남,1745,67,205,365,579,59,3020,1240,53,160,316,246,40,2055
2020-01-16,충남,경북,3401,145,382,523,843,98,5392,3096,142,404,611,597,100,4950
2020-01-16,충남,광주,4151,146,593,590,448,99,6027,4066,107,550,510,335,77,5645
2020-01-16,충남,대구,1142,74,121,184,173,41,1735,1514,82,153,219,243,51,2262
2020-01-16,충남,대전,14824,459,527,254,367,1161,17592,16326,507,565,286,370,1236,19290
2020-01-16,충남,부산,141,12,30,83,204,6,476,157,8,18,66,168,3,420
2020-01-16,충남,서울,25001,698,2526,1522,1204,871,31822,24255,574,2433,858,777,888,29785
2020-01-16,충남,세종,4486,144,152,112,155,224,5273,5951,153,183,131,154,342,6914
2020-01-16,충남,울산,119,3,11,45,111,5,294,122,10,20,57,116,4,329
2020-01-16,충남,전남,4073,101,510,578,1031,97,6390,4262,121,483,807,1293,135,7101
2020-01-16,충남,전북,12981,522,1643,985,1480,428,18039,13736,550,1633,1162,1470,440,18991
2020-01-16,충남,충남,98690,3719,8650,7409,10992,4662,134122,98690,3719,8650,7409,10992,4662,134122
2020-01-16,충남,충북,14092,654,980,971,1529,825,19051,12822,665,961,846,1495,751,17540
2020-01-16,충북,강원,5011,199,294,232,281,303,6320,4915,227,300,251,346,266,6305
2020-01-16,충북,경기,26780,2181,3014,2954,3511,1288,39728,27333,2246,3095,3401,3373,1315,40763
2020-01-16,충북,경남,1553,86,224,545,642,37,3087,1150,53,163,277,249,22,1914
2020-01-16,충북,경북,5110,246,600,682,956,194,7788,5293,238,553,699,904,205,7892
2020-01-16,충북,광주,691,35,95,161,123,16,1121,611,43,64,117,91,18,944
2020-01-16,충북,대구,1367,85,164,231,131,35,2013,1818,101,206,273,403,47,2848
2020-01-16,충북,대전,10068,397,464,192,167,776,12064,11240,456,500,228,195,873,13492
2020-01-16,충북,부산,125,19,23,130,154,3,454,126,15,24,71,233,1,470
2020-01-16,충북,서울,13552,653,1183,862,842,523,17615,13535,544,1159,782,705,522,17247
2020-01-16,충북,세종,301,12,17,18,16,24,388,347,13,16,18,10,30,434
2020-01-16,충북,울산,33,5,3,8,36,0,85,24,0,2,15,51,0,92
2020-01-16,충북,전남,417,26,44,118,269,8,882,371,21,45,116,294,8,855
2020-01-16,충북,전북,1853,128,274,345,263,70,2933,1896,123,221,329,300,54,2923
2020-01-16,충북,충남,12822,665,961,846,1495,751,17540,14092,654,980,971,1529,825,19051
2020-01-16,충북,충북,36768,2036,2492,2251,2831,2100,48478,36768,2036,2492,2251,2831,2100,48478
2020-01-17,강원,강원,78471,2302,3482,1372,2297,4978,92902,78471,2302,3482,1372,2297,4978,92902
2020-01-17,강원,경기,22226,620,1392,650,793,1155,26836,29051,652,1425,684,879,1271,33962
2020-01-17,강원,경남,234,1,19,15,15,8,292,168,3,7,18,8,5,209
2020-01-17,강원,경북,628,22,35,24,30,27,766,669,16,34,28,32,24,803
2020-01-17,강원,광주,116,1,22,11,10,6,166,109,2,12,12,7,2,144
2020-01-17,강원,대구,331,8,19,7,7,14,386,515,7,18,20,15,18,593
2020-01-17,강원,대전,213,5,28,8,2,7,263,257,7,27,7,2,5,305
2020-01-17,강원,부산,6,0,0,0,4,0,10,7,1,1,1,1,1,12
2020-01-17,강원,서울,755,9,354,8,30,38,1194,1021,19,286,24,8,39,1397
2020-01-17,강원,세종,6,0,0,0,1,0,7,9,1,0,0,2,2,14
2020-01-17,강원,울산,1,0,0,0,0,0,1,5,0,0,0,0,0,5
2020-01-17,강원,전남,75,0,7,8,20,1,111,92,0,2,8,28,1,131
2020-01-17,강원,전북,223,4,20,9,22,5,283,200,4,15,25,17,4,265
2020-01-17,강원,충남,396,4,25,23,36,17,501,701,14,18,37,67,31,868
2020-01-17,강원,충북,5643,218,308,235,343,333,7080,6323,189,286,218,288,366,7670
2020-01-17,경기,강원,29051,652,1425,684,879,1271,33962,22226,620,1392,650,793,1155,26836
2020-01-17,경기,경기,450643,23953,26532,19949,25297,33661,580035,450643,23953,26532,19949,25297,33661,580035
2020-01-17,경기,경남,3568,112,388,865,611,106,5650,2734,89,295,601,386,70,4175
2020-01-17,경기,경북,5484,192,569,820,583,198,7846,5448,221,531,966,629,175,7970
2020-01-17,경기,광주,1252,36,185,338,161,34,2006,929,32,144,268,146,21,1540
2020-01-17,경기,대구,2759,117,236,432,246,87,3877,3466,126,251,485,486,104,4918
2020-01-17,경기,대전,2698,111,210,136,54,146,3355,2362,118,195,126,52,96,2949
2020-01-17,경기,부산,232,22,63,235,159,4,715,258,17,30,178,256,3,742
2020-01-17,경기,서울,158128,7636,9782,5423,3908,10770,195647,145462,7215,9763,5126,3429,9944,180939
2020-01-17,경기,세종,69,3,4,4,2,1,83,73,6,2,3,3,2,89
2020-01-17,경기,울산,48,1,3,14,21,2,89,46,1,11,33,78,4,173
2020-01-17,경기,전남,1032,20,118,188,184,32,1574,979,20,92,144,136,27,1398
2020-01-17,경기,전북,1923,52,183,140,220,36,2554,1649,52,145,195,221,68,2330
2020-01-17,경기,충남,41452,1577,3072,2624,4665,2226,55616,44333,1615,2882,2514,4450,2247,58041
2020-01-17,경기,충북,31841,2309,3115,3332,3427,1619,45643,32027,2172,2975,2987,3505,1540,45206
2020-01-17,경남,강원,168,3,7,18,8,5,209,234,1,19,15,15,8,292
2020-01-17,경남,경기,2734,89,295,601,386,70,4175,3568,112,388,865,611,106,5650
2020-01-17,경남,경남,212449,10773,10905,8152,14441,15901,272621,212449,10773,10905,8152,14441,15901,272621
2020-01-17,경남,경북,12428,691,1098,976,2036,569,17798,16106,950,1347,1362,2775,736,23276
2020-01-17,경남,광주,1673,55,161,232,137,52,2310,1490,49,181,177,119,37,2053
2020-01-17,경남,대구,16810,828,1162,1117,1675,706,22298,12836,592,842,450,551,566,15837
2020-01-17,경남,대전,1065,24,109,90,34,47,1369,1338,28,113,150,72,60,1761
2020-01-17,경남,부산,96654,2826,3242,1959,5099,6733,116513,92262,2901,3348,1944,5203,6582,112240
2020-01-17,경남,서울,2230,46,525,298,135,57,3291,2888,50,508,201,129,80,3856
2020-01-17,경남,세종,296,1,13,11,9,13,343,386,3,24,13,11,12,449
2020-01-17,경남,울산,11216,665,766,503,659,734,14543,10719,595,792,504,671,685,13966
2020-01-17,경남,전남,6817,281,542,574,1393,302,9909,7566,320,550,504,1356,339,10635
2020-01-17,경남,전북,1759,50,142,108,185,40,2284,1626,50,164,131,176,44,2191
2020-01-17,경남,충남,1427,63,140,265,245,65,2205,2421,73,195,348,569,81,3687
2020-01-17,경남,충북,1511,55,189,278,288,44,2365,2157,75,257,505,668,71,3733
2020-01-17,경북,강원,669,16,34,28,32,24,803,628,22,35,24,30,27,766
2020-01-17,경북,경기,5448,221,531,966,629,175,7970,5484,192,569,820,583,198,7846
2020-01-17,경북,경남,16106,950,1347,1362,2775,736,23276,12428,691,1098,976,2036,569,17798
2020-01-17,경북,경북,82473,3973,4682,3131,5462,4403,104124,82473,3973,4682,3131,5462,4403,104124
2020-01-17,경북,광주,1188,54,146,224,128,23,1763,1007,38,119,225,101,22,1512
2020-01-17,경북,대구,80854,3006,3151,1623,3085,4410,96129,81131,3254,3534,1953,3516,4363,97751
2020-01-17,경북,대전,2313,56,138,115,95,99,2816,2151,61,140,142,69,90,2653
2020-01-17,경북,부산,5618,129,365,191,646,250,7199,5656,141,379,201,804,225,7406
2020-01-17,경북,서울,3128,104,406,425,138,123,4324,3413,91,387,230,119,102,4342
2020-01-17,경북,세종,361,4,25,17,12,21,440,335,6,15,17,13,13,399
2020-01-17,경북,울산,5903,184,373,464,1037,341,8302,5911,170,378,348,1270,346,8423
2020-01-17,경북,전남,1256,47,79,152,474,27,2035,1364,41,109,122,579,38,2253
2020-01-17,경북,전북,2055,86,202,179,248,73,2843,1771,99,187,178,237,60,2532
2020-01-17,경북,충남,3679,150,434,609,667,125,5664,4249,152,415,529,857,148,6350
2020-01-17,경북,충북,6351,235,512,701,892,238,8929,6197,248,540,680,1004,251,8920
2020-01-17,광주,강원,109,2,12,12,7,2,144,116,1,22,11,10,6,166
2020-01-17,광주,경기,929,32,144,268,146,21,1540,1252,36,185,338,161,34,2006
2020-01-17,광주,경남,1490,49,181,177,119,37,2053,1673,55,161,232,137,52,2310
2020-01-17,광주,경북,1007,38,119,225,101,22,1512,1188,54,146,224,128,23,1763
2020-01-17,광주,광주,13778,506,699,381,405,578,16347,13778,506,699,381,405,578,16347
2020-01-17,광주,대구,867,41,100,94,34,23,1159,779,37,99,93,38,14,1060
2020-01-17,광주,대전,569,19,8,32,29,7,664,633,21,23,35,13,13,738
2020-01-17,광주,부산,504,14,46,37,63,15,679,548,17,53,72,112,19,821
2020-01-17,광주,서울,756,19,25,65,26,20,911,1087,20,28,54,22,35,1246
2020-01-17,광주,세종,158,3,8,7,1,7,184,252,4,8,5,2,4,275
2020-01-17,광주,울산,48,0,6,2,5,0,61,54,0,9,6,14,1,84
2020-01-17,광주,전남,35660,991,1273,753,1759,1402,41838,36732,980,1128,740,1755,1466,42801
2020-01-17,광주,전북,8976,477,588,368,365,335,11109,9405,476,560,324,428,338,11531
2020-01-17,광주,충남,4712,110,633,483,344,138,6420,5386,119,637,625,421,153,7341
2020-01-17,광주,충북,672,19,72,122,56,15,956,903,33,101,189,108,16,1350
2020-01-17,대구,강원,515,7,18,20,15,18,593,331,8,19,7,7,14,386
2020-01-17,대구,경기,3466,126,251,485,486,104,4918,2759,117,236,432,246,87,3877
2020-01-17,대구,경남,12836,592,842,450,551,566,15837,16810,828,1162,1117,1675,706,22298
2020-01-17,대구,경북,81131,3254,3534,1953,3516,4363,97751,80854,3006,3151,1623,3085,4410,96129
2020-01-17,대구,광주,779,37,99,93,38,14,1060,867,41,100,94,34,23,1159
2020-01-17,대구,대구,63446,2355,1929,905,1166,4237,74038,63446,2355,1929,905,1166,4237,74038
2020-01-17,대구,대전,1178,50,70,85,48,36,1467,893,36,54,53,25,28,1089
2020-01-17,대구,부산,728,53,93,62,170,31,1137,3295,104,258,88,257,145,4147
2020-01-17,대구,서울,2787,71,220,247,113,82,3520,1950,60,186,129,45,65,2435
2020-01-17,대구,세종,283,6,15,8,6,6,324,241,3,6,3,3,5,261
2020-01-17,대구,울산,1419,49,154,84,149,52,1907,1623,58,155,69,190,74,2169
2020-01-17,대구,전남,601,20,59,28,48,19,775,691,15,53,35,79,24,897
2020-01-17,대구,전북,409,17,48,18,18,8,518,528,13,40,26,17,9,633
2020-01-17,대구,충남,1686,74,167,214,239,43,2423,1694,55,113,184,183,66,2295
2020-01-17,대구,충북,2200,105,233,278,417,69,3302,1881,91,168,245,136,65,2586
2020-01-17,대전,강원,257,7,27,7,2,5,305,213,5,28,8,2,7,263
2020-01-17,대전,경기,2362,118,195,126,52,96,2949,2698,111,210,136,54,146,3355
2020-01-17,대전,경남,1338,28,113,150,72,60,1761,1065,24,109,90,34,47,1369
2020-01-17,대전,경북,2151,61,140,142,69,90,2653,2313,56,138,115,95,99,2816
2020-01-17,대전,광주,633,21,23,35,13,13,738,569,19,8,32,29,7,664
2020-01-17,대전,대구,893,36,54,53,25,28,1089,1178,50,70,85,48,36,1467
2020-01-17,대전,대전,14651,410,502,418,190,1109,17280,14651,410,502,418,190,1109,17280
2020-01-17,대전,부산,85,4,5,25,23,0,142,83,1,5,12,31,3,135
2020-01-17,대전,서울,1924,49,216,55,10,88,2342,2018,44,229,43,11,92,2437
2020-01-17,대전,세종,3619,107,84,34,87,314,4245,3582,104,98,46,102,301,4233
2020-01-17,대전,울산,128,2,11,17,25,4,187,139,4,14,15,22,3,197
2020-01-17,대전,전남,349,7,9,28,30,16,439,427,7,10,35,23,12,514
2020-01-17,대전,전북,3625,90,113,102,52,166,4148,3694,87,90,104,56,170,4201
2020-01-17,대전,충남,16932,477,588,311,271,1347,19926,16165,444,565,268,321,1264,19027
2020-01-17,대전,충북,11588,460,512,223,157,846,13786,11096,390,451,185,129,799,13050
2020-01-17,부산,강원,7,1,1,1,1,1,12,6,0,0,0,4,0,10
2020-01-17,부산,경기,258,17,30,178,256,3,742,232,22,63,235,159,4,715
2020-01-17,부산,경남,92262,2901,3348,1944,5203,6582,112240,96654,2826,3242,1959,5099,6733,116513
2020-01-17,부산,경북,5656,141,379,201,804,225,7406,5618,129,365,191,646,250,7199
2020-01-17,부산,광주,548,17,53,72,112,19,821,504,14,46,37,63,15,679
2020-01-17,부산,대구,3295,104,258,88,257,145,4147,728,53,93,62,170,31,1137
2020-01-17,부산,대전,83,1,5,12,31,3,135,85,4,5,25,23,0,142
2020-01-17,부산,부산,43492,746,790,774,2141,3118,51061,43492,746,790,774,2141,3118,51061
2020-01-17,부산,서울,202,14,24,84,71,9,404,201,12,25,76,34,2,350
2020-01-17,부산,세종,14,0,1,3,6,0,24,20,2,0,2,3,0,27
2020-01-17,부산,울산,17308,409,537,661,2584,1216,22715,18900,439,486,421,2437,1322,24005
2020-01-17,부산,전남,2156,104,137,216,568,78,3259,2200,80,113,127,560,87,3167
2020-01-17,부산,전북,391,7,46,35,105,15,599,385,13,24,38,64,15,539
2020-01-17,부산,충남,164,12,33,60,139,4,412,181,10,31,75,180,3,480
2020-01-17,부산,충북,135,8,20,94,196,5,458,116,12,26,125,171,2,452
2020-01-17,서울,강원,1021,19,286,24,8,39,1397,755,9,354,8,30,38,1194
2020-01-17,서울,경기,145462,7215,9763,5126,3429,9944,180939,158128,7636,9782,5423,3908,10770,195647
2020-01-17,서울,경남,2888,50,508,201,129,80,3856,2230,46,525,298,135,57,3291
2020-01-17,서울,경북,3413,91,387,230,119,102,4342,3128,104,406,425,138,123,4324
2020-01-17,서울,광주,1087,20,28,54,22,35,1246,756,19,25,65,26,20,911
2020-01-17,서울,대구,1950,60,186,129,45,65,2435,2787,71,220,247,113,82,3520
2020-01-17,서울,대전,2018,44,229,43,11,92,2437,1924,49,216,55,10,88,2342
2020-01-17,서울,부산,201,12,25,76,34,2,350,202,14,24,84,71,9,404
2020-01-17,서울,서울,207,4,9,5,3,13,241,207,4,9,5,3,13,241
2020-01-17,서울,세종,54,0,1,1,1,2,59,48,1,1,1,1,2,54
2020-01-17,서울,울산,31,0,2,2,1,1,37,27,0,6,10,13,0,56
2020-01-17,서울,전남,1062,9,19,46,25,28,1189,934,10,32,86,60,28,1150
2020-01-17,서울,전북,1786,21,69,25,23,45,1969,1414,41,70,49,23,42,1639
2020-01-17,서울,충남,27460,540,2615,864,789,1081,33349,29048,656,2770,1393,1230,1147,36244
2020-01-17,서울,충북,14655,557,1270,734,718,607,18541,15876,698,1263,826,818,646,20127
2020-01-17,세종,강원,9,1,0,0,2,2,14,6,0,0,0,1,0,7
2020-01-17,세종,경기,73,6,2,3,3,2,89,69,3,4,4,2,1,83
2020-01-17,세종,경남,386,3,24,13,11,12,449,296,1,13,11,9,13,343
2020-01-17,세종,경북,335,6,15,17,13,13,399,361,4,25,17,12,21,440
2020-01-17,세종,광주,252,4,8,5,2,4,275,158,3,8,7,1,7,184
2020-01-17,세종,대구,241,3,6,3,3,5,261,283,6,15,8,6,6,324
2020-01-17,세종,대전,3582,104,98,46,102,301,4233,3619,107,84,34,87,314,4245
2020-01-17,세종,부산,20,2,0,2,3,0,27,14,0,1,3,6,0,24
2020-01-17,세종,서울,48,1,1,1,1,2,54,54,0,1,1,1,2,59
2020-01-17,세종,세종,288,21,4,3,2,24,342,288,21,4,3,2,24,342
2020-01-17,세종,울산,12,0,0,1,0,0,13,15,0,0,0,2,0,17
2020-01-17,세종,전남,225,1,8,5,20,11,270,255,1,4,13,22,6,301
2020-01-17,세종,전북,874,23,27,9,52,41,1026,859,20,23,11,61,28,1002
2020-01-17,세종,충남,6152,153,168,105,156,342,7076,5434,154,180,100,168,268,6304
2020-01-17,세종,충북,365,10,21,17,22,27,462,368,18,24,10,28,16,464
2020-01-17,울산,강원,5,0,0,0,0,0,5,1,0,0,0,0,0,1
2020-01-17,울산,경기,46,1,11,33,78,4,173,48,1,3,14,21,2,89
2020-01-17,울산,경남,10719,595,792,504,671,685,13966,11216,665,766,503,659,734,14543
2020-01-17,울산,경북,5911,170,378,348,1270,346,8423,5903,184,373,464,1037,341,8302
2020-01-17,울산,광주,54,0,9,6,14,1,84,48,0,6,2,5,0,61
2020-01-17,울산,대구,1623,58,155,69,190,74,2169,1419,49,154,84,149,52,1907
2020-01-17,울산,대전,139,4,14,15,22,3,197,128,2,11,17,25,4,187
2020-01-17,울산,부산,18900,439,486,421,2437,1322,24005,17308,409,537,661,2584,1216,22715
2020-01-17,울산,서울,27,0,6,10,13,0,56,31,0,2,2,1,1,37
2020-01-17,울산,세종,15,0,0,0,2,0,17,12,0,0,1,0,0,13
2020-01-17,울산,울산,8648,295,587,266,557,784,11137,8648,295,587,266,557,784,11137
2020-01-17,울산,전남,172,10,22,16,30,6,256,267,18,33,12,48,7,385
2020-01-17,울산,전북,57,1,9,3,14,3,87,52,1,7,2,3,1,66
2020-01-17,울산,충남,151,8,20,45,124,8,356,127,5,19,32,144,5,332
2020-01-17,울산,충북,29,4,7,19,44,0,103,20,1,7,12,34,1,75
2020-01-17,전남,강원,92,0,2,8,28,1,131,75,0,7,8,20,1,111
2020-01-17,전남,경기,979,20,92,144,136,27,1398,1032,20,118,188,184,32,1574
2020-01-17,전남,경남,7566,320,550,504,1356,339,10635,6817,281,542,574,1393,302,9909
2020-01-17,전남,경북,1364,41,109,122,579,38,2253,1256,47,79,152,474,27,2035
2020-01-17,전남,광주,36732,980,1128,740,1755,1466,42801,35660,991,1273,753,1759,1402,41838
2020-01-17,전남,대구,691,15,53,35,79,24,897,601,20,59,28,48,19,775
2020-01-17,전남,대전,427,7,10,35,23,12,514,349,7,9,28,30,16,439
2020-01-17,전남,부산,2200,80,113,127,560,87,3167,2156,104,137,216,568,78,3259
2020-01-17,전남,서울,934,10,32,86,60,28,1150,1062,9,19,46,25,28,1189
2020-01-17,전남,세종,255,1,4,13,22,6,301,225,1,8,5,20,11,270
2020-01-17,전남,울산,267,18,33,12,48,7,385,172,10,22,16,30,6,256
2020-01-17,전남,전남,50274,1408,1825,1773,4697,2006,61983,50274,1408,1825,1773,4697,2006,61983
2020-01-17,전남,전북,6068,289,523,651,1332,176,9039,5480,256,523,658,1271,158,8346
2020-01-17,전남,충남,5439,110,504,790,1168,170,8181,5564,100,505,561,1026,147,7903
2020-01-17,전남,충북,553,16,44,98,274,19,1004,541,16,54,98,265,17,991
2020-01-17,전북,강원,200,4,15,25,17,4,265,223,4,20,9,22,5,283
2020-01-17,전북,경기,1649,52,145,195,221,68,2330,1923,52,183,140,220,36,2554
2020-01-17,전북,경남,1626,50,164,131,176,44,2191,1759,50,142,108,185,40,2284
2020-01-17,전북,경북,1771,99,187,178,237,60,2532,2055,86,202,179,248,73,2843
2020-01-17,전북,광주,9405,476,560,324,428,338,11531,8976,477,588,368,365,335,11109
2020-01-17,전북,대구,528,13,40,26,17,9,633,409,17,48,18,18,8,518
2020-01-17,전북,대전,3694,87,90,104,56,170,4201,3625,90,113,102,52,166,4148
2020-01-17,전북,부산,385,13,24,38,64,15,539,391,7,46,35,105,15,599
2020-01-17,전북,서울,1414,41,70,49,23,42,1639,1786,21,69,25,23,45,1969
2020-01-17,전북,세종,859,20,23,11,61,28,1002,874,23,27,9,52,41,1026
2020-01-17,전북,울산,52,1,7,2,3,1,66,57,1,9,3,14,3,87
2020-01-17,전북,전남,5480,256,523,658,1271,158,8346,6068,289,523,651,1332,176,9039
2020-01-17,전북,전북,17340,694,1034,718,813,703,21302,17340,694,1034,718,813,703,21302
2020-01-17,전북,충남,15742,555,1600,1160,1452,562,21071,16820,494,1619,1031,1494,647,22105
2020-01-17,전북,충북,2221,129,223,314,289,78,3254,2413,115,296,303,294,75,3496
2020-01-17,충남,강원,701,14,18,37,67,31,868,396,4,25,23,36,17,501
2020-01-17,충남,경기,44333,1615,2882,2514,4450,2247,58041,41452,1577,3072,2624,4665,2226,55616
2020-01-17,충남,경남,2421,73,195,348,569,81,3687,1427,63,140,265,245,65,2205
2020-01-17,충남,경북,4249,152,415,529,857,148,6350,3679,150,434,609,667,125,5664
2020-01-17,충남,광주,5386,119,637,625,421,153,7341,4712,110,633,483,344,138,6420
2020-01-17,충남,대구,1694,55,113,184,183,66,2295,1686,74,167,214,239,43,2423
2020-01-17,충남,대전,16165,444,565,268,321,1264,19027,16932,477,588,311,271,1347,19926
2020-01-17,충남,부산,181,10,31,75,180,3,480,164,12,33,60,139,4,412
2020-01-17,충남,서울,29048,656,2770,1393,1230,1147,36244,27460,540,2615,864,789,1081,33349
2020-01-17,충남,세종,5434,154,180,100,168,268,6304,6152,153,168,105,156,342,7076
2020-01-17,충남,울산,127,5,19,32,144,5,332,151,8,20,45,124,8,356
2020-01-17,충남,전남,5564,100,505,561,1026,147,7903,5439,110,504,790,1168,170,8181
2020-01-17,충남,전북,16820,494,1619,1031,1494,647,22105,15742,555,1600,1160,1452,562,21071
2020-01-17,충남,충남,110273,3870,8797,7253,10738,5389,146320,110273,3870,8797,7253,10738,5389,146320
2020-01-17,충남,충북,15521,737,961,1036,1507,906,20668,13754,650,939,937,1439,735,18454
2020-01-17,충북,강원,6323,189,286,218,288,366,7670,5643,218,308,235,343,333,7080
2020-01-17,충북,경기,32027,2172,2975,2987,3505,1540,45206,31841,2309,3115,3332,3427,1619,45643
2020-01-17,충북,경남,2157,75,257,505,668,71,3733,1511,55,189,278,288,44,2365
2020-01-17,충북,경북,6197,248,540,680,1004,251,8920,6351,235,512,701,892,238,8929
2020-01-17,충북,광주,903,33,101,189,108,16,1350,672,19,72,122,56,15,956
2020-01-17,충북,대구,1881,91,168,245,136,65,2586,2200,105,233,278,417,69,3302
2020-01-17,충북,대전,11096,390,451,185,129,799,13050,11588,460,512,223,157,846,13786
2020-01-17,충북,부산,116,12,26,125,171,2,452,135,8,20,94,196,5,458
2020-01-17,충북,서울,15876,698,1263,826,818,646,20127,14655,557,1270,734,718,607,18541
2020-01-17,충북,세종,368,18,24,10,28,16,464,365,10,21,17,22,27,462
2020-01-17,충북,울산,20,1,7,12,34,1,75,29,4,7,19,44,0,103
2020-01-17,충북,전남,541,16,54,98,265,17,991,553,16,44,98,274,19,1004
2020-01-17,충북,전북,2413,115,296,303,294,75,3496,2221,129,223,314,289,78,3254
2020-01-17,충북,충남,13754,650,939,937,1439,735,18454,15521,737,961,1036,1507,906,20668
2020-01-17,충북,충북,40176,2023,2560,2324,2996,2404,52483,40176,2023,2560,2324,2996,2404,52483
2020-01-18,강원,강원,96090,1503,2941,936,1620,4841,107931,96090,1503,2941,936,1620,4841,107931
2020-01-18,강원,경기,31566,353,1355,366,351,1371,35362,42502,383,1274,399,475,1725,46758
2020-01-18,강원,경남,218,3,23,12,8,4,268,170,1,9,9,2,9,200
2020-01-18,강원,경북,701,18,44,18,9,40,830,807,15,35,19,8,27,911
2020-01-18,강원,광주,128,2,21,9,7,4,171,128,1,16,10,5,2,162
2020-01-18,강원,대구,339,5,20,9,2,13,388,626,9,34,6,6,20,701
2020-01-18,강원,대전,245,5,37,3,0,10,300,340,1,37,4,1,16,399
2020-01-18,강원,부산,5,0,1,0,0,1,7,9,0,0,0,0,0,9
2020-01-18,강원,서울,1004,14,413,8,24,38,1501,1448,13,380,13,10,45,1909
2020-01-18,강원,세종,4,0,1,1,0,0,6,7,0,0,0,1,3,11
2020-01-18,강원,울산,2,0,0,0,0,0,2,3,0,0,0,0,0,3
2020-01-18,강원,전남,74,1,3,3,8,0,89,75,3,7,2,2,4,93
2020-01-18,강원,전북,193,5,13,4,1,5,221,201,6,10,13,8,2,240
2020-01-18,강원,충남,464,3,30,15,18,17,547,691,5,34,35,24,20,809
2020-01-18,강원,충북,5745,146,241,129,177,286,6724,6719,128,228,137,170,290,7672
2020-01-18,경기,강원,42502,383,1274,399,475,1725,46758,31566,353,1355,366,351,1371,35362
2020-01-18,경기,경기,391334,11179,13824,9372,13972,24832,464513,391334,11179,13824,9372,13972,24832,464513
2020-01-18,경기,경남,3407,47,313,602,351,118,4838,2167,37,223,344,219,73,3063
2020-01-18,경기,경북,6112,83,314,495,374,215,7593,5199,77,282,484,340,182,6564
2020-01-18,경기,광주,1258,19,146,199,106,38,1766,874,12,105,138,69,27,1225
2020-01-18,경기,대구,2482,48,175,310,149,75,3239,3065,54,175,266,197,113,3870
2020-01-18,경기,대전,3467,53,196,97,47,162,4022,3061,58,181,66,42,145,3553
2020-01-18,경기,부산,299,13,46,150,71,6,585,277,10,22,112,101,8,530
2020-01-18,경기,서울,138560,4395,6033,3015,2612,8200,162815,133596,3825,6056,2344,2084,7913,155818
2020-01-18,경기,세종,64,1,2,5,2,2,76,75,5,3,2,0,9,94
2020-01-18,경기,울산,32,0,1,9,2,4,48,50,0,6,16,30,1,103
2020-01-18,경기,전남,1495,10,101,101,113,44,1864,1050,12,61,76,63,32,1294
2020-01-18,경기,전북,2580,19,161,81,123,77,3041,2027,23,128,91,94,60,2423
2020-01-18,경기,충남,47420,758,1897,1249,2285,2199,55808,46067,725,1890,1244,2317,2154,54397
2020-01-18,경기,충북,33352,1004,1662,1530,1837,1495,40880,31456,931,1551,1453,1806,1441,38638
2020-01-18,경남,강원,170,1,9,9,2,9,200,218,3,23,12,8,4,268
2020-01-18,경남,경기,2167,37,223,344,219,73,3063,3407,47,313,602,351,118,4838
2020-01-18,경남,경남,191502,6268,6519,4779,8834,12717,230619,191502,6268,6519,4779,8834,12717,230619
2020-01-18,경남,경북,15745,320,687,510,953,755,18970,18707,455,856,747,1391,820,22976
2020-01-18,경남,광주,1448,31,120,128,82,41,1850,1680,28,125,95,49,41,2018
2020-01-18,경남,대구,17871,410,866,556,756,785,21244,15643,298,643,280,280,650,17794
2020-01-18,경남,대전,1098,12,97,53,24,42,1326,1596,16,108,104,38,66,1928
2020-01-18,경남,부산,94676,1612,2327,1171,2307,5848,107941,90200,1605,2205,1059,2372,5669,103110
2020-01-18,경남,서울,2034,16,513,149,75,59,2846,3197,44,590,156,87,75,4149
2020-01-18,경남,세종,219,1,11,4,8,6,249,359,1,15,8,7,9,399
2020-01-18,경남,울산,11505,401,459,275,235,665,13540,11428,374,499,266,262,635,13464
2020-01-18,경남,전남,7967,167,347,294,792,363,9930,7878,162,335,293,868,341,9877
2020-01-18,경남,전북,2562,23,122,59,111,76,2953,2073,27,126,68,117,66,2477
2020-01-18,경남,충남,1452,17,77,116,106,56,1824,2216,23,129,205,278,78,2929
2020-01-18,경남,충북,1428,23,115,133,142,41,1882,2056,51,179,312,368,72,3038
2020-01-18,경북,강원,807,15,35,19,8,27,911,701,18,44,18,9,40,830
2020-01-18,경북,경기,5199,77,282,484,340,182,6564,6112,83,314,495,374,215,7593
2020-01-18,경북,경남,18707,455,856,747,1391,820,22976,15745,320,687,510,953,755,18970
2020-01-18,경북,경북,83464,2353,3017,1825,3382,3964,98005,83464,2353,3017,1825,3382,3964,98005
2020-01-18,경북,광주,1065,28,98,116,65,28,1400,1034,24,58,101,56,35,1308
2020-01-18,경북,대구,76829,1897,2142,1087,2258,3706,87919,80491,1954,2350,1195,2354,3841,92185
2020-01-18,경북,대전,2595,41,94,72,61,81,2944,2718,32,80,109,59,113,3111
2020-01-18,경북,부산,7355,66,315,97,295,312,8440,8196,61,339,96,318,366,9376
2020-01-18,경북,서울,3512,62,340,198,91,104,4307,4386,49,352,140,87,127,5141
2020-01-18,경북,세종,345,3,10,12,10,14,394,430,5,12,6,3,22,478
2020-01-18,경북,울산,6627,69,239,258,677,356,8226,7137,66,244,174,768,369,8758
2020-01-18,경북,전남,1508,22,66,56,261,49,1962,1380,29,58,66,359,48,1940
2020-01-18,경북,전북,2220,60,143,87,144,60,2714,1996,65,111,72,118,67,2429
2020-01-18,경북,충남,3840,75,200,287,347,133,4882,4489,62,210,298,407,169,5635
2020-01-18,경북,충북,7306,127,367,315,477,281,8873,7440,135,396,377,595,267,9210
2020-01-18,광주,강원,128,1,16,10,5,2,162,128,2,21,9,7,4,171
2020-01-18,광주,경기,874,12,105,138,69,27,1225,1258,19,146,199,106,38,1766
2020-01-18,광주,경남,1680,28,125,95,49,41,2018,1448,31,120,128,82,41,1850
2020-01-18,광주,경북,1034,24,58,101,56,35,1308,1065,28,98,116,65,28,1400
2020-01-18,광주,광주,13013,334,548,247,230,477,14849,13013,334,548,247,230,477,14849
2020-01-18,광주,대구,719,16,88,71,17,18,929,741,13,98,61,24,23,960
2020-01-18,광주,대전,664,10,8,28,20,20,750,789,8,12,26,16,21,872
2020-01-18,광주,부산,621,11,43,11,32,19,737,563,8,59,37,44,10,721
2020-01-18,광주,서울,763,11,13,49,15,21,872,1085,10,19,38,15,23,1190
2020-01-18,광주,세종,182,3,6,3,0,5,199,291,2,3,3,0,11,310
2020-01-18,광주,울산,56,1,9,1,3,1,71,76,1,7,6,9,1,100
2020-01-18,광주,전남,40195,650,1052,621,1221,1436,45175,38277,666,945,560,1294,1321,43063
2020-01-18,광주,전북,10110,264,369,201,185,314,11443,9923,306,369,201,265,326,11390
2020-01-18,광주,충남,5313,56,593,255,244,161,6622,5780,70,606,388,346,167,7357
2020-01-18,광주,충북,661,11,53,50,30,15,820,850,14,68,80,83,26,1121
2020-01-18,대구,강원,626,9,34,6,6,20,701,339,5,20,9,2,13,388
2020-01-18,대구,경기,3065,54,175,266,197,113,3870,2482,48,175,310,149,75,3239
2020-01-18,대구,경남,15643,298,643,280,280,650,17794,17871,410,866,556,756,785,21244
2020-01-18,대구,경북,80491,1954,2350,1195,2354,3841,92185,76829,1897,2142,1087,2258,3706,87919
2020-01-18,대구,광주,741,13,98,61,24,23,960,719,16,88,71,17,18,929
2020-01-18,대구,대구,53694,1284,1239,776,858,3077,60928,53694,1284,1239,776,858,3077,60928
2020-01-18,대구,대전,1347,12,56,58,39,44,1556,960,13,35,44,12,27,1091
2020-01-18,대구,부산,931,24,88,43,67,45,1198,4246,51,236,39,96,149,4817
2020-01-18,대구,서울,2719,36,303,152,52,75,3337,2057,27,216,107,40,57,2504
2020-01-18,대구,세종,276,5,13,5,5,12,316,233,0,3,2,5,7,250
2020-01-18,대구,울산,1777,27,120,55,95,63,2137,1980,26,127,32,139,81,2385
2020-01-18,대구,전남,890,13,52,19,27,29,1030,770,15,39,17,30,24,895
2020-01-18,대구,전북,539,7,32,12,5,15,610,544,5,38,10,12,11,620
2020-01-18,대구,충남,1744,28,68,99,107,49,2095,1556,31,60,127,103,49,1926
2020-01-18,대구,충북,2383,49,166,126,166,94,2984,1960,38,116,154,97,75,2440
2020-01-18,대전,강원,340,1,37,4,1,16,399,245,5,37,3,0,10,300
2020-01-18,대전,경기,3061,58,181,66,42,145,3553,3467,53,196,97,47,162,4022
2020-01-18,대전,경남,1596,16,108,104,38,66,1928,1098,12,97,53,24,42,1326
2020-01-18,대전,경북,2718,32,80,109,59,113,3111,2595,41,94,72,61,81,2944
2020-01-18,대전,광주,789,8,12,26,16,21,872,664,10,8,28,20,20,750
2020-01-18,대전,대구,960,13,35,44,12,27,1091,1347,12,56,58,39,44,1556
2020-01-18,대전,대전,12621,256,303,149,155,872,14356,12621,256,303,149,155,872,14356
2020-01-18,대전,부산,94,2,7,16,14,5,138,102,2,9,11,23,4,151
2020-01-18,대전,서울,2238,23,253,30,10,92,2646,2459,20,266,33,11,107,2896
2020-01-18,대전,세종,3126,76,52,15,20,234,3523,3138,90,52,20,36,260,3596
2020-01-18,대전,울산,155,3,13,16,18,3,208,152,1,17,11,14,7,202
2020-01-18,대전,전남,533,1,11,21,16,12,594,520,4,10,15,23,19,591
2020-01-18,대전,전북,5348,41,88,69,38,227,5811,5142,66,83,54,33,214,5592
2020-01-18,대전,충남,15702,273,389,168,187,939,17658,15268,265,392,154,208,951,17238
2020-01-18,대전,충북,10626,283,361,134,116,671,12191,9932,260,360,117,126,620,11415
2020-01-18,부산,강원,9,0,0,0,0,0,9,5,0,1,0,0,1,7
2020-01-18,부산,경기,277,10,22,112,101,8,530,299,13,46,150,71,6,585
2020-01-18,부산,경남,90200,1605,2205,1059,2372,5669,103110,94676,1612,2327,1171,2307,5848,107941
2020-01-18,부산,경북,8196,61,339,96,318,366,9376,7355,66,315,97,295,312,8440
2020-01-18,부산,광주,563,8,59,37,44,10,721,621,11,43,11,32,19,737
2020-01-18,부산,대구,4246,51,236,39,96,149,4817,931,24,88,43,67,45,1198
2020-01-18,부산,대전,102,2,9,11,23,4,151,94,2,7,16,14,5,138
2020-01-18,부산,부산,47586,410,423,602,1062,2847,52930,47586,410,423,602,1062,2847,52930
2020-01-18,부산,서울,281,7,19,36,23,7,373,275,5,29,41,36,12,398
2020-01-18,부산,세종,27,0,0,1,4,0,32,14,1,0,1,0,0,16
2020-01-18,부산,울산,18677,205,254,316,1082,1164,21698,20474,203,196,223,1080,1239,23415
2020-01-18,부산,전남,2566,29,113,79,342,93,3222,2299,28,84,59,313,85,2868
2020-01-18,부산,전북,621,6,54,23,53,15,772,425,8,41,25,27,10,536
2020-01-18,부산,충남,193,6,13,16,68,4,300,207,4,12,37,82,8,350
2020-01-18,부산,충북,157,6,14,25,104,8,314,151,9,14,77,86,5,342
2020-01-18,서울,강원,1448,13,380,13,10,45,1909,1004,14,413,8,24,38,1501
2020-01-18,서울,경기,133596,3825,6056,2344,2084,7913,155818,138560,4395,6033,3015,2612,8200,162815
2020-01-18,서울,경남,3197,44,590,156,87,75,4149,2034,16,513,149,75,59,2846
2020-01-18,서울,경북,4386,49,352,140,87,127,5141,3512,62,340,198,91,104,4307
2020-01-18,서울,광주,1085,10,19,38,15,23,1190,763,11,13,49,15,21,872
2020-01-18,서울,대구,2057,27,216,107,40,57,2504,2719,36,303,152,52,75,3337
2020-01-18,서울,대전,2459,20,266,33,11,107,2896,2238,23,253,30,10,92,2646
2020-01-18,서울,부산,275,5,29,41,36,12,398,281,7,19,36,23,7,373
2020-01-18,서울,서울,203,2,10,2,4,9,230,203,2,10,2,4,9,230
2020-01-18,서울,세종,39,0,0,0,0,1,40,55,0,1,0,0,0,56
2020-01-18,서울,울산,28,2,3,0,0,2,35,24,2,2,2,8,1,39
2020-01-18,서울,전남,1407,8,29,30,35,46,1555,994,14,35,43,26,18,1130
2020-01-18,서울,전북,2410,12,85,21,18,73,2619,1620,15,75,17,9,62,1798
2020-01-18,서울,충남,34042,272,2512,475,479,1285,39065,33164,294,2553,671,561,1278,38521
2020-01-18,서울,충북,16788,249,1143,430,365,693,19668,16323,298,1116,478,444,673,19332
2020-01-18,세종,강원,7,0,0,0,1,3,11,4,0,1,1,0,0,6
2020-01-18,세종,경기,75,5,3,2,0,9,94,64,1,2,5,2,2,76
2020-01-18,세종,경남,359,1,15,8,7,9,399,219,1,11,4,8,6,249
2020-01-18,세종,경북,430,5,12,6,3,22,478,345,3,10,12,10,14,394
2020-01-18,세종,광주,291,2,3,3,0,11,310,182,3,6,3,0,5,199
2020-01-18,세종,대구,233,0,3,2,5,7,250,276,5,13,5,5,12,316
2020-01-18,세종,대전,3138,90,52,20,36,260,3596,3126,76,52,15,20,234,3523
2020-01-18,세종,부산,14,1,0,1,0,0,16,27,0,0,1,4,0,32
2020-01-18,세종,서울,55,0,1,0,0,0,56,39,0,0,0,0,1,40
2020-01-18,세종,세종,233,13,0,3,0,11,260,233,13,0,3,0,11,260
2020-01-18,세종,울산,18,0,0,0,1,1,20,7,0,0,0,4,0,11
2020-01-18,세종,전남,248,2,1,5,11,2,269,186,0,2,2,11,4,205
2020-01-18,세종,전북,1441,14,15,12,31,55,1568,1109,11,16,8,34,50,1228
2020-01-18,세종,충남,6741,108,113,84,103,304,7453,5228,96,95,67,105,227,5818
2020-01-18,세종,충북,345,9,15,14,7,18,408,321,9,14,12,13,21,390
2020-01-18,울산,강원,3,0,0,0,0,0,3,2,0,0,0,0,0,2
2020-01-18,울산,경기,50,0,6,16,30,1,103,32,0,1,9,2,4,48
2020-01-18,울산,경남,11428,374,499,266,262,635,13464,11505,401,459,275,235,665,13540
2020-01-18,울산,경북,7137,66,244,174,768,369,8758,6627,69,239,258,677,356,8226
2020-01-18,울산,광주,76,1,7,6,9,1,100,56,1,9,1,3,1,71
2020-01-18,울산,대구,1980,26,127,32,139,81,2385,1777,27,120,55,95,63,2137
2020-01-18,울산,대전,152,1,17,11,14,7,202,155,3,13,16,18,3,208
2020-01-18,울산,부산,20474,203,196,223,1080,1239,23415,18677,205,254,316,1082,1164,21698
2020-01-18,울산,서울,24,2,2,2,8,1,39,28,2,3,0,0,2,35
2020-01-18,울산,세종,7,0,0,0,4,0,11,18,0,0,0,1,1,20
2020-01-18,울산,울산,6278,143,256,155,281,503,7616,6278,143,256,155,281,503,7616
2020-01-18,울산,전남,266,11,14,4,18,6,319,259,13,8,5,15,5,305
2020-01-18,울산,전북,72,0,7,1,10,2,92,50,0,7,0,3,0,60
2020-01-18,울산,충남,160,0,8,20,56,3,247,167,2,14,22,57,6,268
2020-01-18,울산,충북,30,2,7,12,30,1,82,27,0,0,8,40,0,75
2020-01-18,전남,강원,75,3,7,2,2,4,93,74,1,3,3,8,0,89
2020-01-18,전남,경기,1050,12,61,76,63,32,1294,1495,10,101,101,113,44,1864
2020-01-18,전남,경남,7878,162,335,293,868,341,9877,7967,167,347,294,792,363,9930
2020-01-18,전남,경북,1380,29,58,66,359,48,1940,1508,22,66,56,261,49,1962
2020-01-18,전남,광주,38277,666,945,560,1294,1321,43063,40195,650,1052,621,1221,1436,45175
2020-01-18,전남,대구,770,15,39,17,30,24,895,890,13,52,19,27,29,1030
2020-01-18,전남,대전,520,4,10,15,23,19,591,533,1,11,21,16,12,594
2020-01-18,전남,부산,2299,28,84,59,313,85,2868,2566,29,113,79,342,93,3222
2020-01-18,전남,서울,994,14,35,43,26,18,1130,1407,8,29,30,35,46,1555
2020-01-18,전남,세종,186,0,2,2,11,4,205,248,2,1,5,11,2,269
2020-01-18,전남,울산,259,13,8,5,15,5,305,266,11,14,4,18,6,319
2020-01-18,전남,전남,52368,858,1328,1205,3350,1828,60937,52368,858,1328,1205,3350,1828,60937
2020-01-18,전남,전북,7509,181,430,414,807,208,9549,7328,151,401,465,853,213,9411
2020-01-18,전남,충남,5439,73,398,337,392,129,6768,6884,57,468,316,572,175,8472
2020-01-18,전남,충북,507,12,30,49,117,19,734,630,7,48,61,157,22,925
2020-01-18,전북,강원,201,6,10,13,8,2,240,193,5,13,4,1,5,221
2020-01-18,전북,경기,2027,23,128,91,94,60,2423,2580,19,161,81,123,77,3041
2020-01-18,전북,경남,2073,27,126,68,117,66,2477,2562,23,122,59,111,76,2953
2020-01-18,전북,경북,1996,65,111,72,118,67,2429,2220,60,143,87,144,60,2714
2020-01-18,전북,광주,9923,306,369,201,265,326,11390,10110,264,369,201,185,314,11443
2020-01-18,전북,대구,544,5,38,10,12,11,620,539,7,32,12,5,15,610
2020-01-18,전북,대전,5142,66,83,54,33,214,5592,5348,41,88,69,38,227,5811
2020-01-18,전북,부산,425,8,41,25,27,10,536,621,6,54,23,53,15,772
2020-01-18,전북,서울,1620,15,75,17,9,62,1798,2410,12,85,21,18,73,2619
2020-01-18,전북,세종,1109,11,16,8,34,50,1228,1441,14,15,12,31,55,1568
2020-01-18,전북,울산,50,0,7,0,3,0,60,72,0,7,1,10,2,92
2020-01-18,전북,전남,7328,151,401,465,853,213,9411,7509,181,430,414,807,208,9549
2020-01-18,전북,전북,17564,427,697,410,526,615,20239,17564,427,697,410,526,615,20239
2020-01-18,전북,충남,18931,268,1296,544,807,627,22473,20984,308,1338,599,886,679,24794
2020-01-18,전북,충북,2427,51,147,184,140,66,3015,2826,68,140,168,175,82,3459
2020-01-18,충남,강원,691,5,34,35,24,20,809,464,3,30,15,18,17,547
2020-01-18,충남,경기,46067,725,1890,1244,2317,2154,54397,47420,758,1897,1249,2285,2199,55808
2020-01-18,충남,경남,2216,23,129,205,278,78,2929,1452,17,77,116,106,56,1824
2020-01-18,충남,경북,4489,62,210,298,407,169,5635,3840,75,200,287,347,133,4882
2020-01-18,충남,광주,5780,70,606,388,346,167,7357,5313,56,593,255,244,161,6622
2020-01-18,충남,대구,1556,31,60,127,103,49,1926,1744,28,68,99,107,49,2095
2020-01-18,충남,대전,15268,265,392,154,208,951,17238,15702,273,389,168,187,939,17658
2020-01-18,충남,부산,207,4,12,37,82,8,350,193,6,13,16,68,4,300
2020-01-18,충남,서울,33164,294,2553,671,561,1278,38521,34042,272,2512,475,479,1285,39065
2020-01-18,충남,세종,5228,96,95,67,105,227,5818,6741,108,113,84,103,304,7453
2020-01-18,충남,울산,167,2,14,22,57,6,268,160,0,8,20,56,3,247
2020-01-18,충남,전남,6884,57,468,316,572,175,8472,5439,73,398,337,392,129,6768
2020-01-18,충남,전북,20984,308,1338,599,886,679,24794,18931,268,1296,544,807,627,22473
2020-01-18,충남,충남,114544,1938,6451,3524,5720,4735,136912,114544,1938,6451,3524,5720,4735,136912
2020-01-18,충남,충북,12670,332,533,483,901,684,15603,11622,352,530,439,805,612,14360
2020-01-18,충북,강원,6719,128,228,137,170,290,7672,5745,146,241,129,177,286,6724
2020-01-18,충북,경기,31456,931,1551,1453,1806,1441,38638,33352,1004,1662,1530,1837,1495,40880
2020-01-18,충북,경남,2056,51,179,312,368,72,3038,1428,23,115,133,142,41,1882
2020-01-18,충북,경북,7440,135,396,377,595,267,9210,7306,127,367,315,477,281,8873
2020-01-18,충북,광주,850,14,68,80,83,26,1121,661,11,53,50,30,15,820
2020-01-18,충북,대구,1960,38,116,154,97,75,2440,2383,49,166,126,166,94,2984
2020-01-18,충북,대전,9932,260,360,117,126,620,11415,10626,283,361,134,116,671,12191
2020-01-18,충북,부산,151,9,14,77,86,5,342,157,6,14,25,104,8,314
2020-01-18,충북,서울,16323,298,1116,478,444,673,19332,16788,249,1143,430,365,693,19668
2020-01-18,충북,세종,321,9,14,12,13,21,390,345,9,15,14,7,18,408
2020-01-18,충북,울산,27,0,0,8,40,0,75,30,2,7,12,30,1,82
2020-01-18,충북,전남,630,7,48,61,157,22,925,507,12,30,49,117,19,734
2020-01-18,충북,전북,2826,68,140,168,175,82,3459,2427,51,147,184,140,66,3015
2020-01-18,충북,충남,11622,352,530,439,805,612,14360,12670,332,533,483,901,684,15603
2020-01-18,충북,충북,36128,1030,1292,1262,1595,2001,43308,36128,1030,1292,1262,1595,2001,43308
2020-01-19,강원,강원,77924,729,2573,378,634,4107,86345,77924,729,2573,378,634,4107,86345
2020-01-19,강원,경기,40526,244,1163,176,126,1602,43837,24238,185,1092,147,155,1213,27030
2020-01-19,강원,경남,343,1,15,0,4,9,372,163,2,8,4,1,7,185
2020-01-19,강원,경북,830,16,56,5,2,25,934,618,8,51,14,5,32,728
2020-01-19,강원,광주,143,1,17,4,1,4,170,110,0,13,2,1,1,127
2020-01-19,강원,대구,524,3,37,4,2,5,575,474,5,57,2,4,5,547
2020-01-19,강원,대전,332,1,43,0,0,8,384,243,2,42,0,0,12,299
2020-01-19,강원,부산,4,0,1,0,0,0,5,8,0,0,0,0,0,8
2020-01-19,강원,서울,1485,6,496,7,3,44,2041,839,9,352,1,2,28,1231
2020-01-19,강원,세종,20,0,0,0,0,1,21,10,0,0,0,0,0,10
2020-01-19,강원,울산,6,0,0,0,0,0,6,2,0,0,1,0,0,3
2020-01-19,강원,전남,84,0,1,5,5,3,98,73,0,3,1,8,2,87
2020-01-19,강원,전북,217,1,14,1,0,7,240,197,1,5,11,4,8,226
2020-01-19,강원,충남,652,2,24,8,8,24,718,481,3,23,13,13,32,565
2020-01-19,강원,충북,5688,63,178,55,58,240,6282,4835,53,206,61,55,241,5451
2020-01-19,경기,강원,24238,185,1092,147,155,1213,27030,40526,244,1163,176,126,1602,43837
2020-01-19,경기,경기,302361,4943,7559,3725,5359,18535,342482,302361,4943,7559,3725,5359,18535,342482
2020-01-19,경기,경남,2520,20,219,167,66,99,3091,2671,14,172,126,71,83,3137
2020-01-19,경기,경북,4494,36,224,183,81,137,5155,5946,63,205,260,107,202,6783
2020-01-19,경기,광주,827,11,110,39,18,21,1026,1046,9,94,44,27,26,1246
2020-01-19,경기,대구,2038,16,122,76,37,61,2350,3296,20,129,95,72,108,3720
2020-01-19,경기,대전,2360,16,166,21,5,107,2675,3015,35,175,21,15,130,3391
2020-01-19,경기,부산,228,1,7,41,22,7,306,441,2,10,29,37,18,537
2020-01-19,경기,서울,108030,1756,4327,1371,623,6170,122277,119338,1913,4370,1325,633,6945,134524
2020-01-19,경기,세종,39,1,2,3,1,2,48,58,0,2,3,0,1,64
2020-01-19,경기,울산,35,0,1,4,5,0,45,33,0,1,3,12,5,54
2020-01-19,경기,전남,744,8,65,41,26,31,915,1433,8,72,67,45,28,1653
2020-01-19,경기,전북,1533,13,107,37,26,54,1770,2377,12,100,54,43,87,2673
2020-01-19,경기,충남,36776,321,1358,519,673,1747,41394,39328,310,1388,471,670,1750,43917
2020-01-19,경기,충북,26401,485,997,621,585,1296,30385,28982,504,999,571,481,1296,32833
2020-01-19,경남,강원,163,2,8,4,1,7,185,343,1,15,0,4,9,372
2020-01-19,경남,경기,2671,14,172,126,71,83,3137,2520,20,219,167,66,99,3091
2020-01-19,경남,경남,161314,2344,3516,1189,1785,10090,180238,161314,2344,3516,1189,1785,10090,180238
2020-01-19,경남,경북,14775,151,453,174,166,641,16360,19165,240,584,274,240,861,21364
2020-01-19,경남,광주,1519,14,110,46,12,49,1750,1468,8,98,56,17,54,1701
2020-01-19,경남,대구,16742,194,636,327,389,718,19006,13738,129,530,103,62,601,15163
2020-01-19,경남,대전,1158,9,94,44,13,50,1368,1409,8,101,33,13,70,1634
2020-01-19,경남,부산,80751,668,1694,295,924,4814,89146,79651,674,1631,273,954,4967,88150
2020-01-19,경남,서울,2480,29,485,147,67,74,3282,2504,16,509,34,24,75,3162
2020-01-19,경남,세종,298,0,10,2,1,9,320,283,0,15,0,0,7,305
2020-01-19,경남,울산,11062,133,295,51,66,653,12260,10659,112,306,45,58,603,11783
2020-01-19,경남,전남,7062,86,253,117,187,321,8026,7256,81,233,148,241,333,8292
2020-01-19,경남,전북,1927,15,102,28,21,64,2157,2407,21,108,21,23,79,2659
2020-01-19,경남,충남,1700,12,60,57,35,81,1945,1784,16,63,67,54,77,2061
2020-01-19,경남,충북,1801,8,88,62,61,59,2079,1754,12,106,95,60,60,2087
2020-01-19,경북,강원,618,8,51,14,5,32,728,830,16,56,5,2,25,934
2020-01-19,경북,경기,5946,63,205,260,107,202,6783,4494,36,224,183,81,137,5155
2020-01-19,경북,경남,19165,240,584,274,240,861,21364,14775,151,453,174,166,641,16360
2020-01-19,경북,경북,75278,921,1728,633,868,3707,83135,75278,921,1728,633,868,3707,83135
2020-01-19,경북,광주,1074,18,66,69,15,34,1276,1023,17,46,67,24,30,1207
2020-01-19,경북,대구,64794,648,1316,349,435,3084,70626,68671,699,1559,472,487,3306,75194
2020-01-19,경북,대전,2466,12,79,46,25,102,2730,2384,17,72,32,17,108,2630
2020-01-19,경북,부산,8056,25,268,34,105,371,8859,8416,30,307,56,111,350,9270
2020-01-19,경북,서울,4050,28,333,162,32,121,4726,3221,26,315,62,18,95,3737
2020-01-19,경북,세종,391,1,10,3,1,12,418,320,3,13,4,0,10,350
2020-01-19,경북,울산,7640,31,156,117,256,356,8556,6491,28,141,57,269,289,7275
2020-01-19,경북,전남,1411,16,49,41,95,35,1647,1524,16,50,35,136,46,1807
2020-01-19,경북,전북,2011,29,68,35,41,53,2237,2037,29,62,33,45,51,2257
2020-01-19,경북,충남,4065,33,94,84,116,144,4536,3684,35,121,73,89,125,4127
2020-01-19,경북,충북,7229,63,202,195,165,273,8127,6450,61,241,119,95,251,7217
2020-01-19,광주,강원,110,0,13,2,1,1,127,143,1,17,4,1,4,170
2020-01-19,광주,경기,1046,9,94,44,27,26,1246,827,11,110,39,18,21,1026
2020-01-19,광주,경남,1468,8,98,56,17,54,1701,1519,14,110,46,12,49,1750
2020-01-19,광주,경북,1023,17,46,67,24,30,1207,1074,18,66,69,15,34,1276
2020-01-19,광주,광주,10650,151,463,137,67,386,11854,10650,151,463,137,67,386,11854
2020-01-19,광주,대구,713,8,97,57,15,21,911,667,11,115,37,9,22,861
2020-01-19,광주,대전,622,4,6,14,9,26,681,624,2,10,15,12,24,687
2020-01-19,광주,부산,505,2,53,9,6,15,590,753,5,63,7,7,29,864
2020-01-19,광주,서울,1010,12,16,17,6,32,1093,765,10,26,14,3,24,842
2020-01-19,광주,세종,242,0,3,3,2,8,258,200,2,2,1,0,7,212
2020-01-19,광주,울산,72,0,10,1,2,4,89,40,0,9,2,2,0,53
2020-01-19,광주,전남,32996,269,829,265,205,1082,35646,32478,262,711,331,190,1133,35105
2020-01-19,광주,전북,8122,94,215,80,75,264,8850,8906,97,258,58,52,289,9660
2020-01-19,광주,충남,5477,38,545,185,137,193,6575,4697,33,545,125,75,137,5612
2020-01-19,광주,충북,706,9,36,25,20,24,820,692,9,40,36,12,23,812
2020-01-19,대구,강원,474,5,57,2,4,5,547,524,3,37,4,2,5,575
2020-01-19,대구,경기,3296,20,129,95,72,108,3720,2038,16,122,76,37,61,2350
2020-01-19,대구,경남,13738,129,530,103,62,601,15163,16742,194,636,327,389,718,19006
2020-01-19,대구,경북,68671,699,1559,472,487,3306,75194,64794,648,1316,349,435,3084,70626
2020-01-19,대구,광주,667,11,115,37,9,22,861,713,8,97,57,15,21,911
2020-01-19,대구,대구,40199,427,644,161,168,2216,43815,40199,427,644,161,168,2216,43815
2020-01-19,대구,대전,1249,7,37,20,15,59,1387,837,3,29,20,12,29,930
2020-01-19,대구,부산,793,11,66,22,14,38,944,4664,30,177,22,40,183,5116
2020-01-19,대구,서울,2684,18,183,69,28,87,3069,1863,12,143,33,8,60,2119
2020-01-19,대구,세종,399,0,11,1,1,12,424,186,0,3,0,0,8,197
2020-01-19,대구,울산,1829,17,100,12,43,93,2094,1567,11,95,12,51,62,1798
2020-01-19,대구,전남,825,8,67,16,22,26,964,864,10,60,24,39,30,1027
2020-01-19,대구,전북,509,1,46,3,3,17,579,514,2,44,8,3,16,587
2020-01-19,대구,충남,2001,10,60,31,39,58,2199,1148,7,33,29,18,38,1273
2020-01-19,대구,충북,2493,16,162,79,63,92,2905,1838,15,104,49,24,50,2080
2020-01-19,대전,강원,243,2,42,0,0,12,299,332,1,43,0,0,8,384
2020-01-19,대전,경기,3015,35,175,21,15,130,3391,2360,16,166,21,5,107,2675
2020-01-19,대전,경남,1409,8,101,33,13,70,1634,1158,9,94,44,13,50,1368
2020-01-19,대전,경북,2384,17,72,32,17,108,2630,2466,12,79,46,25,102,2730
2020-01-19,대전,광주,624,2,10,15,12,24,687,622,4,6,14,9,26,681
2020-01-19,대전,대구,837,3,29,20,12,29,930,1249,7,37,20,15,59,1387
2020-01-19,대전,대전,9529,64,149,56,32,694,10524,9529,64,149,56,32,694,10524
2020-01-19,대전,부산,69,0,2,3,2,4,80,146,0,3,0,3,4,156
2020-01-19,대전,서울,2211,8,245,15,0,89,2568,1848,7,231,4,3,89,2182
2020-01-19,대전,세종,2466,28,27,4,7,179,2711,2115,36,23,6,5,130,2315
2020-01-19,대전,울산,134,0,13,7,11,5,170,135,0,11,3,9,9,167
2020-01-19,대전,전남,431,1,10,6,10,21,479,504,1,10,18,4,11,548
2020-01-19,대전,전북,4065,25,61,28,20,182,4381,4583,25,62,60,29,211,4970
2020-01-19,대전,충남,12795,82,229,60,46,709,13921,11775,98,228,64,56,692,12913
2020-01-19,대전,충북,8579,123,265,43,29,519,9558,7722,100,242,40,28,451,8583
2020-01-19,부산,강원,8,0,0,0,0,0,8,4,0,1,0,0,0,5
2020-01-19,부산,경기,441,2,10,29,37,18,537,228,1,7,41,22,7,306
2020-01-19,부산,경남,79651,674,1631,273,954,4967,88150,80751,668,1694,295,924,4814,89146
2020-01-19,부산,경북,8416,30,307,56,111,350,9270,8056,25,268,34,105,371,8859
2020-01-19,부산,광주,753,5,63,7,7,29,864,505,2,53,9,6,15,590
2020-01-19,부산,대구,4664,30,177,22,40,183,5116,793,11,66,22,14,38,944
2020-01-19,부산,대전,146,0,3,0,3,4,156,69,0,2,3,2,4,80
2020-01-19,부산,부산,46132,143,246,70,304,2615,49510,46132,143,246,70,304,2615,49510
2020-01-19,부산,서울,405,3,13,14,9,13,457,216,4,11,13,6,6,256
2020-01-19,부산,세종,32,0,0,0,0,0,32,24,0,0,2,0,1,27
2020-01-19,부산,울산,19722,71,158,85,334,1161,21531,18125,80,107,59,364,1128,19863
2020-01-19,부산,전남,2643,24,109,42,137,96,3051,2255,18,95,80,136,85,2669
2020-01-19,부산,전북,539,4,59,5,20,12,639,549,7,52,10,16,28,662
2020-01-19,부산,충남,270,4,11,11,11,12,319,173,1,10,7,15,6,212
2020-01-19,부산,충북,234,1,11,8,30,6,290,131,1,6,22,9,7,176
2020-01-19,서울,강원,839,9,352,1,2,28,1231,1485,6,496,7,3,44,2041
2020-01-19,서울,경기,119338,1913,4370,1325,633,6945,134524,108030,1756,4327,1371,623,6170,122277
2020-01-19,서울,경남,2504,16,509,34,24,75,3162,2480,29,485,147,67,74,3282
2020-01-19,서울,경북,3221,26,315,62,18,95,3737,4050,28,333,162,32,121,4726
2020-01-19,서울,광주,765,10,26,14,3,24,842,1010,12,16,17,6,32,1093
2020-01-19,서울,대구,1863,12,143,33,8,60,2119,2684,18,183,69,28,87,3069
2020-01-19,서울,대전,1848,7,231,4,3,89,2182,2211,8,245,15,0,89,2568
2020-01-19,서울,부산,216,4,11,13,6,6,256,405,3,13,14,9,13,457
2020-01-19,서울,서울,195,3,5,4,1,6,214,195,3,5,4,1,6,214
2020-01-19,서울,세종,41,0,0,0,1,1,43,29,0,0,0,0,1,30
2020-01-19,서울,울산,21,1,0,0,0,0,22,43,0,0,1,3,1,48
2020-01-19,서울,전남,863,3,29,18,4,18,935,1609,7,31,72,44,43,1806
2020-01-19,서울,전북,1374,10,77,3,1,36,1501,2285,7,83,10,4,65,2454
2020-01-19,서울,충남,31078,147,2252,215,204,1245,35141,33946,208,2189,645,352,1357,38697
2020-01-19,서울,충북,15545,119,968,225,147,617,17621,14831,114,1023,209,148,624,16949
2020-01-19,세종,강원,10,0,0,0,0,0,10,20,0,0,0,0,1,21
2020-01-19,세종,경기,58,0,2,3,0,1,64,39,1,2,3,1,2,48
2020-01-19,세종,경남,283,0,15,0,0,7,305,298,0,10,2,1,9,320
2020-01-19,세종,경북,320,3,13,4,0,10,350,391,1,10,3,1,12,418
2020-01-19,세종,광주,200,2,2,1,0,7,212,242,0,3,3,2,8,258
2020-01-19,세종,대구,186,0,3,0,0,8,197,399,0,11,1,1,12,424
2020-01-19,세종,대전,2115,36,23,6,5,130,2315,2466,28,27,4,7,179,2711
2020-01-19,세종,부산,24,0,0,2,0,1,27,32,0,0,0,0,0,32
2020-01-19,세종,서울,29,0,0,0,0,1,30,41,0,0,0,1,1,43
2020-01-19,세종,세종,199,4,1,0,0,14,218,199,4,1,0,0,14,218
2020-01-19,세종,울산,12,0,0,0,2,0,14,17,0,1,0,1,0,19
2020-01-19,세종,전남,200,2,1,0,2,8,213,277,2,4,2,2,11,298
2020-01-19,세종,전북,921,0,10,4,7,23,965,1137,2,8,3,14,44,1208
2020-01-19,세종,충남,5168,45,70,36,38,231,5588,4765,37,78,33,29,215,5157
2020-01-19,세종,충북,277,5,4,3,1,14,304,277,7,3,1,0,20,308
2020-01-19,울산,강원,2,0,0,1,0,0,3,6,0,0,0,0,0,6
2020-01-19,울산,경기,33,0,1,3,12,5,54,35,0,1,4,5,0,45
2020-01-19,울산,경남,10659,112,306,45,58,603,11783,11062,133,295,51,66,653,12260
2020-01-19,울산,경북,6491,28,141,57,269,289,7275,7640,31,156,117,256,356,8556
2020-01-19,울산,광주,40,0,9,2,2,0,53,72,0,10,1,2,4,89
2020-01-19,울산,대구,1567,11,95,12,51,62,1798,1829,17,100,12,43,93,2094
2020-01-19,울산,대전,135,0,11,3,9,9,167,134,0,13,7,11,5,170
2020-01-19,울산,부산,18125,80,107,59,364,1128,19863,19722,71,158,85,334,1161,21531
2020-01-19,울산,서울,43,0,0,1,3,1,48,21,1,0,0,0,0,22
2020-01-19,울산,세종,17,0,1,0,1,0,19,12,0,0,0,2,0,14
2020-01-19,울산,울산,5288,47,142,27,53,371,5928,5288,47,142,27,53,371,5928
2020-01-19,울산,전남,247,4,9,6,4,6,276,262,3,8,4,1,7,285
2020-01-19,울산,전북,64,0,7,0,5,0,76,64,0,8,0,1,2,75
2020-01-19,울산,충남,142,2,8,9,22,2,185,146,1,7,5,26,5,190
2020-01-19,울산,충북,34,1,3,0,3,2,43,22,0,0,0,6,0,28
2020-01-19,전남,강원,73,0,3,1,8,2,87,84,0,1,5,5,3,98
2020-01-19,전남,경기,1433,8,72,67,45,28,1653,744,8,65,41,26,31,915
2020-01-19,전남,경남,7256,81,233,148,241,333,8292,7062,86,253,117,187,321,8026
2020-01-19,전남,경북,1524,16,50,35,136,46,1807,1411,16,49,41,95,35,1647
2020-01-19,전남,광주,32478,262,711,331,190,1133,35105,32996,269,829,265,205,1082,35646
2020-01-19,전남,대구,864,10,60,24,39,30,1027,825,8,67,16,22,26,964
2020-01-19,전남,대전,504,1,10,18,4,11,548,431,1,10,6,10,21,479
2020-01-19,전남,부산,2255,18,95,80,136,85,2669,2643,24,109,42,137,96,3051
2020-01-19,전남,서울,1609,7,31,72,44,43,1806,863,3,29,18,4,18,935
2020-01-19,전남,세종,277,2,4,2,2,11,298,200,2,1,0,2,8,213
2020-01-19,전남,울산,262,3,8,4,1,7,285,247,4,9,6,4,6,276
2020-01-19,전남,전남,44935,465,1045,759,1120,1527,49851,44935,465,1045,759,1120,1527,49851
2020-01-19,전남,전북,7006,104,226,346,289,204,8175,6337,81,245,181,253,185,7282
2020-01-19,전남,충남,7353,65,400,508,551,189,9066,4871,34,431,138,216,138,5828
2020-01-19,전남,충북,681,5,18,35,62,13,814,478,4,25,29,54,12,602
2020-01-19,전북,강원,197,1,5,11,4,8,226,217,1,14,1,0,7,240
2020-01-19,전북,경기,2377,12,100,54,43,87,2673,1533,13,107,37,26,54,1770
2020-01-19,전북,경남,2407,21,108,21,23,79,2659,1927,15,102,28,21,64,2157
2020-01-19,전북,경북,2037,29,62,33,45,51,2257,2011,29,68,35,41,53,2237
2020-01-19,전북,광주,8906,97,258,58,52,289,9660,8122,94,215,80,75,264,8850
2020-01-19,전북,대구,514,2,44,8,3,16,587,509,1,46,3,3,17,579
2020-01-19,전북,대전,4583,25,62,60,29,211,4970,4065,25,61,28,20,182,4381
2020-01-19,전북,부산,549,7,52,10,16,28,662,539,4,59,5,20,12,639
2020-01-19,전북,서울,2285,7,83,10,4,65,2454,1374,10,77,3,1,36,1501
2020-01-19,전북,세종,1137,2,8,3,14,44,1208,921,0,10,4,7,23,965
2020-01-19,전북,울산,64,0,8,0,1,2,75,64,0,7,0,5,0,76
2020-01-19,전북,전남,6337,81,245,181,253,185,7282,7006,104,226,346,289,204,8175
2020-01-19,전북,전북,14287,134,412,144,93,455,15525,14287,134,412,144,93,455,15525
2020-01-19,전북,충남,19634,153,1054,324,349,653,22167,15928,117,1031,192,265,530,18063
2020-01-19,전북,충북,2644,38,71,139,68,94,3054,2098,35,98,110,45,58,2444
2020-01-19,충남,강원,481,3,23,13,13,32,565,652,2,24,8,8,24,718
2020-01-19,충남,경기,39328,310,1388,471,670,1750,43917,36776,321,1358,519,673,1747,41394
2020-01-19,충남,경남,1784,16,63,67,54,77,2061,1700,12,60,57,35,81,1945
2020-01-19,충남,경북,3684,35,121,73,89,125,4127,4065,33,94,84,116,144,4536
2020-01-19,충남,광주,4697,33,545,125,75,137,5612,5477,38,545,185,137,193,6575
2020-01-19,충남,대구,1148,7,33,29,18,38,1273,2001,10,60,31,39,58,2199
2020-01-19,충남,대전,11775,98,228,64,56,692,12913,12795,82,229,60,46,709,13921
2020-01-19,충남,부산,173,1,10,7,15,6,212,270,4,11,11,11,12,319
2020-01-19,충남,서울,33946,208,2189,645,352,1357,38697,31078,147,2252,215,204,1245,35141
2020-01-19,충남,세종,4765,37,78,33,29,215,5157,5168,45,70,36,38,231,5588
2020-01-19,충남,울산,146,1,7,5,26,5,190,142,2,8,9,22,2,185
2020-01-19,충남,전남,4871,34,431,138,216,138,5828,7353,65,400,508,551,189,9066
2020-01-19,충남,전북,15928,117,1031,192,265,530,18063,19634,153,1054,324,349,653,22167
2020-01-19,충남,충남,100283,959,5000,1670,2245,4061,114218,100283,959,5000,1670,2245,4061,114218
2020-01-19,충남,충북,10258,145,309,255,259,519,11745,9687,141,335,227,323,528,11241
2020-01-19,충북,강원,4835,53,206,61,55,241,5451,5688,63,178,55,58,240,6282
2020-01-19,충북,경기,28982,504,999,571,481,1296,32833,26401,485,997,621,585,1296,30385
2020-01-19,충북,경남,1754,12,106,95,60,60,2087,1801,8,88,62,61,59,2079
2020-01-19,충북,경북,6450,61,241,119,95,251,7217,7229,63,202,195,165,273,8127
2020-01-19,충북,광주,692,9,40,36,12,23,812,706,9,36,25,20,24,820
2020-01-19,충북,대구,1838,15,104,49,24,50,2080,2493,16,162,79,63,92,2905
2020-01-19,충북,대전,7722,100,242,40,28,451,8583,8579,123,265,43,29,519,9558
2020-01-19,충북,부산,131,1,6,22,9,7,176,234,1,11,8,30,6,290
2020-01-19,충북,서울,14831,114,1023,209,148,624,16949,15545,119,968,225,147,617,17621
2020-01-19,충북,세종,277,7,3,1,0,20,308,277,5,4,3,1,14,304
2020-01-19,충북,울산,22,0,0,0,6,0,28,34,1,3,0,3,2,43
2020-01-19,충북,전남,478,4,25,29,54,12,602,681,5,18,35,62,13,814
2020-01-19,충북,전북,2098,35,98,110,45,58,2444,2644,38,71,139,68,94,3054
2020-01-19,충북,충남,9687,141,335,227,323,528,11241,10258,145,309,255,259,519,11745
2020-01-19,충북,충북,29533,469,747,540,426,1518,33233,29533,469,747,540,426,1518,33233
2020-01-20,강원,강원,68484,2242,3122,1430,2250,4648,82176,68484,2242,3122,1430,2250,4648,82176
2020-01-20,강원,경기,20954,582,1246,659,791,931,25163,20378,625,1312,636,882,986,24819
2020-01-20,강원,경남,221,2,6,10,15,7,261,108,0,7,14,7,3,139
2020-01-20,강원,경북,518,19,44,16,27,15,639,447,16,35,21,24,29,572
2020-01-20,강원,광주,86,1,21,8,8,4,128,74,2,15,15,8,3,117
2020-01-20,강원,대구,263,5,5,12,12,7,304,306,6,21,20,16,12,381
2020-01-20,강원,대전,166,0,30,4,1,9,210,213,4,33,5,0,12,267
2020-01-20,강원,부산,7,0,0,2,3,0,12,1,0,1,1,0,0,3
2020-01-20,강원,서울,662,9,279,10,30,25,1015,697,9,233,8,9,28,984
2020-01-20,강원,세종,7,0,1,0,1,0,9,7,0,0,2,1,0,10
2020-01-20,강원,울산,2,0,1,0,0,0,3,1,0,0,0,1,0,2
2020-01-20,강원,전남,52,0,2,2,8,0,64,45,1,6,6,21,2,81
2020-01-20,강원,전북,133,3,13,13,9,4,175,161,6,11,20,16,6,220
2020-01-20,강원,충남,379,11,18,17,36,18,479,436,11,29,27,75,15,593
2020-01-20,강원,충북,5000,224,291,258,386,306,6465,5048,215,301,196,311,316,6387
2020-01-20,경기,강원,20378,625,1312,636,882,986,24819,20954,582,1246,659,791,931,25163
2020-01-20,경기,경기,439539,23038,25126,19848,25077,33093,565721,439539,23038,25126,19848,25077,33093,565721
2020-01-20,경기,경남,2631,88,311,417,373,90,3910,1778,53,271,436,363,59,2960
2020-01-20,경기,경북,4660,187,487,633,524,147,6638,4156,182,475,811,552,153,6329
2020-01-20,경기,광주,878,36,190,267,119,16,1506,806,22,148,254,127,20,1377
2020-01-20,경기,대구,2134,83,207,279,154,63,2920,2942,94,229,345,406,84,4100
2020-01-20,경기,대전,2235,106,202,100,48,96,2787,2624,118,198,122,65,120,3247
2020-01-20,경기,부산,192,11,20,92,105,4,424,276,17,25,109,196,7,630
2020-01-20,경기,서울,147289,7370,9618,4966,3390,10088,182721,152788,6915,9313,4929,3116,10283,187344
2020-01-20,경기,세종,42,3,4,5,0,3,57,65,4,4,2,5,2,82
2020-01-20,경기,울산,44,1,1,9,13,1,69,35,0,6,26,62,1,130
2020-01-20,경기,전남,846,16,119,131,143,27,1282,715,19,80,137,116,20,1087
2020-01-20,경기,전북,1439,47,171,122,186,44,2009,1401,43,133,152,197,53,1979
2020-01-20,경기,충남,40688,1522,2865,2480,4810,2089,54454,37311,1490,2742,2361,4629,1986,50519
2020-01-20,경기,충북,31788,2281,3070,3126,3545,1564,45374,29277,2179,2970,2793,3803,1398,42420
2020-01-20,경남,강원,108,0,7,14,7,3,139,221,2,6,10,15,7,261
2020-01-20,경남,경기,1778,53,271,436,363,59,2960,2631,88,311,417,373,90,3910
2020-01-20,경남,경남,204655,10448,10416,7931,13283,15561,262294,204655,10448,10416,7931,13283,15561,262294
2020-01-20,경남,경북,11251,617,1012,870,1897,510,16157,13559,898,1221,1149,2587,664,20078
2020-01-20,경남,광주,1140,51,133,160,141,23,1648,1229,41,139,150,96,31,1686
2020-01-20,경남,대구,14365,768,945,987,1697,614,19376,11821,543,726,396,432,523,14441
2020-01-20,경남,대전,652,22,93,61,31,28,887,1002,25,101,91,52,48,1319
2020-01-20,경남,부산,90993,2785,2912,1639,5024,6499,109852,92591,2836,3122,1798,5185,6661,112193
2020-01-20,경남,서울,1473,50,451,234,126,52,2386,2243,43,452,104,68,71,2981
2020-01-20,경남,세종,159,1,8,8,8,6,190,292,3,22,8,13,10,348
2020-01-20,경남,울산,10941,680,783,513,647,698,14262,10012,616,811,444,658,628,13169
2020-01-20,경남,전남,6340,278,488,559,1430,261,9356,5971,278,448,445,1441,226,8809
2020-01-20,경남,전북,1233,38,126,87,171,40,1695,1271,39,126,96,150,28,1710
2020-01-20,경남,충남,1209,43,134,237,237,35,1895,1605,45,148,248,417,51,2514
2020-01-20,경남,충북,1158,45,140,239,275,30,1887,1426,83,199,369,530,49,2656
2020-01-20,경북,강원,447,16,35,21,24,29,572,518,19,44,16,27,15,639
2020-01-20,경북,경기,4156,182,475,811,552,153,6329,4660,187,487,633,524,147,6638
2020-01-20,경북,경남,13559,898,1221,1149,2587,664,20078,11251,617,1012,870,1897,510,16157
2020-01-20,경북,경북,77749,3864,4386,2917,5134,4304,98354,77749,3864,4386,2917,5134,4304,98354
2020-01-20,경북,광주,874,52,140,203,117,14,1400,955,41,105,172,89,17,1379
2020-01-20,경북,대구,75435,2950,2957,1555,2889,4176,89962,81532,3127,3334,2039,3413,4336,97781
2020-01-20,경북,대전,1780,48,115,108,78,71,2200,2047,41,115,103,66,76,2448
2020-01-20,경북,부산,4395,115,321,209,719,214,5973,5304,131,335,223,771,223,6987
2020-01-20,경북,서울,2653,93,365,333,109,86,3639,2808,79,325,186,75,87,3560
2020-01-20,경북,세종,277,8,18,19,13,14,349,333,7,22,12,9,8,391
2020-01-20,경북,울산,5529,177,372,465,1120,330,7993,5284,162,368,346,1344,326,7830
2020-01-20,경북,전남,1074,36,80,152,471,32,1845,1088,40,96,103,615,35,1977
2020-01-20,경북,전북,1899,90,207,165,256,61,2678,1663,74,182,168,232,59,2378
2020-01-20,경북,충남,3332,156,407,592,639,136,5262,3516,144,369,477,708,138,5352
2020-01-20,경북,충북,5412,242,521,702,901,233,8011,5369,246,541,620,899,230,7905
2020-01-20,광주,강원,74,2,15,15,8,3,117,86,1,21,8,8,4,128
2020-01-20,광주,경기,806,22,148,254,127,20,1377,878,36,190,267,119,16,1506
2020-01-20,광주,경남,1229,41,139,150,96,31,1686,1140,51,133,160,141,23,1648
2020-01-20,광주,경북,955,41,105,172,89,17,1379,874,52,140,203,117,14,1400
2020-01-20,광주,광주,13454,469,651,428,403,562,15967,13454,469,651,428,403,562,15967
2020-01-20,광주,대구,637,23,72,95,41,15,883,702,28,101,70,33,24,958
2020-01-20,광주,대전,441,16,14,29,13,19,532,553,18,26,28,17,19,661
2020-01-20,광주,부산,389,7,46,31,82,11,566,491,16,56,48,92,8,711
2020-01-20,광주,서울,619,14,14,66,21,14,748,795,20,25,27,26,14,907
2020-01-20,광주,세종,180,1,8,4,0,2,195,192,4,9,6,0,2,213
2020-01-20,광주,울산,49,0,14,3,5,3,74,43,0,11,5,12,1,72
2020-01-20,광주,전남,36309,991,1240,923,2092,1410,42965,32958,956,1051,797,2060,1361,39183
2020-01-20,광주,전북,8759,409,523,349,372,283,10695,8411,440,500,329,378,300,10358
2020-01-20,광주,충남,4345,104,572,475,278,100,5874,4223,111,570,516,331,105,5856
2020-01-20,광주,충북,632,31,82,138,87,24,994,607,38,91,164,98,21,1019
2020-01-20,대구,강원,306,6,21,20,16,12,381,263,5,5,12,12,7,304
2020-01-20,대구,경기,2942,94,229,345,406,84,4100,2134,83,207,279,154,63,2920
2020-01-20,대구,경남,11821,543,726,396,432,523,14441,14365,768,945,987,1697,614,19376
2020-01-20,대구,경북,81532,3127,3334,2039,3413,4336,97781,75435,2950,2957,1555,2889,4176,89962
2020-01-20,대구,광주,702,28,101,70,33,24,958,637,23,72,95,41,15,883
2020-01-20,대구,대구,64451,2266,1723,874,1364,4221,74899,64451,2266,1723,874,1364,4221,74899
2020-01-20,대구,대전,1003,32,54,62,26,25,1202,676,22,36,48,17,29,828
2020-01-20,대구,부산,711,64,94,51,144,25,1089,3267,113,214,89,218,148,4049
2020-01-20,대구,서울,2313,72,214,163,93,65,2920,1720,39,132,82,30,52,2055
2020-01-20,대구,세종,296,2,12,5,9,3,327,195,1,6,4,2,6,214
2020-01-20,대구,울산,1580,61,142,80,199,54,2116,1308,70,139,76,200,59,1852
2020-01-20,대구,전남,548,16,48,35,63,19,729,487,23,41,50,82,17,700
2020-01-20,대구,전북,446,9,38,28,23,11,555,377,9,37,27,11,10,471
2020-01-20,대구,충남,1797,73,155,194,312,53,2584,1048,57,115,145,133,27,1525
2020-01-20,대구,충북,2107,83,191,243,402,72,3098,1409,82,152,167,131,46,1987
2020-01-20,대전,강원,213,4,33,5,0,12,267,166,0,30,4,1,9,210
2020-01-20,대전,경기,2624,118,198,122,65,120,3247,2235,106,202,100,48,96,2787
2020-01-20,대전,경남,1002,25,101,91,52,48,1319,652,22,93,61,31,28,887
2020-01-20,대전,경북,2047,41,115,103,66,76,2448,1780,48,115,108,78,71,2200
2020-01-20,대전,광주,553,18,26,28,17,19,661,441,16,14,29,13,19,532
2020-01-20,대전,대구,676,22,36,48,17,29,828,1003,32,54,62,26,25,1202
2020-01-20,대전,대전,14447,415,447,436,278,1084,17107,14447,415,447,436,278,1084,17107
2020-01-20,대전,부산,75,4,9,8,14,3,113,73,6,10,9,12,1,111
2020-01-20,대전,서울,1922,38,216,41,12,82,2311,1820,50,203,31,7,76,2187
2020-01-20,대전,세종,3701,104,92,31,57,305,4290,3715,114,89,37,63,302,4320
2020-01-20,대전,울산,90,2,12,18,25,6,153,78,3,12,3,31,3,130
2020-01-20,대전,전남,312,8,9,29,23,11,392,280,6,15,34,30,13,378
2020-01-20,대전,전북,3558,91,95,75,37,148,4004,3225,101,84,86,53,152,3701
2020-01-20,대전,충남,17930,480,562,266,322,1323,20883,15190,460,525,274,288,1179,17916
2020-01-20,대전,충북,12156,458,505,217,160,921,14417,10403,386,415,182,144,784,12314
2020-01-20,부산,강원,1,0,1,1,0,0,3,7,0,0,2,3,0,12
2020-01-20,부산,경기,276,17,25,109,196,7,630,192,11,20,92,105,4,424
2020-01-20,부산,경남,92591,2836,3122,1798,5185,6661,112193,90993,2785,2912,1639,5024,6499,109852
2020-01-20,부산,경북,5304,131,335,223,771,223,6987,4395,115,321,209,719,214,5973
2020-01-20,부산,광주,491,16,56,48,92,8,711,389,7,46,31,82,11,566
2020-01-20,부산,대구,3267,113,214,89,218,148,4049,711,64,94,51,144,25,1089
2020-01-20,부산,대전,73,6,10,9,12,1,111,75,4,9,8,14,3,113
2020-01-20,부산,부산,41433,717,689,714,2174,2987,48714,41433,717,689,714,2174,2987,48714
2020-01-20,부산,서울,181,12,15,42,44,6,300,142,4,10,33,26,3,218
2020-01-20,부산,세종,17,0,0,5,2,0,24,15,0,0,0,2,0,17
2020-01-20,부산,울산,17769,399,500,653,2554,1246,23121,16409,397,444,410,2496,1210,21366
2020-01-20,부산,전남,2155,93,162,228,659,80,3377,1772,75,140,172,660,52,2871
2020-01-20,부산,전북,355,9,31,38,81,13,527,313,8,28,34,77,10,470
2020-01-20,부산,충남,193,12,21,66,119,5,416,132,6,18,49,155,2,362
2020-01-20,부산,충북,139,8,26,74,158,9,414,105,14,18,87,162,2,388
2020-01-20,서울,강원,697,9,233,8,9,28,984,662,9,279,10,30,25,1015
2020-01-20,서울,경기,152788,6915,9313,4929,3116,10283,187344,147289,7370,9618,4966,3390,10088,182721
2020-01-20,서울,경남,2243,43,452,104,68,71,2981,1473,50,451,234,126,52,2386
2020-01-20,서울,경북,2808,79,325,186,75,87,3560,2653,93,365,333,109,86,3639
2020-01-20,서울,광주,795,20,25,27,26,14,907,619,14,14,66,21,14,748
2020-01-20,서울,대구,1720,39,132,82,30,52,2055,2313,72,214,163,93,65,2920
2020-01-20,서울,대전,1820,50,203,31,7,76,2187,1922,38,216,41,12,82,2311
2020-01-20,서울,부산,142,4,10,33,26,3,218,181,12,15,42,44,6,300
2020-01-20,서울,서울,205,2,11,2,3,9,232,205,2,11,2,3,9,232
2020-01-20,서울,세종,42,0,3,0,0,1,46,49,0,2,0,0,4,55
2020-01-20,서울,울산,28,0,3,2,2,2,37,24,0,2,2,15,2,45
2020-01-20,서울,전남,876,16,15,43,32,26,1008,788,8,19,65,57,16,953
2020-01-20,서울,전북,1351,22,51,23,17,39,1503,1199,22,50,37,27,37,1372
2020-01-20,서울,충남,27646,532,2406,745,731,1101,33161,25198,585,2499,1280,1198,931,31691
2020-01-20,서울,충북,15917,586,1158,709,631,627,19628,13609,697,1244,761,791,533,17635
2020-01-20,세종,강원,7,0,0,2,1,0,10,7,0,1,0,1,0,9
2020-01-20,세종,경기,65,4,4,2,5,2,82,42,3,4,5,0,3,57
2020-01-20,세종,경남,292,3,22,8,13,10,348,159,1,8,8,8,6,190
2020-01-20,세종,경북,333,7,22,12,9,8,391,277,8,18,19,13,14,349
2020-01-20,세종,광주,192,4,9,6,0,2,213,180,1,8,4,0,2,195
2020-01-20,세종,대구,195,1,6,4,2,6,214,296,2,12,5,9,3,327
2020-01-20,세종,대전,3715,114,89,37,63,302,4320,3701,104,92,31,57,305,4290
2020-01-20,세종,부산,15,0,0,0,2,0,17,17,0,0,5,2,0,24
2020-01-20,세종,서울,49,0,2,0,0,4,55,42,0,3,0,0,1,46
2020-01-20,세종,세종,278,28,2,2,2,28,340,278,28,2,2,2,28,340
2020-01-20,세종,울산,6,0,0,4,1,0,11,13,0,0,2,4,0,19
2020-01-20,세종,전남,196,3,6,11,13,3,232,164,1,3,4,18,2,192
2020-01-20,세종,전북,822,23,22,11,30,26,934,712,16,20,21,51,26,846
2020-01-20,세종,충남,6590,169,179,124,186,382,7630,4467,148,132,119,140,232,5238
2020-01-20,세종,충북,362,10,26,18,13,20,449,298,18,27,13,13,26,395
2020-01-20,울산,강원,1,0,0,0,1,0,2,2,0,1,0,0,0,3
2020-01-20,울산,경기,35,0,6,26,62,1,130,44,1,1,9,13,1,69
2020-01-20,울산,경남,10012,616,811,444,658,628,13169,10941,680,783,513,647,698,14262
2020-01-20,울산,경북,5284,162,368,346,1344,326,7830,5529,177,372,465,1120,330,7993
2020-01-20,울산,광주,43,0,11,5,12,1,72,49,0,14,3,5,3,74
2020-01-20,울산,대구,1308,70,139,76,200,59,1852,1580,61,142,80,199,54,2116
2020-01-20,울산,대전,78,3,12,3,31,3,130,90,2,12,18,25,6,153
2020-01-20,울산,부산,16409,397,444,410,2496,1210,21366,17769,399,500,653,2554,1246,23121
2020-01-20,울산,서울,24,0,2,2,15,2,45,28,0,3,2,2,2,37
2020-01-20,울산,세종,13,0,0,2,4,0,19,6,0,0,4,1,0,11
2020-01-20,울산,울산,8531,338,582,311,565,785,11112,8531,338,582,311,565,785,11112
2020-01-20,울산,전남,201,9,16,19,44,5,294,202,12,20,14,61,2,311
2020-01-20,울산,전북,52,1,8,2,14,1,78,34,0,6,3,3,1,47
2020-01-20,울산,충남,118,5,18,54,137,4,336,109,2,13,24,111,4,263
2020-01-20,울산,충북,16,0,4,16,33,1,70,19,1,4,11,43,0,78
2020-01-20,전남,강원,45,1,6,6,21,2,81,52,0,2,2,8,0,64
2020-01-20,전남,경기,715,19,80,137,116,20,1087,846,16,119,131,143,27,1282
2020-01-20,전남,경남,5971,278,448,445,1441,226,8809,6340,278,488,559,1430,261,9356
2020-01-20,전남,경북,1088,40,96,103,615,35,1977,1074,36,80,152,471,32,1845
2020-01-20,전남,광주,32958,956,1051,797,2060,1361,39183,36309,991,1240,923,2092,1410,42965
2020-01-20,전남,대구,487,23,41,50,82,17,700,548,16,48,35,63,19,729
2020-01-20,전남,대전,280,6,15,34,30,13,378,312,8,9,29,23,11,392
2020-01-20,전남,부산,1772,75,140,172,660,52,2871,2155,93,162,228,659,80,3377
2020-01-20,전남,서울,788,8,19,65,57,16,953,876,16,15,43,32,26,1008
2020-01-20,전남,세종,164,1,3,4,18,2,192,196,3,6,11,13,3,232
2020-01-20,전남,울산,202,12,20,14,61,2,311,201,9,16,19,44,5,294
2020-01-20,전남,전남,46992,1409,1604,1844,5055,1940,58844,46992,1409,1604,1844,5055,1940,58844
2020-01-20,전남,전북,5042,255,464,588,1375,160,7884,5278,229,467,609,1374,151,8108
2020-01-20,전남,충남,4041,108,434,763,1281,97,6724,4312,79,489,481,1039,120,6520
2020-01-20,전남,충북,391,20,24,104,259,12,810,373,16,47,104,254,10,804
2020-01-20,전북,강원,161,6,11,20,16,6,220,133,3,13,13,9,4,175
2020-01-20,전북,경기,1401,43,133,152,197,53,1979,1439,47,171,122,186,44,2009
2020-01-20,전북,경남,1271,39,126,96,150,28,1710,1233,38,126,87,171,40,1695
2020-01-20,전북,경북,1663,74,182,168,232,59,2378,1899,90,207,165,256,61,2678
2020-01-20,전북,광주,8411,440,500,329,378,300,10358,8759,409,523,349,372,283,10695
2020-01-20,전북,대구,377,9,37,27,11,10,471,446,9,38,28,23,11,555
2020-01-20,전북,대전,3225,101,84,86,53,152,3701,3558,91,95,75,37,148,4004
2020-01-20,전북,부산,313,8,28,34,77,10,470,355,9,31,38,81,13,527
2020-01-20,전북,서울,1199,22,50,37,27,37,1372,1351,22,51,23,17,39,1503
2020-01-20,전북,세종,712,16,20,21,51,26,846,822,23,22,11,30,26,934
2020-01-20,전북,울산,34,0,6,3,3,1,47,52,1,8,2,14,1,78
2020-01-20,전북,전남,5278,229,467,609,1374,151,8108,5042,255,464,588,1375,160,7884
2020-01-20,전북,전북,17142,596,935,687,731,600,20691,17142,596,935,687,731,600,20691
2020-01-20,전북,충남,14043,515,1590,1148,1416,506,19218,14062,517,1629,911,1369,502,18990
2020-01-20,전북,충북,1933,123,188,322,263,71,2900,1769,117,231,301,265,69,2752
2020-01-20,충남,강원,436,11,29,27,75,15,593,379,11,18,17,36,18,479
2020-01-20,충남,경기,37311,1490,2742,2361,4629,1986,50519,40688,1522,2865,2480,4810,2089,54454
2020-01-20,충남,경남,1605,45,148,248,417,51,2514,1209,43,134,237,237,35,1895
2020-01-20,충남,경북,3516,144,369,477,708,138,5352,3332,156,407,592,639,136,5262
2020-01-20,충남,광주,4223,111,570,516,331,105,5856,4345,104,572,475,278,100,5874
2020-01-20,충남,대구,1048,57,115,145,133,27,1525,1797,73,155,194,312,53,2584
2020-01-20,충남,대전,15190,460,525,274,288,1179,17916,17930,480,562,266,322,1323,20883
2020-01-20,충남,부산,132,6,18,49,155,2,362,193,12,21,66,119,5,416
2020-01-20,충남,서울,25198,585,2499,1280,1198,931,31691,27646,532,2406,745,731,1101,33161
2020-01-20,충남,세종,4467,148,132,119,140,232,5238,6590,169,179,124,186,382,7630
2020-01-20,충남,울산,109,2,13,24,111,4,263,118,5,18,54,137,4,336
2020-01-20,충남,전남,4312,79,489,481,1039,120,6520,4041,108,434,763,1281,97,6724
2020-01-20,충남,전북,14062,517,1629,911,1369,502,18990,14043,515,1590,1148,1416,506,19218
2020-01-20,충남,충남,101088,3579,8303,6803,10689,4860,135322,101088,3579,8303,6803,10689,4860,135322
2020-01-20,충남,충북,14542,685,949,962,1347,828,19313,13467,650,906,878,1360,742,18003
2020-01-20,충북,강원,5048,215,301,196,311,316,6387,5000,224,291,258,386,306,6465
2020-01-20,충북,경기,29277,2179,2970,2793,3803,1398,42420,31788,2281,3070,3126,3545,1564,45374
2020-01-20,충북,경남,1426,83,199,369,530,49,2656,1158,45,140,239,275,30,1887
2020-01-20,충북,경북,5369,246,541,620,899,230,7905,5412,242,521,702,901,233,8011
2020-01-20,충북,광주,607,38,91,164,98,21,1019,632,31,82,138,87,24,994
2020-01-20,충북,대구,1409,82,152,167,131,46,1987,2107,83,191,243,402,72,3098
2020-01-20,충북,대전,10403,386,415,182,144,784,12314,12156,458,505,217,160,921,14417
2020-01-20,충북,부산,105,14,18,87,162,2,388,139,8,26,74,158,9,414
2020-01-20,충북,서울,13609,697,1244,761,791,533,17635,15917,586,1158,709,631,627,19628
2020-01-20,충북,세종,298,18,27,13,13,26,395,362,10,26,18,13,20,449
2020-01-20,충북,울산,19,1,4,11,43,0,78,16,0,4,16,33,1,70
2020-01-20,충북,전남,373,16,47,104,254,10,804,391,20,24,104,259,12,810
2020-01-20,충북,전북,1769,117,231,301,265,69,2752,1933,123,188,322,263,71,2900
2020-01-20,충북,충남,13467,650,906,878,1360,742,18003,14542,685,949,962,1347,828,19313
2020-01-20,충북,충북,37878,1990,2365,2230,2904,2286,49653,37878,1990,2365,2230,2904,2286,49653
2020-01-21,강원,강원,65806,2445,3349,1435,2550,4498,80083,65806,2445,3349,1435,2550,4498,80083
2020-01-21,강원,경기,18171,666,1390,723,851,920,22721,18025,756,1385,792,994,959,22911
2020-01-21,강원,경남,172,1,10,16,25,6,230,113,2,5,25,12,3,160
2020-01-21,강원,경북,541,18,40,20,30,14,663,417,17,32,31,31,18,546
2020-01-21,강원,광주,77,2,18,10,12,1,120,60,2,15,21,9,5,112
2020-01-21,강원,대구,269,6,13,13,9,4,314,273,11,27,21,14,6,352
2020-01-21,강원,대전,197,4,29,5,1,7,243,190,9,27,7,4,10,247
2020-01-21,강원,부산,2,0,0,0,3,0,5,2,0,0,0,6,0,8
2020-01-21,강원,서울,660,16,264,9,22,28,999,712,28,259,12,15,23,1049
2020-01-21,강원,세종,2,0,0,0,1,0,3,11,0,0,0,2,0,13
2020-01-21,강원,울산,0,0,0,0,0,0,0,1,0,0,0,0,0,1
2020-01-21,강원,전남,29,1,3,3,12,0,48,44,2,0,3,24,1,74
2020-01-21,강원,전북,124,7,17,11,20,3,182,139,4,19,23,26,7,218
2020-01-21,강원,충남,334,7,27,26,43,14,451,413,16,32,56,100,16,633
2020-01-21,강원,충북,4980,222,340,247,384,294,6467,5184,230,342,251,345,285,6637
2020-01-21,경기,강원,18025,756,1385,792,994,959,22911,18171,666,1390,723,851,920,22721
2020-01-21,경기,경기,443720,24453,26501,21462,26432,33572,576140,443720,24453,26501,21462,26432,33572,576140
2020-01-21,경기,경남,2651,142,358,934,626,79,4790,1851,88,273,625,487,58,3382
2020-01-21,경기,경북,4436,217,551,862,606,121,6793,4161,219,528,1005,637,115,6665
2020-01-21,경기,광주,896,39,201,378,205,17,1736,787,29,153,320,146,23,1458
2020-01-21,경기,대구,2259,129,248,443,227,68,3374,2849,136,226,574,549,89,4423
2020-01-21,경기,대전,1987,93,218,137,55,96,2586,2077,121,190,135,52,104,2679
2020-01-21,경기,부산,219,30,45,225,196,8,723,221,18,36,174,335,6,790
2020-01-21,경기,서울,150180,7758,9418,5721,4019,10100,187196,150609,7324,9754,5407,3570,10146,186810
2020-01-21,경기,세종,47,2,3,5,4,1,62,67,2,2,0,1,6,78
2020-01-21,경기,울산,30,2,5,10,19,0,66,37,2,12,46,88,1,186
2020-01-21,경기,전남,836,19,125,190,178,16,1364,843,23,103,173,136,33,1311
2020-01-21,경기,전북,1359,60,197,137,221,40,2014,1344,55,166,195,216,47,2023
2020-01-21,경기,충남,38636,1639,2941,2839,5178,1957,53190,38863,1608,2917,2653,4843,1955,52839
2020-01-21,경기,충북,28679,2360,3250,3559,3690,1350,42888,27998,2247,3076,3077,3932,1363,41693
2020-01-21,경남,강원,113,2,5,25,12,3,160,172,1,10,16,25,6,230
2020-01-21,경남,경기,1851,88,273,625,487,58,3382,2651,142,358,934,626,79,4790
2020-01-21,경남,경남,205682,11235,11069,9157,14555,15298,266996,205682,11235,11069,9157,14555,15298,266996
2020-01-21,경남,경북,10323,675,1098,955,1886,501,15438,13254,959,1379,1406,2762,565,20325
2020-01-21,경남,광주,1119,50,145,201,176,29,1720,1061,47,152,166,123,25,1574
2020-01-21,경남,대구,14180,830,1131,1242,1997,555,19935,11413,558,824,504,471,527,14297
2020-01-21,경남,대전,715,28,97,93,48,35,1016,962,38,130,135,67,43,1375
2020-01-21,경남,부산,93346,2915,3081,2044,5325,6551,113262,95718,3096,3289,2165,5722,6907,116897
2020-01-21,경남,서울,1602,50,460,318,129,50,2609,2317,58,485,252,135,60,3307
2020-01-21,경남,세종,225,1,14,10,12,9,271,310,3,22,15,9,12,371
2020-01-21,경남,울산,10541,658,772,494,634,624,13723,9905,615,823,459,678,607,13087
2020-01-21,경남,전남,5917,301,529,539,1561,275,9122,6202,301,536,436,1563,253,9291
2020-01-21,경남,전북,1184,45,129,108,215,38,1719,1166,47,160,123,213,39,1748
2020-01-21,경남,충남,1250,56,175,278,275,30,2064,1716,74,189,363,645,44,3031
2020-01-21,경남,충북,1054,53,191,325,299,34,1956,1446,88,245,557,616,49,3001
2020-01-21,경북,강원,417,17,32,31,31,18,546,541,18,40,20,30,14,663
2020-01-21,경북,경기,4161,219,528,1005,637,115,6665,4436,217,551,862,606,121,6793
2020-01-21,경북,경남,13254,959,1379,1406,2762,565,20325,10323,675,1098,955,1886,501,15438
2020-01-21,경북,경북,78719,4230,4738,3119,5397,4369,100572,78719,4230,4738,3119,5397,4369,100572
2020-01-21,경북,광주,797,57,129,195,154,12,1344,736,53,105,194,113,19,1220
2020-01-21,경북,대구,77767,3107,3088,1771,3160,4149,93042,80335,3250,3486,2230,3638,4264,97203
2020-01-21,경북,대전,1825,67,138,131,89,70,2320,1828,57,117,145,81,70,2298
2020-01-21,경북,부산,4197,139,331,246,816,195,5924,4471,146,383,275,869,211,6355
2020-01-21,경북,서울,2484,133,374,423,147,74,3635,2863,89,345,268,110,71,3746
2020-01-21,경북,세종,321,2,23,25,15,6,392,333,8,18,21,9,12,401
2020-01-21,경북,울산,5233,191,397,489,1152,308,7770,5099,180,378,388,1410,292,7747
2020-01-21,경북,전남,994,52,74,162,512,29,1823,955,52,104,137,648,32,1928
2020-01-21,경북,전북,1849,107,206,206,286,68,2722,1577,106,180,164,269,51,2347
2020-01-21,경북,충남,3183,158,418,631,630,116,5136,3517,171,399,570,776,115,5548
2020-01-21,경북,충북,5414,237,559,762,973,193,8138,5213,256,585,731,1021,189,7995
2020-01-21,광주,강원,60,2,15,21,9,5,112,77,2,18,10,12,1,120
2020-01-21,광주,경기,787,29,153,320,146,23,1458,896,39,201,378,205,17,1736
2020-01-21,광주,경남,1061,47,152,166,123,25,1574,1119,50,145,201,176,29,1720
2020-01-21,광주,경북,736,53,105,194,113,19,1220,797,57,129,195,154,12,1344
2020-01-21,광주,광주,14144,569,647,438,440,628,16866,14144,569,647,438,440,628,16866
2020-01-21,광주,대구,628,41,102,92,36,7,906,663,36,114,79,44,12,948
2020-01-21,광주,대전,513,22,18,31,24,17,625,553,20,19,47,19,11,669
2020-01-21,광주,부산,433,13,39,45,80,9,619,451,26,49,99,141,14,780
2020-01-21,광주,서울,600,27,29,72,29,19,776,836,30,31,63,21,26,1007
2020-01-21,광주,세종,148,2,7,6,3,3,169,219,5,8,6,2,3,243
2020-01-21,광주,울산,52,1,8,1,7,2,71,46,5,11,4,9,0,75
2020-01-21,광주,전남,35523,1031,1294,942,2383,1366,42539,34605,1037,1122,868,2324,1357,41313
2020-01-21,광주,전북,8232,446,577,405,379,310,10349,8460,487,548,358,398,311,10562
2020-01-21,광주,충남,3892,127,583,524,290,94,5510,4260,144,592,712,371,98,6177
2020-01-21,광주,충북,539,26,66,118,73,12,834,652,32,85,181,104,16,1070
2020-01-21,대구,강원,273,11,27,21,14,6,352,269,6,13,13,9,4,314
2020-01-21,대구,경기,2849,136,226,574,549,89,4423,2259,129,248,443,227,68,3374
2020-01-21,대구,경남,11413,558,824,504,471,527,14297,14180,830,1131,1242,1997,555,19935
2020-01-21,대구,경북,80335,3250,3486,2230,3638,4264,97203,77767,3107,3088,1771,3160,4149,93042
2020-01-21,대구,광주,663,36,114,79,44,12,948,628,41,102,92,36,7,906
2020-01-21,대구,대구,64875,2272,1975,918,1131,4164,75335,64875,2272,1975,918,1131,4164,75335
2020-01-21,대구,대전,951,48,64,101,33,36,1233,730,26,34,64,23,21,898
2020-01-21,대구,부산,631,63,117,66,179,28,1084,2914,111,249,104,295,130,3803
2020-01-21,대구,서울,2150,87,220,312,174,61,3004,1732,57,157,151,78,36,2211
2020-01-21,대구,세종,282,2,15,7,14,4,324,199,3,6,5,2,4,219
2020-01-21,대구,울산,1376,59,161,97,176,54,1923,1265,54,155,79,227,50,1830
2020-01-21,대구,전남,480,13,47,38,67,11,656,544,21,42,43,75,14,739
2020-01-21,대구,전북,400,16,44,21,21,15,517,371,14,50,19,27,4,485
2020-01-21,대구,충남,1563,90,158,217,305,39,2372,1263,75,129,188,178,35,1868
2020-01-21,대구,충북,1840,120,243,297,456,55,3011,1400,85,166,255,124,45,2075
2020-01-21,대전,강원,190,9,27,7,4,10,247,197,4,29,5,1,7,243
2020-01-21,대전,경기,2077,121,190,135,52,104,2679,1987,93,218,137,55,96,2586
2020-01-21,대전,경남,962,38,130,135,67,43,1375,715,28,97,93,48,35,1016
2020-01-21,대전,경북,1828,57,117,145,81,70,2298,1825,67,138,131,89,70,2320
2020-01-21,대전,광주,553,20,19,47,19,11,669,513,22,18,31,24,17,625
2020-01-21,대전,대구,730,26,34,64,23,21,898,951,48,64,101,33,36,1233
2020-01-21,대전,대전,14763,464,458,570,357,1166,17778,14763,464,458,570,357,1166,17778
2020-01-21,대전,부산,64,2,8,22,29,2,127,84,2,5,21,25,0,137
2020-01-21,대전,서울,1685,52,209,60,9,82,2097,1720,46,203,40,17,80,2106
2020-01-21,대전,세종,3725,119,72,41,37,322,4316,3711,99,82,43,50,300,4285
2020-01-21,대전,울산,89,5,11,25,24,1,155,102,5,12,7,29,2,157
2020-01-21,대전,전남,267,6,5,37,29,8,352,324,8,11,38,22,12,415
2020-01-21,대전,전북,3362,73,90,105,50,155,3835,3429,99,81,86,51,156,3902
2020-01-21,대전,충남,17558,520,580,308,340,1325,20631,16042,510,534,299,288,1217,18890
2020-01-21,대전,충북,11671,480,472,234,155,863,13875,10557,434,446,172,152,794,12555
2020-01-21,부산,강원,2,0,0,0,6,0,8,2,0,0,0,3,0,5
2020-01-21,부산,경기,221,18,36,174,335,6,790,219,30,45,225,196,8,723
2020-01-21,부산,경남,95718,3096,3289,2165,5722,6907,116897,93346,2915,3081,2044,5325,6551,113262
2020-01-21,부산,경북,4471,146,383,275,869,211,6355,4197,139,331,246,816,195,5924
2020-01-21,부산,광주,451,26,49,99,141,14,780,433,13,39,45,80,9,619
2020-01-21,부산,대구,2914,111,249,104,295,130,3803,631,63,117,66,179,28,1084
2020-01-21,부산,대전,84,2,5,21,25,0,137,64,2,8,22,29,2,127
2020-01-21,부산,부산,42115,816,701,1074,2309,3087,50102,42115,816,701,1074,2309,3087,50102
2020-01-21,부산,서울,177,14,20,84,92,4,391,192,11,12,76,42,7,340
2020-01-21,부산,세종,15,0,1,3,2,0,21,17,0,0,2,1,0,20
2020-01-21,부산,울산,16923,423,517,706,2860,1163,22592,17116,445,449,459,2623,1231,22323
2020-01-21,부산,전남,1987,94,169,203,668,63,3184,1891,91,145,160,629,66,2982
2020-01-21,부산,전북,355,17,41,38,113,10,574,277,14,35,33,82,12,453
2020-01-21,부산,충남,151,20,23,78,170,5,447,177,11,24,91,242,3,548
2020-01-21,부산,충북,118,14,24,90,211,4,461,108,16,22,141,206,0,493
2020-01-21,서울,강원,712,28,259,12,15,23,1049,660,16,264,9,22,28,999
2020-01-21,서울,경기,150609,7324,9754,5407,3570,10146,186810,150180,7758,9418,5721,4019,10100,187196
2020-01-21,서울,경남,2317,58,485,252,135,60,3307,1602,50,460,318,129,50,2609
2020-01-21,서울,경북,2863,89,345,268,110,71,3746,2484,133,374,423,147,74,3635
2020-01-21,서울,광주,836,30,31,63,21,26,1007,600,27,29,72,29,19,776
2020-01-21,서울,대구,1732,57,157,151,78,36,2211,2150,87,220,312,174,61,3004
2020-01-21,서울,대전,1720,46,203,40,17,80,2106,1685,52,209,60,9,82,2097
2020-01-21,서울,부산,192,11,12,76,42,7,340,177,14,20,84,92,4,391
2020-01-21,서울,서울,198,6,4,0,0,11,219,198,6,4,0,0,11,219
2020-01-21,서울,세종,49,0,0,1,0,1,51,42,1,0,0,0,4,47
2020-01-21,서울,울산,19,0,0,5,1,3,28,23,3,4,11,19,0,60
2020-01-21,서울,전남,902,12,31,40,54,28,1067,834,16,43,77,66,28,1064
2020-01-21,서울,전북,1329,24,64,28,27,47,1519,1156,28,62,42,28,28,1344
2020-01-21,서울,충남,25146,587,2362,921,851,930,30797,24656,712,2429,1552,1377,948,31674
2020-01-21,서울,충북,13779,587,1217,812,752,609,17756,13379,717,1207,911,870,539,17623
2020-01-21,세종,강원,11,0,0,0,2,0,13,2,0,0,0,1,0,3
2020-01-21,세종,경기,67,2,2,0,1,6,78,47,2,3,5,4,1,62
2020-01-21,세종,경남,310,3,22,15,9,12,371,225,1,14,10,12,9,271
2020-01-21,세종,경북,333,8,18,21,9,12,401,321,2,23,25,15,6,392
2020-01-21,세종,광주,219,5,8,6,2,3,243,148,2,7,6,3,3,169
2020-01-21,세종,대구,199,3,6,5,2,4,219,282,2,15,7,14,4,324
2020-01-21,세종,대전,3711,99,82,43,50,300,4285,3725,119,72,41,37,322,4316
2020-01-21,세종,부산,17,0,0,2,1,0,20,15,0,1,3,2,0,21
2020-01-21,세종,서울,42,1,0,0,0,4,47,49,0,0,1,0,1,51
2020-01-21,세종,세종,244,20,3,5,1,22,295,244,20,3,5,1,22,295
2020-01-21,세종,울산,11,0,1,2,2,0,16,11,0,1,1,7,1,21
2020-01-21,세종,전남,213,4,9,10,18,3,257,219,3,7,4,22,5,260
2020-01-21,세종,전북,773,15,26,21,43,32,910,706,16,28,15,39,20,824
2020-01-21,세종,충남,6136,166,189,122,197,343,7153,4785,142,170,134,167,248,5646
2020-01-21,세종,충북,365,14,18,15,10,21,443,320,10,22,13,21,22,408
2020-01-21,울산,강원,1,0,0,0,0,0,1,0,0,0,0,0,0,0
2020-01-21,울산,경기,37,2,12,46,88,1,186,30,2,5,10,19,0,66
2020-01-21,울산,경남,9905,615,823,459,678,607,13087,10541,658,772,494,634,624,13723
2020-01-21,울산,경북,5099,180,378,388,1410,292,7747,5233,191,397,489,1152,308,7770
2020-01-21,울산,광주,46,5,11,4,9,0,75,52,1,8,1,7,2,71
2020-01-21,울산,대구,1265,54,155,79,227,50,1830,1376,59,161,97,176,54,1923
2020-01-21,울산,대전,102,5,12,7,29,2,157,89,5,11,25,24,1,155
2020-01-21,울산,부산,17116,445,449,459,2623,1231,22323,16923,423,517,706,2860,1163,22592
2020-01-21,울산,서울,23,3,4,11,19,0,60,19,0,0,5,1,3,28
2020-01-21,울산,세종,11,0,1,1,7,1,21,11,0,1,2,2,0,16
2020-01-21,울산,울산,8802,332,620,324,670,766,11514,8802,332,620,324,670,766,11514
2020-01-21,울산,전남,155,14,23,19,27,5,243,179,20,27,19,49,6,300
2020-01-21,울산,전북,46,0,8,3,14,1,72,35,1,9,5,3,3,56
2020-01-21,울산,충남,134,6,17,55,152,3,367,124,9,19,43,132,8,335
2020-01-21,울산,충북,22,2,8,17,48,0,97,23,1,5,21,26,0,76
2020-01-21,전남,강원,44,2,0,3,24,1,74,29,1,3,3,12,0,48
2020-01-21,전남,경기,843,23,103,173,136,33,1311,836,19,125,190,178,16,1364
2020-01-21,전남,경남,6202,301,536,436,1563,253,9291,5917,301,529,539,1561,275,9122
2020-01-21,전남,경북,955,52,104,137,648,32,1928,994,52,74,162,512,29,1823
2020-01-21,전남,광주,34605,1037,1122,868,2324,1357,41313,35523,1031,1294,942,2383,1366,42539
2020-01-21,전남,대구,544,21,42,43,75,14,739,480,13,47,38,67,11,656
2020-01-21,전남,대전,324,8,11,38,22,12,415,267,6,5,37,29,8,352
2020-01-21,전남,부산,1891,91,145,160,629,66,2982,1987,94,169,203,668,63,3184
2020-01-21,전남,서울,834,16,43,77,66,28,1064,902,12,31,40,54,28,1067
2020-01-21,전남,세종,219,3,7,4,22,5,260,213,4,9,10,18,3,257
2020-01-21,전남,울산,179,20,27,19,49,6,300,155,14,23,19,27,5,243
2020-01-21,전남,전남,48713,1504,1846,2235,5453,2006,61757,48713,1504,1846,2235,5453,2006,61757
2020-01-21,전남,전북,5283,312,564,706,1491,154,8510,4846,270,524,625,1384,132,7781
2020-01-21,전남,충남,4247,115,498,883,1454,112,7309,4120,91,537,613,1214,105,6680
2020-01-21,전남,충북,425,26,48,110,302,5,916,362,17,45,129,313,8,874
2020-01-21,전북,강원,139,4,19,23,26,7,218,124,7,17,11,20,3,182
2020-01-21,전북,경기,1344,55,166,195,216,47,2023,1359,60,197,137,221,40,2014
2020-01-21,전북,경남,1166,47,160,123,213,39,1748,1184,45,129,108,215,38,1719
2020-01-21,전북,경북,1577,106,180,164,269,51,2347,1849,107,206,206,286,68,2722
2020-01-21,전북,광주,8460,487,548,358,398,311,10562,8232,446,577,405,379,310,10349
2020-01-21,전북,대구,371,14,50,19,27,4,485,400,16,44,21,21,15,517
2020-01-21,전북,대전,3429,99,81,86,51,156,3902,3362,73,90,105,50,155,3835
2020-01-21,전북,부산,277,14,35,33,82,12,453,355,17,41,38,113,10,574
2020-01-21,전북,서울,1156,28,62,42,28,28,1344,1329,24,64,28,27,47,1519
2020-01-21,전북,세종,706,16,28,15,39,20,824,773,15,26,21,43,32,910
2020-01-21,전북,울산,35,1,9,5,3,3,56,46,0,8,3,14,1,72
2020-01-21,전북,전남,4846,270,524,625,1384,132,7781,5283,312,564,706,1491,154,8510
2020-01-21,전북,전북,17632,711,990,951,848,696,21828,17632,711,990,951,848,696,21828
2020-01-21,전북,충남,13593,559,1624,1320,1455,456,19007,13774,524,1588,1092,1473,470,18921
2020-01-21,전북,충북,1823,125,222,312,279,79,2840,1830,131,228,307,302,68,2866
2020-01-21,충남,강원,413,16,32,56,100,16,633,334,7,27,26,43,14,451
2020-01-21,충남,경기,38863,1608,2917,2653,4843,1955,52839,38636,1639,2941,2839,5178,1957,53190
2020-01-21,충남,경남,1716,74,189,363,645,44,3031,1250,56,175,278,275,30,2064
2020-01-21,충남,경북,3517,171,399,570,776,115,5548,3183,158,418,631,630,116,5136
2020-01-21,충남,광주,4260,144,592,712,371,98,6177,3892,127,583,524,290,94,5510
2020-01-21,충남,대구,1263,75,129,188,178,35,1868,1563,90,158,217,305,39,2372
2020-01-21,충남,대전,16042,510,534,299,288,1217,18890,17558,520,580,308,340,1325,20631
2020-01-21,충남,부산,177,11,24,91,242,3,548,151,20,23,78,170,5,447
2020-01-21,충남,서울,24656,712,2429,1552,1377,948,31674,25146,587,2362,921,851,930,30797
2020-01-21,충남,세종,4785,142,170,134,167,248,5646,6136,166,189,122,197,343,7153
2020-01-21,충남,울산,124,9,19,43,132,8,335,134,6,17,55,152,3,367
2020-01-21,충남,전남,4120,91,537,613,1214,105,6680,4247,115,498,883,1454,112,7309
2020-01-21,충남,전북,13774,524,1588,1092,1473,470,18921,13593,559,1624,1320,1455,456,19007
2020-01-21,충남,충남,103199,3937,8839,8038,11138,4884,140035,103199,3937,8839,8038,11138,4884,140035
2020-01-21,충남,충북,14918,697,958,1058,1535,846,20012,13212,676,928,946,1419,726,17907
2020-01-21,충북,강원,5184,230,342,251,345,285,6637,4980,222,340,247,384,294,6467
2020-01-21,충북,경기,27998,2247,3076,3077,3932,1363,41693,28679,2360,3250,3559,3690,1350,42888
2020-01-21,충북,경남,1446,88,245,557,616,49,3001,1054,53,191,325,299,34,1956
2020-01-21,충북,경북,5213,256,585,731,1021,189,7995,5414,237,559,762,973,193,8138
2020-01-21,충북,광주,652,32,85,181,104,16,1070,539,26,66,118,73,12,834
2020-01-21,충북,대구,1400,85,166,255,124,45,2075,1840,120,243,297,456,55,3011
2020-01-21,충북,대전,10557,434,446,172,152,794,12555,11671,480,472,234,155,863,13875
2020-01-21,충북,부산,108,16,22,141,206,0,493,118,14,24,90,211,4,461
2020-01-21,충북,서울,13379,717,1207,911,870,539,17623,13779,587,1217,812,752,609,17756
2020-01-21,충북,세종,320,10,22,13,21,22,408,365,14,18,15,10,21,443
2020-01-21,충북,울산,23,1,5,21,26,0,76,22,2,8,17,48,0,97
2020-01-21,충북,전남,362,17,45,129,313,8,874,425,26,48,110,302,5,916
2020-01-21,충북,전북,1830,131,228,307,302,68,2866,1823,125,222,312,279,79,2840
2020-01-21,충북,충남,13212,676,928,946,1419,726,17907,14918,697,958,1058,1535,846,20012
2020-01-21,충북,충북,38699,2035,2478,2271,3117,2362,50962,38699,2035,2478,2271,3117,2362,50962
2020-01-22,강원,강원,65338,2245,3251,1324,2503,4538,79199,65338,2245,3251,1324,2503,4538,79199
2020-01-22,강원,경기,18918,639,1337,709,811,929,23343,18291,631,1261,717,872,961,22733
2020-01-22,강원,경남,244,1,15,23,22,9,314,123,3,7,21,11,2,167
2020-01-22,강원,경북,617,23,43,23,33,21,760,433,21,27,27,27,15,550
2020-01-22,강원,광주,171,1,26,12,9,6,225,80,2,15,6,4,2,109
2020-01-22,강원,대구,343,3,14,12,11,10,393,255,6,24,19,15,8,327
2020-01-22,강원,대전,229,3,31,4,2,8,277,147,5,30,2,1,4,189
2020-01-22,강원,부산,7,0,1,2,3,0,13,0,0,0,0,1,0,1
2020-01-22,강원,서울,652,15,290,18,21,23,1019,656,10,199,13,12,19,909
2020-01-22,강원,세종,3,1,0,0,0,0,4,7,1,0,1,0,0,9
2020-01-22,강원,울산,1,0,1,0,0,0,2,2,0,0,0,1,0,3
2020-01-22,강원,전남,79,0,1,7,10,1,98,79,1,7,6,31,0,124
2020-01-22,강원,전북,230,1,18,19,20,8,296,152,9,13,22,17,5,218
2020-01-22,강원,충남,371,9,31,20,35,9,475,416,4,24,44,70,27,585
2020-01-22,강원,충북,5264,233,327,241,397,324,6786,4858,208,278,225,282,282,6133
2020-01-22,경기,강원,18291,631,1261,717,872,961,22733,18918,639,1337,709,811,929,23343
2020-01-22,경기,경기,453518,24115,26099,21011,25468,33918,584129,453518,24115,26099,21011,25468,33918,584129
2020-01-22,경기,경남,4231,113,364,899,691,139,6437,2383,65,263,641,442,68,3862
2020-01-22,경기,경북,5287,193,571,840,658,184,7733,4654,197,509,984,608,143,7095
2020-01-22,경기,광주,1464,31,193,353,163,40,2244,829,24,150,290,128,21,1442
2020-01-22,경기,대구,3135,87,230,452,245,123,4272,3051,135,253,513,542,82,4576
2020-01-22,경기,대전,2674,104,218,128,52,118,3294,2153,113,195,105,50,91,2707
2020-01-22,경기,부산,281,15,36,218,180,13,743,321,19,35,173,312,10,870
2020-01-22,경기,서울,157072,7757,9915,5503,3876,10667,194790,149856,7252,9439,4844,3392,10067,184850
2020-01-22,경기,세종,40,4,4,6,3,2,59,74,4,3,6,3,3,93
2020-01-22,경기,울산,40,1,5,14,29,3,92,54,6,8,35,67,2,172
2020-01-22,경기,전남,1529,15,113,168,173,43,2041,1030,21,98,155,137,26,1467
2020-01-22,경기,전북,1932,56,161,144,222,70,2585,1459,60,169,182,206,52,2128
2020-01-22,경기,충남,41063,1607,2984,2617,4852,2087,55210,40597,1577,2874,2515,4564,2032,54159
2020-01-22,경기,충북,29348,2337,3131,3493,3673,1409,43391,29060,2218,3024,2984,3868,1338,42492
2020-01-22,경남,강원,123,3,7,21,11,2,167,244,1,15,23,22,9,314
2020-01-22,경남,경기,2383,65,263,641,442,68,3862,4231,113,364,899,691,139,6437
2020-01-22,경남,경남,207626,10480,10790,7871,14561,15428,266756,207626,10480,10790,7871,14561,15428,266756
2020-01-22,경남,경북,10266,650,1003,908,1916,435,15178,13631,909,1291,1311,2882,606,20630
2020-01-22,경남,광주,1247,56,143,202,131,35,1814,1055,50,161,157,101,32,1556
2020-01-22,경남,대구,14591,791,1089,1154,1896,587,20108,11257,572,834,475,535,466,14139
2020-01-22,경남,대전,853,22,93,71,45,32,1116,1056,24,99,116,69,45,1409
2020-01-22,경남,부산,93628,2785,3168,1990,5283,6437,113291,90612,2830,3215,1978,5424,6341,110400
2020-01-22,경남,서울,2020,56,467,298,153,79,3073,3320,51,487,189,160,89,4296
2020-01-22,경남,세종,215,1,14,8,7,7,252,355,4,20,10,21,14,424
2020-01-22,경남,울산,10561,692,734,527,680,614,13808,10009,596,792,475,719,552,13143
2020-01-22,경남,전남,5872,253,493,496,1530,233,8877,6740,301,500,451,1468,259,9719
2020-01-22,경남,전북,1247,34,138,99,180,37,1735,1310,35,126,116,177,37,1801
2020-01-22,경남,충남,1291,51,143,255,246,27,2013,2330,73,189,391,679,84,3746
2020-01-22,경남,충북,1130,60,154,295,289,41,1969,1670,76,261,550,708,62,3327
2020-01-22,경북,강원,433,21,27,27,27,15,550,617,23,43,23,33,21,760
2020-01-22,경북,경기,4654,197,509,984,608,143,7095,5287,193,571,840,658,184,7733
2020-01-22,경북,경남,13631,909,1291,1311,2882,606,20630,10266,650,1003,908,1916,435,15178
2020-01-22,경북,경북,78132,3943,4475,3068,5242,4242,99102,78132,3943,4475,3068,5242,4242,99102
2020-01-22,경북,광주,1003,52,126,205,167,22,1575,754,48,91,168,120,22,1203
2020-01-22,경북,대구,77573,3091,3056,1837,2740,4110,92407,78718,3191,3366,2234,3229,4199,94937
2020-01-22,경북,대전,1849,56,114,88,79,81,2267,1789,48,120,130,71,72,2230
2020-01-22,경북,부산,4491,111,308,197,746,200,6053,4250,113,361,201,937,197,6059
2020-01-22,경북,서울,2884,107,384,356,137,73,3941,3419,84,351,234,130,113,4331
2020-01-22,경북,세종,268,6,22,16,13,14,339,319,6,26,19,14,15,399
2020-01-22,경북,울산,5443,188,419,458,1199,311,8018,5174,186,384,366,1426,312,7848
2020-01-22,경북,전남,1031,40,87,121,507,35,1821,1102,42,84,87,609,36,1960
2020-01-22,경북,전북,1859,90,208,169,264,52,2642,1585,89,182,156,232,53,2297
2020-01-22,경북,충남,3268,154,386,569,674,104,5155,4033,168,392,498,830,128,6049
2020-01-22,경북,충북,5411,232,518,744,938,188,8031,5417,243,557,709,975,206,8107
2020-01-22,광주,강원,80,2,15,6,4,2,109,171,1,26,12,9,6,225
2020-01-22,광주,경기,829,24,150,290,128,21,1442,1464,31,193,353,163,40,2244
2020-01-22,광주,경남,1055,50,161,157,101,32,1556,1247,56,143,202,131,35,1814
2020-01-22,광주,경북,754,48,91,168,120,22,1203,1003,52,126,205,167,22,1575
2020-01-22,광주,광주,14080,501,626,370,250,591,16418,14080,501,626,370,250,591,16418
2020-01-22,광주,대구,749,26,99,87,24,20,1005,692,34,100,68,32,18,944
2020-01-22,광주,대전,435,18,13,37,18,17,538,514,22,13,29,18,12,608
2020-01-22,광주,부산,374,12,29,35,77,16,543,506,11,47,78,126,12,780
2020-01-22,광주,서울,705,18,21,71,28,19,862,1442,25,26,48,22,32,1595
2020-01-22,광주,세종,127,1,12,4,3,2,149,241,1,11,6,2,8,269
2020-01-22,광주,울산,49,0,8,2,8,2,69,76,0,13,5,10,1,105
2020-01-22,광주,전남,33877,941,1133,699,1908,1379,39937,33524,935,1079,549,1859,1317,39263
2020-01-22,광주,전북,7783,427,535,345,333,331,9754,8120,449,515,310,374,339,10107
2020-01-22,광주,충남,3869,101,605,494,259,97,5425,5821,116,570,601,378,175,7661
2020-01-22,광주,충북,553,31,73,113,66,18,854,953,38,105,179,103,30,1408
2020-01-22,대구,강원,255,6,24,19,15,8,327,343,3,14,12,11,10,393
2020-01-22,대구,경기,3051,135,253,513,542,82,4576,3135,87,230,452,245,123,4272
2020-01-22,대구,경남,11257,572,834,475,535,466,14139,14591,791,1089,1154,1896,587,20108
2020-01-22,대구,경북,78718,3191,3366,2234,3229,4199,94937,77573,3091,3056,1837,2740,4110,92407
2020-01-22,대구,광주,692,34,100,68,32,18,944,749,26,99,87,24,20,1005
2020-01-22,대구,대구,65418,2257,1888,1031,1102,4246,75942,65418,2257,1888,1031,1102,4246,75942
2020-01-22,대구,대전,980,36,56,61,39,38,1210,772,22,30,47,21,26,918
2020-01-22,대구,부산,516,43,105,71,184,19,938,2874,104,229,93,299,117,3716
2020-01-22,대구,서울,2548,74,222,237,145,79,3305,2370,48,163,128,60,62,2831
2020-01-22,대구,세종,261,4,14,6,14,8,307,224,1,3,6,2,5,241
2020-01-22,대구,울산,1310,60,158,81,173,62,1844,1495,65,150,77,226,65,2078
2020-01-22,대구,전남,413,13,48,26,67,14,581,594,21,48,42,69,15,789
2020-01-22,대구,전북,386,14,38,14,23,7,482,427,7,43,26,16,10,529
2020-01-22,대구,충남,1446,71,155,211,291,45,2219,1581,70,117,171,173,44,2156
2020-01-22,대구,충북,1739,90,204,283,417,67,2800,1675,98,151,263,122,66,2375
2020-01-22,대전,강원,147,5,30,2,1,4,189,229,3,31,4,2,8,277
2020-01-22,대전,경기,2153,113,195,105,50,91,2707,2674,104,218,128,52,118,3294
2020-01-22,대전,경남,1056,24,99,116,69,45,1409,853,22,93,71,45,32,1116
2020-01-22,대전,경북,1789,48,120,130,71,72,2230,1849,56,114,88,79,81,2267
2020-01-22,대전,광주,514,22,13,29,18,12,608,435,18,13,37,18,17,538
2020-01-22,대전,대구,772,22,30,47,21,26,918,980,36,56,61,39,38,1210
2020-01-22,대전,대전,14998,435,442,238,395,1104,17612,14998,435,442,238,395,1104,17612
2020-01-22,대전,부산,67,3,9,12,18,1,110,95,4,3,21,13,5,141
2020-01-22,대전,서울,1707,43,217,45,11,65,2088,2121,42,197,38,12,79,2489
2020-01-22,대전,세종,3703,106,81,30,37,336,4293,3796,95,84,30,101,340,4446
2020-01-22,대전,울산,87,2,12,14,35,2,152,147,0,8,8,31,7,201
2020-01-22,대전,전남,290,3,12,23,34,17,379,377,9,12,15,20,13,446
2020-01-22,대전,전북,3202,83,101,98,49,165,3698,3341,76,97,80,42,161,3797
2020-01-22,대전,충남,17271,456,541,269,385,1358,20280,16146,445,488,224,323,1193,18819
2020-01-22,대전,충북,11839,466,476,205,144,906,14036,11036,416,412,152,125,801,12942
2020-01-22,부산,강원,0,0,0,0,1,0,1,7,0,1,2,3,0,13
2020-01-22,부산,경기,321,19,35,173,312,10,870,281,15,36,218,180,13,743
2020-01-22,부산,경남,90612,2830,3215,1978,5424,6341,110400,93628,2785,3168,1990,5283,6437,113291
2020-01-22,부산,경북,4250,113,361,201,937,197,6059,4491,111,308,197,746,200,6053
2020-01-22,부산,광주,506,11,47,78,126,12,780,374,12,29,35,77,16,543
2020-01-22,부산,대구,2874,104,229,93,299,117,3716,516,43,105,71,184,19,938
2020-01-22,부산,대전,95,4,3,21,13,5,141,67,3,9,12,18,1,110
2020-01-22,부산,부산,42353,718,689,839,2258,3032,49889,42353,718,689,839,2258,3032,49889
2020-01-22,부산,서울,238,18,18,75,74,10,433,214,15,19,57,54,7,366
2020-01-22,부산,세종,18,0,2,3,9,1,33,15,0,0,1,3,1,20
2020-01-22,부산,울산,16757,415,523,694,2791,1146,22326,17294,437,464,448,2626,1210,22479
2020-01-22,부산,전남,1959,89,150,205,624,77,3104,1999,87,111,125,732,86,3140
2020-01-22,부산,전북,367,10,36,42,97,9,561,309,6,26,47,74,9,471
2020-01-22,부산,충남,139,14,24,77,174,3,431,168,9,29,81,238,2,527
2020-01-22,부산,충북,123,12,26,88,217,1,467,107,16,22,119,162,3,429
2020-01-22,서울,강원,656,10,199,13,12,19,909,652,15,290,18,21,23,1019
2020-01-22,서울,경기,149856,7252,9439,4844,3392,10067,184850,157072,7757,9915,5503,3876,10667,194790
2020-01-22,서울,경남,3320,51,487,189,160,89,4296,2020,56,467,298,153,79,3073
2020-01-22,서울,경북,3419,84,351,234,130,113,4331,2884,107,384,356,137,73,3941
2020-01-22,서울,광주,1442,25,26,48,22,32,1595,705,18,21,71,28,19,862
2020-01-22,서울,대구,2370,48,163,128,60,62,2831,2548,74,222,237,145,79,3305
2020-01-22,서울,대전,2121,42,197,38,12,79,2489,1707,43,217,45,11,65,2088
2020-01-22,서울,부산,214,15,19,57,54,7,366,238,18,18,75,74,10,433
2020-01-22,서울,서울,196,6,7,2,2,15,228,196,6,7,2,2,15,228
2020-01-22,서울,세종,44,0,0,2,1,5,52,45,0,1,0,0,3,49
2020-01-22,서울,울산,26,2,0,4,1,0,33,36,1,5,5,13,3,63
2020-01-22,서울,전남,1667,8,22,36,48,46,1827,1061,15,24,71,65,36,1272
2020-01-22,서울,전북,2033,22,42,33,31,72,2233,1297,26,51,43,26,44,1487
2020-01-22,서울,충남,27346,498,2411,830,822,1033,32940,25863,598,2564,1295,1294,1033,32647
2020-01-22,서울,충북,13950,543,1175,788,706,591,17753,13849,647,1230,788,911,581,18006
2020-01-22,세종,강원,7,1,0,1,0,0,9,3,1,0,0,0,0,4
2020-01-22,세종,경기,74,4,3,6,3,3,93,40,4,4,6,3,2,59
2020-01-22,세종,경남,355,4,20,10,21,14,424,215,1,14,8,7,7,252
2020-01-22,세종,경북,319,6,26,19,14,15,399,268,6,22,16,13,14,339
2020-01-22,세종,광주,241,1,11,6,2,8,269,127,1,12,4,3,2,149
2020-01-22,세종,대구,224,1,3,6,2,5,241,261,4,14,6,14,8,307
2020-01-22,세종,대전,3796,95,84,30,101,340,4446,3703,106,81,30,37,336,4293
2020-01-22,세종,부산,15,0,0,1,3,1,20,18,0,2,3,9,1,33
2020-01-22,세종,서울,45,0,1,0,0,3,49,44,0,0,2,1,5,52
2020-01-22,세종,세종,268,18,9,4,1,19,319,268,18,9,4,1,19,319
2020-01-22,세종,울산,14,0,0,1,0,1,16,15,0,0,3,6,0,24
2020-01-22,세종,전남,193,3,1,12,23,4,236,189,2,3,8,24,5,231
2020-01-22,세종,전북,784,21,25,14,21,30,895,646,15,23,15,34,26,759
2020-01-22,세종,충남,6104,153,160,120,179,333,7049,4580,141,156,133,130,265,5405
2020-01-22,세종,충북,402,12,18,17,8,27,484,354,14,15,9,12,20,424
2020-01-22,울산,강원,2,0,0,0,1,0,3,1,0,1,0,0,0,2
2020-01-22,울산,경기,54,6,8,35,67,2,172,40,1,5,14,29,3,92
2020-01-22,울산,경남,10009,596,792,475,719,552,13143,10561,692,734,527,680,614,13808
2020-01-22,울산,경북,5174,186,384,366,1426,312,7848,5443,188,419,458,1199,311,8018
2020-01-22,울산,광주,76,0,13,5,10,1,105,49,0,8,2,8,2,69
2020-01-22,울산,대구,1495,65,150,77,226,65,2078,1310,60,158,81,173,62,1844
2020-01-22,울산,대전,147,0,8,8,31,7,201,87,2,12,14,35,2,152
2020-01-22,울산,부산,17294,437,464,448,2626,1210,22479,16757,415,523,694,2791,1146,22326
2020-01-22,울산,서울,36,1,5,5,13,3,63,26,2,0,4,1,0,33
2020-01-22,울산,세종,15,0,0,3,6,0,24,14,0,0,1,0,1,16
2020-01-22,울산,울산,9022,319,563,328,611,846,11689,9022,319,563,328,611,846,11689
2020-01-22,울산,전남,188,6,19,17,32,3,265,203,12,15,14,63,4,311
2020-01-22,울산,전북,55,1,8,3,13,0,80,50,0,7,3,3,0,63
2020-01-22,울산,충남,140,7,19,57,135,8,366,197,7,10,46,121,9,390
2020-01-22,울산,충북,30,2,6,8,43,1,90,20,5,1,16,38,1,81
2020-01-22,전남,강원,79,1,7,6,31,0,124,79,0,1,7,10,1,98
2020-01-22,전남,경기,1030,21,98,155,137,26,1467,1529,15,113,168,173,43,2041
2020-01-22,전남,경남,6740,301,500,451,1468,259,9719,5872,253,493,496,1530,233,8877
2020-01-22,전남,경북,1102,42,84,87,609,36,1960,1031,40,87,121,507,35,1821
2020-01-22,전남,광주,33524,935,1079,549,1859,1317,39263,33877,941,1133,699,1908,1379,39937
2020-01-22,전남,대구,594,21,48,42,69,15,789,413,13,48,26,67,14,581
2020-01-22,전남,대전,377,9,12,15,20,13,446,290,3,12,23,34,17,379
2020-01-22,전남,부산,1999,87,111,125,732,86,3140,1959,89,150,205,624,77,3104
2020-01-22,전남,서울,1061,15,24,71,65,36,1272,1667,8,22,36,48,46,1827
2020-01-22,전남,세종,189,2,3,8,24,5,231,193,3,1,12,23,4,236
2020-01-22,전남,울산,203,12,15,14,63,4,311,188,6,19,17,32,3,265
2020-01-22,전남,전남,47502,1316,1511,1528,4816,1920,58593,47502,1316,1511,1528,4816,1920,58593
2020-01-22,전남,전북,5310,284,525,564,1282,141,8106,4809,234,420,599,1263,134,7459
2020-01-22,전남,충남,5123,115,444,746,1279,125,7832,6385,88,519,536,1135,201,8864
2020-01-22,전남,충북,499,15,36,79,316,8,953,497,12,38,103,295,11,956
2020-01-22,전북,강원,152,9,13,22,17,5,218,230,1,18,19,20,8,296
2020-01-22,전북,경기,1459,60,169,182,206,52,2128,1932,56,161,144,222,70,2585
2020-01-22,전북,경남,1310,35,126,116,177,37,1801,1247,34,138,99,180,37,1735
2020-01-22,전북,경북,1585,89,182,156,232,53,2297,1859,90,208,169,264,52,2642
2020-01-22,전북,광주,8120,449,515,310,374,339,10107,7783,427,535,345,333,331,9754
2020-01-22,전북,대구,427,7,43,26,16,10,529,386,14,38,14,23,7,482
2020-01-22,전북,대전,3341,76,97,80,42,161,3797,3202,83,101,98,49,165,3698
2020-01-22,전북,부산,309,6,26,47,74,9,471,367,10,36,42,97,9,561
2020-01-22,전북,서울,1297,26,51,43,26,44,1487,2033,22,42,33,31,72,2233
2020-01-22,전북,세종,646,15,23,15,34,26,759,784,21,25,14,21,30,895
2020-01-22,전북,울산,50,0,7,3,3,0,63,55,1,8,3,13,0,80
2020-01-22,전북,전남,4809,234,420,599,1263,134,7459,5310,284,525,564,1282,141,8106
2020-01-22,전북,전북,16785,602,951,826,744,665,20573,16785,602,951,826,744,665,20573
2020-01-22,전북,충남,13483,525,1541,1171,1343,446,18509,16016,531,1590,1024,1385,555,21101
2020-01-22,전북,충북,1849,118,196,301,301,66,2831,2103,118,221,290,306,81,3119
2020-01-22,충남,강원,416,4,24,44,70,27,585,371,9,31,20,35,9,475
2020-01-22,충남,경기,40597,1577,2874,2515,4564,2032,54159,41063,1607,2984,2617,4852,2087,55210
2020-01-22,충남,경남,2330,73,189,391,679,84,3746,1291,51,143,255,246,27,2013
2020-01-22,충남,경북,4033,168,392,498,830,128,6049,3268,154,386,569,674,104,5155
2020-01-22,충남,광주,5821,116,570,601,378,175,7661,3869,101,605,494,259,97,5425
2020-01-22,충남,대구,1581,70,117,171,173,44,2156,1446,71,155,211,291,45,2219
2020-01-22,충남,대전,16146,445,488,224,323,1193,18819,17271,456,541,269,385,1358,20280
2020-01-22,충남,부산,168,9,29,81,238,2,527,139,14,24,77,174,3,431
2020-01-22,충남,서울,25863,598,2564,1295,1294,1033,32647,27346,498,2411,830,822,1033,32940
2020-01-22,충남,세종,4580,141,156,133,130,265,5405,6104,153,160,120,179,333,7049
2020-01-22,충남,울산,197,7,10,46,121,9,390,140,7,19,57,135,8,366
2020-01-22,충남,전남,6385,88,519,536,1135,201,8864,5123,115,444,746,1279,125,7832
2020-01-22,충남,전북,16016,531,1590,1024,1385,555,21101,13483,525,1541,1171,1343,446,18509
2020-01-22,충남,충남,107064,3720,8571,7241,10799,4972,142367,107064,3720,8571,7241,10799,4972,142367
2020-01-22,충남,충북,14864,644,944,989,1465,796,19702,13140,655,908,898,1448,725,17774
2020-01-22,충북,강원,4858,208,278,225,282,282,6133,5264,233,327,241,397,324,6786
2020-01-22,충북,경기,29060,2218,3024,2984,3868,1338,42492,29348,2337,3131,3493,3673,1409,43391
2020-01-22,충북,경남,1670,76,261,550,708,62,3327,1130,60,154,295,289,41,1969
2020-01-22,충북,경북,5417,243,557,709,975,206,8107,5411,232,518,744,938,188,8031
2020-01-22,충북,광주,953,38,105,179,103,30,1408,553,31,73,113,66,18,854
2020-01-22,충북,대구,1675,98,151,263,122,66,2375,1739,90,204,283,417,67,2800
2020-01-22,충북,대전,11036,416,412,152,125,801,12942,11839,466,476,205,144,906,14036
2020-01-22,충북,부산,107,16,22,119,162,3,429,123,12,26,88,217,1,467
2020-01-22,충북,서울,13849,647,1230,788,911,581,18006,13950,543,1175,788,706,591,17753
2020-01-22,충북,세종,354,14,15,9,12,20,424,402,12,18,17,8,27,484
2020-01-22,충북,울산,20,5,1,16,38,1,81,30,2,6,8,43,1,90
2020-01-22,충북,전남,497,12,38,103,295,11,956,499,15,36,79,316,8,953
2020-01-22,충북,전북,2103,118,221,290,306,81,3119,1849,118,196,301,301,66,2831
2020-01-22,충북,충남,13140,655,908,898,1448,725,17774,14864,644,944,989,1465,796,19702
2020-01-22,충북,충북,39155,2033,2360,2263,2904,2324,51039,39155,2033,2360,2263,2904,2324,51039
2020-01-23,강원,강원,84262,2001,3020,872,1549,5525,97229,84262,2001,3020,872,1549,5525,97229
2020-01-23,강원,경기,19811,462,1164,525,615,1102,23679,38348,486,1266,543,676,1790,43109
2020-01-23,강원,경남,449,0,8,8,20,20,505,237,0,8,13,7,11,276
2020-01-23,강원,경북,1089,12,28,14,14,36,1193,625,15,27,12,18,24,721
2020-01-23,강원,광주,139,1,14,3,3,5,165,130,2,12,10,4,1,159
2020-01-23,강원,대구,458,4,8,10,12,17,509,454,5,12,23,12,18,524
2020-01-23,강원,대전,114,2,14,0,0,4,134,234,2,24,0,1,4,265
2020-01-23,강원,부산,12,0,1,0,0,0,13,7,0,0,0,5,0,12
2020-01-23,강원,서울,622,6,289,4,14,27,962,1329,14,272,11,9,42,1677
2020-01-23,강원,세종,3,0,0,0,1,0,4,12,0,0,0,0,2,14
2020-01-23,강원,울산,4,0,0,0,0,0,4,1,1,0,0,0,1,3
2020-01-23,강원,전남,95,1,1,4,2,5,108,128,0,2,5,12,3,150
2020-01-23,강원,전북,158,0,5,10,10,5,188,191,1,5,4,9,5,215
2020-01-23,강원,충남,207,5,16,10,25,9,272,643,5,16,33,36,41,774
2020-01-23,강원,충북,5240,183,195,111,218,325,6272,6381,165,216,152,176,410,7500
2020-01-23,경기,강원,38348,486,1266,543,676,1790,43109,19811,462,1164,525,615,1102,23679
2020-01-23,경기,경기,448536,18472,20597,14310,17856,31499,551270,448536,18472,20597,14310,17856,31499,551270
2020-01-23,경기,경남,8209,60,354,604,418,249,9894,3006,50,265,425,332,107,4185
2020-01-23,경기,경북,10850,99,372,465,399,393,12578,4665,109,416,617,396,206,6409
2020-01-23,경기,광주,3047,15,236,195,102,98,3693,851,13,158,146,75,26,1269
2020-01-23,경기,대구,4420,56,193,217,156,121,5163,3417,86,241,343,375,114,4576
2020-01-23,경기,대전,2281,63,180,65,25,98,2712,1862,91,191,55,29,87,2315
2020-01-23,경기,부산,533,11,39,159,123,12,877,205,5,20,141,194,6,571
2020-01-23,경기,서울,144924,6160,8341,3578,2319,9770,175092,139141,5467,8109,3122,2157,8831,166827
2020-01-23,경기,세종,122,2,3,2,4,2,135,71,3,2,2,0,2,80
2020-01-23,경기,울산,85,0,13,12,20,1,131,97,2,8,23,60,2,192
2020-01-23,경기,전남,5669,9,108,92,97,117,6092,1175,10,98,93,82,37,1495
2020-01-23,경기,전북,4972,34,195,107,164,146,5618,1631,36,133,134,147,68,2149
2020-01-23,경기,충남,51412,1045,2145,1631,2967,2209,61409,39433,1092,2388,1767,3087,2151,49918
2020-01-23,경기,충북,42605,1461,2183,2119,2156,1870,52394,27988,1567,2133,2071,2287,1515,37561
2020-01-23,경남,강원,237,0,8,13,7,11,276,449,0,8,8,20,20,505
2020-01-23,경남,경기,3006,50,265,425,332,107,4185,8209,60,354,604,418,249,9894
2020-01-23,경남,경남,213464,8806,8753,6088,10141,15733,262985,213464,8806,8753,6088,10141,15733,262985
2020-01-23,경남,경북,13966,458,898,717,1449,647,18135,19333,638,1051,1041,2203,840,25106
2020-01-23,경남,광주,2236,38,169,139,115,74,2771,1501,35,166,131,76,52,1961
2020-01-23,경남,대구,17488,597,1060,830,1395,729,22099,11253,419,711,331,359,536,13609
2020-01-23,경남,대전,1282,11,116,38,25,64,1536,2167,14,113,87,48,103,2532
2020-01-23,경남,부산,95037,2197,2809,1295,4019,6528,111885,90918,2258,2776,1276,4266,6503,107997
2020-01-23,경남,서울,2628,25,619,189,97,101,3659,6691,33,822,155,88,166,7955
2020-01-23,경남,세종,248,0,9,6,11,9,283,1260,4,23,9,13,32,1341
2020-01-23,경남,울산,10930,552,625,420,505,662,13694,11448,494,674,417,564,634,14231
2020-01-23,경남,전남,8682,204,403,396,960,356,11001,8152,208,405,294,877,383,10319
2020-01-23,경남,전북,2124,26,102,86,102,81,2521,1753,28,112,68,116,75,2152
2020-01-23,경남,충남,1615,33,116,169,156,62,2151,5928,43,175,259,444,210,7059
2020-01-23,경남,충북,1651,33,108,156,206,53,2207,5705,54,155,406,511,194,7025
2020-01-23,경북,강원,625,15,27,12,18,24,721,1089,12,28,14,14,36,1193
2020-01-23,경북,경기,4665,109,416,617,396,206,6409,10850,99,372,465,399,393,12578
2020-01-23,경북,경남,19333,638,1051,1041,2203,840,25106,13966,458,898,717,1449,647,18135
2020-01-23,경북,경북,85430,3084,3608,2260,3275,4594,102251,85430,3084,3608,2260,3275,4594,102251
2020-01-23,경북,광주,1768,33,104,136,90,41,2172,1230,26,100,120,65,29,1570
2020-01-23,경북,대구,79577,2424,2522,1174,1487,4249,91433,78473,2518,2750,1409,1907,4307,91364
2020-01-23,경북,대전,2375,35,108,51,54,108,2731,2623,38,105,85,30,140,3021
2020-01-23,경북,부산,6270,87,282,146,657,272,7714,5643,82,325,192,773,269,7284
2020-01-23,경북,서울,2970,48,389,214,105,101,3827,5823,32,362,119,60,192,6588
2020-01-23,경북,세종,294,4,9,19,8,8,342,770,8,23,16,8,27,852
2020-01-23,경북,울산,5822,117,311,380,1001,376,8007,6475,125,304,282,1164,340,8690
2020-01-23,경북,전남,1791,21,61,85,384,62,2404,1613,26,62,81,511,66,2359
2020-01-23,경북,전북,2475,72,148,115,168,106,3084,2026,58,111,100,159,67,2521
2020-01-23,경북,충남,3208,90,272,398,440,108,4516,6660,88,252,385,561,257,8203
2020-01-23,경북,충북,6163,168,396,457,540,280,8004,11120,168,461,525,654,387,13315
2020-01-23,광주,강원,130,2,12,10,4,1,159,139,1,14,3,3,5,165
2020-01-23,광주,경기,851,13,158,146,75,26,1269,3047,15,236,195,102,98,3693
2020-01-23,광주,경남,1501,35,166,131,76,52,1961,2236,38,169,139,115,74,2771
2020-01-23,광주,경북,1230,26,100,120,65,29,1570,1768,33,104,136,90,41,2172
2020-01-23,광주,광주,16596,474,651,238,167,689,18815,16596,474,651,238,167,689,18815
2020-01-23,광주,대구,900,14,95,39,14,29,1091,855,17,106,52,12,20,1062
2020-01-23,광주,대전,551,11,16,5,4,23,610,893,9,19,12,11,26,970
2020-01-23,광주,부산,659,9,42,28,68,15,821,872,10,58,48,72,17,1077
2020-01-23,광주,서울,798,11,26,54,15,28,932,2853,9,270,30,14,50,3226
2020-01-23,광주,세종,132,0,6,0,0,4,142,635,1,6,7,1,16,666
2020-01-23,광주,울산,64,1,9,4,0,3,81,136,0,9,4,5,1,155
2020-01-23,광주,전남,39593,764,1049,457,1238,1649,44750,37668,794,1032,431,1252,1428,42605
2020-01-23,광주,전북,8646,335,485,276,233,339,10314,10433,341,449,257,329,379,12188
2020-01-23,광주,충남,4856,64,723,273,155,176,6247,13586,77,489,421,272,315,15160
2020-01-23,광주,충북,669,13,62,73,35,17,869,1635,20,83,93,72,46,1949
2020-01-23,대구,강원,454,5,12,23,12,18,524,458,4,8,10,12,17,509
2020-01-23,대구,경기,3417,86,241,343,375,114,4576,4420,56,193,217,156,121,5163
2020-01-23,대구,경남,11253,419,711,331,359,536,13609,17488,597,1060,830,1395,729,22099
2020-01-23,대구,경북,78473,2518,2750,1409,1907,4307,91364,79577,2424,2522,1174,1487,4249,91433
2020-01-23,대구,광주,855,17,106,52,12,20,1062,900,14,95,39,14,29,1091
2020-01-23,대구,대구,64051,1724,1666,694,625,4127,72887,64051,1724,1666,694,625,4127,72887
2020-01-23,대구,대전,1222,24,60,47,25,41,1419,1147,16,44,34,16,55,1312
2020-01-23,대구,부산,770,35,100,56,172,29,1162,3542,73,231,82,236,118,4282
2020-01-23,대구,서울,3012,38,353,160,71,96,3730,3022,26,280,68,40,78,3514
2020-01-23,대구,세종,268,4,11,5,9,13,310,554,2,0,3,2,12,573
2020-01-23,대구,울산,1359,43,138,64,139,68,1811,2150,34,128,55,185,89,2641
2020-01-23,대구,전남,686,3,39,24,37,21,810,790,6,41,23,33,39,932
2020-01-23,대구,전북,521,11,42,12,14,19,619,567,10,37,12,13,17,656
2020-01-23,대구,충남,1450,31,107,135,198,53,1974,2664,29,106,101,131,92,3123
2020-01-23,대구,충북,2177,60,155,187,342,98,3019,3665,53,123,190,103,122,4256
2020-01-23,대전,강원,234,2,24,0,1,4,265,114,2,14,0,0,4,134
2020-01-23,대전,경기,1862,91,191,55,29,87,2315,2281,63,180,65,25,98,2712
2020-01-23,대전,경남,2167,14,113,87,48,103,2532,1282,11,116,38,25,64,1536
2020-01-23,대전,경북,2623,38,105,85,30,140,3021,2375,35,108,51,54,108,2731
2020-01-23,대전,광주,893,9,19,12,11,26,970,551,11,16,5,4,23,610
2020-01-23,대전,대구,1147,16,44,34,16,55,1312,1222,24,60,47,25,41,1419
2020-01-23,대전,대전,15697,341,364,124,122,1177,17825,15697,341,364,124,122,1177,17825
2020-01-23,대전,부산,159,3,3,8,11,9,193,102,2,9,11,9,2,135
2020-01-23,대전,서울,1742,14,243,17,2,77,2095,1999,12,232,12,5,76,2336
2020-01-23,대전,세종,3400,85,62,22,13,288,3870,3737,84,55,23,22,276,4197
2020-01-23,대전,울산,168,1,15,8,12,10,214,257,3,13,6,13,14,306
2020-01-23,대전,전남,622,0,6,15,13,20,676,506,3,7,3,16,20,555
2020-01-23,대전,전북,4114,65,77,42,20,160,4478,3465,87,82,24,25,160,3843
2020-01-23,대전,충남,16967,385,467,185,283,1333,19620,14978,345,442,157,202,1099,17223
2020-01-23,대전,충북,10771,364,373,133,79,777,12497,9673,328,363,128,72,670,11234
2020-01-23,부산,강원,7,0,0,0,5,0,12,12,0,1,0,0,0,13
2020-01-23,부산,경기,205,5,20,141,194,6,571,533,11,39,159,123,12,877
2020-01-23,부산,경남,90918,2258,2776,1276,4266,6503,107997,95037,2197,2809,1295,4019,6528,111885
2020-01-23,부산,경북,5643,82,325,192,773,269,7284,6270,87,282,146,657,272,7714
2020-01-23,부산,광주,872,10,58,48,72,17,1077,659,9,42,28,68,15,821
2020-01-23,부산,대구,3542,73,231,82,236,118,4282,770,35,100,56,172,29,1162
2020-01-23,부산,대전,102,2,9,11,9,2,135,159,3,3,8,11,9,193
2020-01-23,부산,부산,43860,552,531,454,1800,3081,50278,43860,552,531,454,1800,3081,50278
2020-01-23,부산,서울,190,5,24,53,49,6,327,370,4,23,39,32,5,473
2020-01-23,부산,세종,15,0,0,2,2,0,19,61,0,1,0,5,0,67
2020-01-23,부산,울산,15986,328,419,602,2575,1149,21059,20384,326,373,325,2357,1363,25128
2020-01-23,부산,전남,3337,46,100,152,563,101,4299,2475,43,101,84,542,105,3350
2020-01-23,부산,전북,630,6,30,21,93,23,803,389,7,21,29,80,18,544
2020-01-23,부산,충남,179,6,25,56,122,5,393,428,3,18,58,157,9,673
2020-01-23,부산,충북,127,8,17,63,180,8,403,332,4,13,77,116,8,550
2020-01-23,서울,강원,1329,14,272,11,9,42,1677,622,6,289,4,14,27,962
2020-01-23,서울,경기,139141,5467,8109,3122,2157,8831,166827,144924,6160,8341,3578,2319,9770,175092
2020-01-23,서울,경남,6691,33,822,155,88,166,7955,2628,25,619,189,97,101,3659
2020-01-23,서울,경북,5823,32,362,119,60,192,6588,2970,48,389,214,105,101,3827
2020-01-23,서울,광주,2853,9,270,30,14,50,3226,798,11,26,54,15,28,932
2020-01-23,서울,대구,3022,26,280,68,40,78,3514,3012,38,353,160,71,96,3730
2020-01-23,서울,대전,1999,12,232,12,5,76,2336,1742,14,243,17,2,77,2095
2020-01-23,서울,부산,370,4,23,39,32,5,473,190,5,24,53,49,6,327
2020-01-23,서울,서울,200,1,7,1,2,12,223,200,1,7,1,2,12,223
2020-01-23,서울,세종,41,1,3,1,0,4,50,41,1,0,0,0,3,45
2020-01-23,서울,울산,68,1,7,2,3,3,84,47,0,4,1,14,0,66
2020-01-23,서울,전남,4933,3,142,17,27,108,5230,1322,8,24,31,23,38,1446
2020-01-23,서울,전북,4736,7,340,20,26,114,5243,1536,19,37,20,16,49,1677
2020-01-23,서울,충남,35510,270,1986,482,420,1190,39858,27829,380,2684,715,672,1187,33467
2020-01-23,서울,충북,18946,305,1164,440,413,761,22029,14505,383,1083,528,547,670,17716
2020-01-23,세종,강원,12,0,0,0,0,2,14,3,0,0,0,1,0,4
2020-01-23,세종,경기,71,3,2,2,0,2,80,122,2,3,2,4,2,135
2020-01-23,세종,경남,1260,4,23,9,13,32,1341,248,0,9,6,11,9,283
2020-01-23,세종,경북,770,8,23,16,8,27,852,294,4,9,19,8,8,342
2020-01-23,세종,광주,635,1,6,7,1,16,666,132,0,6,0,0,4,142
2020-01-23,세종,대구,554,2,0,3,2,12,573,268,4,11,5,9,13,310
2020-01-23,세종,대전,3737,84,55,23,22,276,4197,3400,85,62,22,13,288,3870
2020-01-23,세종,부산,61,0,1,0,5,0,67,15,0,0,2,2,0,19
2020-01-23,세종,서울,41,1,0,0,0,3,45,41,1,3,1,0,4,50
2020-01-23,세종,세종,322,21,1,7,0,26,377,322,21,1,7,0,26,377
2020-01-23,세종,울산,30,0,1,2,2,0,35,17,0,1,0,1,0,19
2020-01-23,세종,전남,606,0,4,5,21,12,648,208,2,0,5,15,7,237
2020-01-23,세종,전북,1326,12,25,10,45,48,1466,702,9,21,17,48,23,820
2020-01-23,세종,충남,7362,127,129,88,125,376,8207,5526,118,107,93,121,278,6243
2020-01-23,세종,충북,437,12,17,13,6,43,528,252,6,23,12,6,19,318
2020-01-23,울산,강원,1,1,0,0,0,1,3,4,0,0,0,0,0,4
2020-01-23,울산,경기,97,2,8,23,60,2,192,85,0,13,12,20,1,131
2020-01-23,울산,경남,11448,494,674,417,564,634,14231,10930,552,625,420,505,662,13694
2020-01-23,울산,경북,6475,125,304,282,1164,340,8690,5822,117,311,380,1001,376,8007
2020-01-23,울산,광주,136,0,9,4,5,1,155,64,1,9,4,0,3,81
2020-01-23,울산,대구,2150,34,128,55,185,89,2641,1359,43,138,64,139,68,1811
2020-01-23,울산,대전,257,3,13,6,13,14,306,168,1,15,8,12,10,214
2020-01-23,울산,부산,20384,326,373,325,2357,1363,25128,15986,328,419,602,2575,1149,21059
2020-01-23,울산,서울,47,0,4,1,14,0,66,68,1,7,2,3,3,84
2020-01-23,울산,세종,17,0,1,0,1,0,19,30,0,1,2,2,0,35
2020-01-23,울산,울산,8537,232,436,279,419,785,10688,8537,232,436,279,419,785,10688
2020-01-23,울산,전남,439,5,18,10,31,6,509,312,13,16,8,38,9,396
2020-01-23,울산,전북,188,0,11,5,12,3,219,73,0,6,5,2,0,86
2020-01-23,울산,충남,240,2,14,41,89,5,391,380,2,17,35,106,10,550
2020-01-23,울산,충북,49,1,2,8,35,1,96,51,0,1,12,26,0,90
2020-01-23,전남,강원,128,0,2,5,12,3,150,95,1,1,4,2,5,108
2020-01-23,전남,경기,1175,10,98,93,82,37,1495,5669,9,108,92,97,117,6092
2020-01-23,전남,경남,8152,208,405,294,877,383,10319,8682,204,403,396,960,356,11001
2020-01-23,전남,경북,1613,26,62,81,511,66,2359,1791,21,61,85,384,62,2404
2020-01-23,전남,광주,37668,794,1032,431,1252,1428,42605,39593,764,1049,457,1238,1649,44750
2020-01-23,전남,대구,790,6,41,23,33,39,932,686,3,39,24,37,21,810
2020-01-23,전남,대전,506,3,7,3,16,20,555,622,0,6,15,13,20,676
2020-01-23,전남,부산,2475,43,101,84,542,105,3350,3337,46,100,152,563,101,4299
2020-01-23,전남,서울,1322,8,24,31,23,38,1446,4933,3,142,17,27,108,5230
2020-01-23,전남,세종,208,2,0,5,15,7,237,606,0,4,5,21,12,648
2020-01-23,전남,울산,312,13,16,8,38,9,396,439,5,18,10,31,6,509
2020-01-23,전남,전남,64551,985,1305,1142,2948,2422,73353,64551,985,1305,1142,2948,2422,73353
2020-01-23,전남,전북,6811,200,443,316,1054,195,9019,8752,179,320,421,1003,237,10912
2020-01-23,전남,충남,6496,57,494,363,773,207,8390,20208,36,412,356,864,496,22372
2020-01-23,전남,충북,653,12,19,45,189,28,946,1215,8,28,73,243,33,1600
2020-01-23,전북,강원,191,1,5,4,9,5,215,158,0,5,10,10,5,188
2020-01-23,전북,경기,1631,36,133,134,147,68,2149,4972,34,195,107,164,146,5618
2020-01-23,전북,경남,1753,28,112,68,116,75,2152,2124,26,102,86,102,81,2521
2020-01-23,전북,경북,2026,58,111,100,159,67,2521,2475,72,148,115,168,106,3084
2020-01-23,전북,광주,10433,341,449,257,329,379,12188,8646,335,485,276,233,339,10314
2020-01-23,전북,대구,567,10,37,12,13,17,656,521,11,42,12,14,19,619
2020-01-23,전북,대전,3465,87,82,24,25,160,3843,4114,65,77,42,20,160,4478
2020-01-23,전북,부산,389,7,21,29,80,18,544,630,6,30,21,93,23,803
2020-01-23,전북,서울,1536,19,37,20,16,49,1677,4736,7,340,20,26,114,5243
2020-01-23,전북,세종,702,9,21,17,48,23,820,1326,12,25,10,45,48,1466
2020-01-23,전북,울산,73,0,6,5,2,0,86,188,0,11,5,12,3,219
2020-01-23,전북,전남,8752,179,320,421,1003,237,10912,6811,200,443,316,1054,195,9019
2020-01-23,전북,전북,18908,552,813,434,447,729,21883,18908,552,813,434,447,729,21883
2020-01-23,전북,충남,14160,349,1534,769,1006,523,18341,29321,354,1117,680,1124,934,33530
2020-01-23,전북,충북,1926,77,137,184,191,84,2599,3235,76,145,190,216,125,3987
2020-01-23,충남,강원,643,5,16,33,36,41,774,207,5,16,10,25,9,272
2020-01-23,충남,경기,39433,1092,2388,1767,3087,2151,49918,51412,1045,2145,1631,2967,2209,61409
2020-01-23,충남,경남,5928,43,175,259,444,210,7059,1615,33,116,169,156,62,2151
2020-01-23,충남,경북,6660,88,252,385,561,257,8203,3208,90,272,398,440,108,4516
2020-01-23,충남,광주,13586,77,489,421,272,315,15160,4856,64,723,273,155,176,6247
2020-01-23,충남,대구,2664,29,106,101,131,92,3123,1450,31,107,135,198,53,1974
2020-01-23,충남,대전,14978,345,442,157,202,1099,17223,16967,385,467,185,283,1333,19620
2020-01-23,충남,부산,428,3,18,58,157,9,673,179,6,25,56,122,5,393
2020-01-23,충남,서울,27829,380,2684,715,672,1187,33467,35510,270,1986,482,420,1190,39858
2020-01-23,충남,세종,5526,118,107,93,121,278,6243,7362,127,129,88,125,376,8207
2020-01-23,충남,울산,380,2,17,35,106,10,550,240,2,14,41,89,5,391
2020-01-23,충남,전남,20208,36,412,356,864,496,22372,6496,57,494,363,773,207,8390
2020-01-23,충남,전북,29321,354,1117,680,1124,934,33530,14160,349,1534,769,1006,523,18341
2020-01-23,충남,충남,130766,2546,6691,4467,7189,5574,157233,130766,2546,6691,4467,7189,5574,157233
2020-01-23,충남,충북,12472,483,613,579,1010,780,15937,10450,498,589,552,949,639,13677
2020-01-23,충북,강원,6381,165,216,152,176,410,7500,5240,183,195,111,218,325,6272
2020-01-23,충북,경기,27988,1567,2133,2071,2287,1515,37561,42605,1461,2183,2119,2156,1870,52394
2020-01-23,충북,경남,5705,54,155,406,511,194,7025,1651,33,108,156,206,53,2207
2020-01-23,충북,경북,11120,168,461,525,654,387,13315,6163,168,396,457,540,280,8004
2020-01-23,충북,광주,1635,20,83,93,72,46,1949,669,13,62,73,35,17,869
2020-01-23,충북,대구,3665,53,123,190,103,122,4256,2177,60,155,187,342,98,3019
2020-01-23,충북,대전,9673,328,363,128,72,670,11234,10771,364,373,133,79,777,12497
2020-01-23,충북,부산,332,4,13,77,116,8,550,127,8,17,63,180,8,403
2020-01-23,충북,서울,14505,383,1083,528,547,670,17716,18946,305,1164,440,413,761,22029
2020-01-23,충북,세종,252,6,23,12,6,19,318,437,12,17,13,6,43,528
2020-01-23,충북,울산,51,0,1,12,26,0,90,49,1,2,8,35,1,96
2020-01-23,충북,전남,1215,8,28,73,243,33,1600,653,12,19,45,189,28,946
2020-01-23,충북,전북,3235,76,145,190,216,125,3987,1926,77,137,184,191,84,2599
2020-01-23,충북,충남,10450,498,589,552,949,639,13677,12472,483,613,579,1010,780,15937
2020-01-23,충북,충북,41783,1515,1783,1622,1928,2330,50961,41783,1515,1783,1622,1928,2330,50961
2020-01-24,강원,강원,113936,903,2096,285,446,4926,122592,113936,903,2096,285,446,4926,122592
2020-01-24,강원,경기,23002,159,814,134,190,1107,25406,60613,210,833,142,183,2232,64213
2020-01-24,강원,경남,590,1,3,1,1,20,616,476,0,1,6,1,10,494
2020-01-24,강원,경북,1564,9,14,2,2,54,1645,1342,8,16,1,0,45,1412
2020-01-24,강원,광주,121,0,13,0,1,4,139,207,0,13,0,0,4,224
2020-01-24,강원,대구,523,2,0,0,0,17,542,849,2,7,3,1,29,891
2020-01-24,강원,대전,121,0,17,3,0,8,149,406,2,24,0,0,13,445
2020-01-24,강원,부산,14,0,1,0,0,1,16,18,0,1,0,0,1,20
2020-01-24,강원,서울,791,7,296,3,4,35,1136,2653,10,409,2,2,58,3134
2020-01-24,강원,세종,3,0,0,0,0,0,3,23,0,0,0,0,0,23
2020-01-24,강원,울산,6,0,0,0,1,0,7,8,0,1,0,0,0,9
2020-01-24,강원,전남,136,0,1,0,0,3,140,134,1,1,0,3,4,143
2020-01-24,강원,전북,216,1,2,1,0,15,235,283,1,2,2,1,11,300
2020-01-24,강원,충남,254,0,8,0,1,16,279,756,2,9,4,10,27,808
2020-01-24,강원,충북,5896,50,69,10,23,256,6304,7869,59,108,21,23,302,8382
2020-01-24,경기,강원,60613,210,833,142,183,2232,64213,23002,159,814,134,190,1107,25406
2020-01-24,경기,경기,334934,4334,6032,2684,2469,16994,367447,334934,4334,6032,2684,2469,16994,367447
2020-01-24,경기,경남,13402,15,290,146,83,327,14263,3500,0,186,80,52,111,3929
2020-01-24,경기,경북,18834,26,145,82,57,513,19657,5488,22,148,134,52,200,6044
2020-01-24,경기,광주,3323,7,227,44,16,88,3705,1508,4,133,14,7,35,1701
2020-01-24,경기,대구,7044,10,129,42,20,181,7426,4311,14,155,60,47,129,4716
2020-01-24,경기,대전,3262,15,139,19,7,121,3563,2415,22,148,13,2,123,2723
2020-01-24,경기,부산,853,1,17,16,20,39,946,177,1,17,19,37,6,257
2020-01-24,경기,서울,112344,2028,3655,975,431,6136,125569,123113,1540,3461,816,382,5589,134901
2020-01-24,경기,세종,146,1,1,1,1,4,154,212,1,2,1,1,3,220
2020-01-24,경기,울산,154,0,5,1,4,4,168,153,0,3,4,11,4,175
2020-01-24,경기,전남,8006,6,119,20,11,188,8350,1750,1,65,17,19,51,1903
2020-01-24,경기,전북,9259,9,161,12,30,260,9731,2244,1,76,21,23,72,2437
2020-01-24,경기,충남,61239,250,915,248,515,2161,65328,35269,285,1153,257,615,1516,39095
2020-01-24,경기,충북,57255,379,628,291,405,1764,60722,24323,420,647,359,478,1068,27295
2020-01-24,경남,강원,476,0,1,6,1,10,494,590,1,3,1,1,20,616
2020-01-24,경남,경기,3500,0,186,80,52,111,3929,13402,15,290,146,83,327,14263
2020-01-24,경남,경남,209731,2914,3344,991,1230,10318,228528,209731,2914,3344,991,1230,10318,228528
2020-01-24,경남,경북,27073,118,355,138,182,1017,28883,27222,173,438,223,278,1037,29371
2020-01-24,경남,광주,3044,14,115,42,16,81,3312,2179,9,87,20,5,65,2365
2020-01-24,경남,대구,25417,157,567,219,329,1006,27695,15928,96,428,76,73,604,17205
2020-01-24,경남,대전,1598,2,81,4,4,62,1751,4502,8,105,24,7,141,4787
2020-01-24,경남,부산,91335,708,1695,243,815,4459,99255,100593,757,1540,181,897,4760,108728
2020-01-24,경남,서울,3806,5,613,25,15,129,4593,11781,9,1025,49,18,298,13180
2020-01-24,경남,세종,475,2,10,0,1,14,502,2844,1,17,6,2,58,2928
2020-01-24,경남,울산,11419,170,264,89,93,541,12576,15502,140,273,52,132,686,16785
2020-01-24,경남,전남,14400,83,187,97,269,481,15517,8036,82,193,85,218,290,8904
2020-01-24,경남,전북,3971,10,84,16,16,122,4219,2433,11,70,14,17,75,2620
2020-01-24,경남,충남,2735,8,34,19,23,94,2913,8178,7,56,60,89,206,8596
2020-01-24,경남,충북,3026,4,43,24,48,96,3241,10497,11,68,93,88,274,11031
2020-01-24,경북,강원,1342,8,16,1,0,45,1412,1564,9,14,2,2,54,1645
2020-01-24,경북,경기,5488,22,148,134,52,200,6044,18834,26,145,82,57,513,19657
2020-01-24,경북,경남,27222,173,438,223,278,1037,29371,27073,118,355,138,182,1017,28883
2020-01-24,경북,경북,109355,1077,1413,384,563,3987,116779,109355,1077,1413,384,563,3987,116779
2020-01-24,경북,광주,2024,13,40,23,14,69,2183,1769,6,36,10,8,50,1879
2020-01-24,경북,대구,68188,682,1070,254,278,2810,73282,92154,701,1210,307,362,3646,98380
2020-01-24,경북,대전,2815,5,57,7,8,102,2994,4348,8,55,20,5,166,4602
2020-01-24,경북,부산,8356,22,233,18,76,340,9045,11732,32,234,26,101,419,12544
2020-01-24,경북,서울,4027,11,307,23,8,136,4512,12179,20,371,40,9,291,12910
2020-01-24,경북,세종,428,0,9,4,2,21,464,1288,1,8,7,2,28,1334
2020-01-24,경북,울산,7109,38,117,89,356,305,8014,11985,26,102,49,369,489,13020
2020-01-24,경북,전남,3148,8,19,16,83,98,3372,2091,10,23,12,197,55,2388
2020-01-24,경북,전북,3823,23,47,27,26,97,4043,2340,28,54,21,39,58,2540
2020-01-24,경북,충남,4616,12,57,48,85,151,4969,9225,11,76,52,92,252,9708
2020-01-24,경북,충북,8502,39,152,79,128,265,9165,19603,49,188,97,124,548,20609
2020-01-24,광주,강원,207,0,13,0,0,4,224,121,0,13,0,1,4,139
2020-01-24,광주,경기,1508,4,133,14,7,35,1701,3323,7,227,44,16,88,3705
2020-01-24,광주,경남,2179,9,87,20,5,65,2365,3044,14,115,42,16,81,3312
2020-01-24,광주,경북,1769,6,36,10,8,50,1879,2024,13,40,23,14,69,2183
2020-01-24,광주,광주,20082,180,468,57,24,440,21251,20082,180,468,57,24,440,21251
2020-01-24,광주,대구,896,2,84,6,2,31,1021,1143,4,82,14,6,35,1284
2020-01-24,광주,대전,613,3,5,1,0,22,644,1089,1,5,1,1,27,1124
2020-01-24,광주,부산,948,2,53,4,10,23,1040,880,3,35,5,11,18,952
2020-01-24,광주,서울,1210,3,16,2,0,38,1269,4210,9,391,7,5,65,4687
2020-01-24,광주,세종,174,0,2,0,0,5,181,954,0,7,3,1,20,985
2020-01-24,광주,울산,96,0,10,0,0,3,109,314,0,12,2,1,5,334
2020-01-24,광주,전남,58014,344,700,84,172,1592,60906,37651,328,668,66,168,875,39756
2020-01-24,광주,전북,10803,125,214,48,29,324,11543,11021,137,215,66,48,287,11774
2020-01-24,광주,충남,6893,29,546,29,23,185,7705,17841,25,314,80,47,425,18732
2020-01-24,광주,충북,907,3,33,9,2,25,979,1978,2,35,17,5,44,2081
2020-01-24,대구,강원,849,2,7,3,1,29,891,523,2,0,0,0,17,542
2020-01-24,대구,경기,4311,14,155,60,47,129,4716,7044,10,129,42,20,181,7426
2020-01-24,대구,경남,15928,96,428,76,73,604,17205,25417,157,567,219,329,1006,27695
2020-01-24,대구,경북,92154,701,1210,307,362,3646,98380,68188,682,1070,254,278,2810,73282
2020-01-24,대구,광주,1143,4,82,14,6,35,1284,896,2,84,6,2,31,1021
2020-01-24,대구,대구,50094,352,526,148,164,2362,53646,50094,352,526,148,164,2362,53646
2020-01-24,대구,대전,1779,1,31,13,13,72,1909,1999,6,26,10,4,48,2093
2020-01-24,대구,부산,1178,4,55,17,46,42,1342,5033,10,158,13,38,195,5447
2020-01-24,대구,서울,4698,9,270,27,10,150,5164,5245,3,303,15,3,130,5699
2020-01-24,대구,세종,492,0,7,1,6,16,522,929,0,1,0,2,13,945
2020-01-24,대구,울산,2021,11,100,11,58,74,2275,3330,9,97,10,94,125,3665
2020-01-24,대구,전남,1383,3,37,5,14,44,1486,853,5,37,7,14,27,943
2020-01-24,대구,전북,854,1,32,3,5,27,922,561,2,27,3,4,18,615
2020-01-24,대구,충남,2807,3,28,24,34,73,2969,3787,3,20,29,29,117,3985
2020-01-24,대구,충북,3682,13,79,26,84,104,3988,5484,15,53,43,38,128,5761
2020-01-24,대전,강원,406,2,24,0,0,13,445,121,0,17,3,0,8,149
2020-01-24,대전,경기,2415,22,148,13,2,123,2723,3262,15,139,19,7,121,3563
2020-01-24,대전,경남,4502,8,105,24,7,141,4787,1598,2,81,4,4,62,1751
2020-01-24,대전,경북,4348,8,55,20,5,166,4602,2815,5,57,7,8,102,2994
2020-01-24,대전,광주,1089,1,5,1,1,27,1124,613,3,5,1,0,22,644
2020-01-24,대전,대구,1999,6,26,10,4,48,2093,1779,1,31,13,13,72,1909
2020-01-24,대전,대전,11639,63,110,13,6,633,12464,11639,63,110,13,6,633,12464
2020-01-24,대전,부산,377,1,0,0,2,12,392,109,0,2,0,15,2,128
2020-01-24,대전,서울,2390,6,267,4,0,101,2768,3263,3,257,4,0,109,3636
2020-01-24,대전,세종,2677,28,24,2,1,137,2869,2497,25,14,8,3,133,2680
2020-01-24,대전,울산,306,0,9,1,1,5,322,385,0,10,1,3,10,409
2020-01-24,대전,전남,1095,1,2,3,4,45,1150,503,1,3,1,10,12,530
2020-01-24,대전,전북,5700,24,50,4,5,197,5980,3493,39,49,4,6,118,3709
2020-01-24,대전,충남,16513,74,197,20,31,751,17586,10411,65,208,12,14,472,11182
2020-01-24,대전,충북,8995,116,177,16,7,434,9745,5937,57,151,14,5,290,6454
2020-01-24,부산,강원,18,0,1,0,0,1,20,14,0,1,0,0,1,16
2020-01-24,부산,경기,177,1,17,19,37,6,257,853,1,17,16,20,39,946
2020-01-24,부산,경남,100593,757,1540,181,897,4760,108728,91335,708,1695,243,815,4459,99255
2020-01-24,부산,경북,11732,32,234,26,101,419,12544,8356,22,233,18,76,340,9045
2020-01-24,부산,광주,880,3,35,5,11,18,952,948,2,53,4,10,23,1040
2020-01-24,부산,대구,5033,10,158,13,38,195,5447,1178,4,55,17,46,42,1342
2020-01-24,부산,대전,109,0,2,0,15,2,128,377,1,0,0,2,12,392
2020-01-24,부산,부산,41925,164,150,49,482,1879,44649,41925,164,150,49,482,1879,44649
2020-01-24,부산,서울,181,0,20,8,3,10,222,510,2,44,2,12,13,583
2020-01-24,부산,세종,22,0,1,1,4,0,28,133,0,0,1,4,4,142
2020-01-24,부산,울산,16832,114,133,71,850,881,18881,23523,114,73,52,734,1084,25580
2020-01-24,부산,전남,4615,10,44,14,166,118,4967,2778,9,52,15,176,93,3123
2020-01-24,부산,전북,919,0,14,4,23,35,995,579,1,26,0,16,20,642
2020-01-24,부산,충남,268,0,10,4,15,10,307,679,0,9,2,36,14,740
2020-01-24,부산,충북,188,0,4,3,41,7,243,657,1,6,11,24,20,719
2020-01-24,서울,강원,2653,10,409,2,2,58,3134,791,7,296,3,4,35,1136
2020-01-24,서울,경기,123113,1540,3461,816,382,5589,134901,112344,2028,3655,975,431,6136,125569
2020-01-24,서울,경남,11781,9,1025,49,18,298,13180,3806,5,613,25,15,129,4593
2020-01-24,서울,경북,12179,20,371,40,9,291,12910,4027,11,307,23,8,136,4512
2020-01-24,서울,광주,4210,9,391,7,5,65,4687,1210,3,16,2,0,38,1269
2020-01-24,서울,대구,5245,3,303,15,3,130,5699,4698,9,270,27,10,150,5164
2020-01-24,서울,대전,3263,3,257,4,0,109,3636,2390,6,267,4,0,101,2768
2020-01-24,서울,부산,510,2,44,2,12,13,583,181,0,20,8,3,10,222
2020-01-24,서울,서울,191,5,10,2,2,13,223,191,5,10,2,2,13,223
2020-01-24,서울,세종,85,2,4,0,0,2,93,104,0,0,0,0,3,107
2020-01-24,서울,울산,120,0,31,0,0,3,154,129,0,15,0,1,3,148
2020-01-24,서울,전남,8391,10,231,8,1,169,8810,1512,3,26,5,4,42,1592
2020-01-24,서울,전북,9239,7,472,5,7,237,9967,1891,1,41,3,8,66,2010
2020-01-24,서울,충남,52179,70,1560,121,72,1599,55601,33195,84,2144,71,72,1316,36882
2020-01-24,서울,충북,30018,62,935,73,42,885,32015,15851,60,772,116,57,697,17553
2020-01-24,세종,강원,23,0,0,0,0,0,23,3,0,0,0,0,0,3
2020-01-24,세종,경기,212,1,2,1,1,3,220,146,1,1,1,1,4,154
2020-01-24,세종,경남,2844,1,17,6,2,58,2928,475,2,10,0,1,14,502
2020-01-24,세종,경북,1288,1,8,7,2,28,1334,428,0,9,4,2,21,464
2020-01-24,세종,광주,954,0,7,3,1,20,985,174,0,2,0,0,5,181
2020-01-24,세종,대구,929,0,1,0,2,13,945,492,0,7,1,6,16,522
2020-01-24,세종,대전,2497,25,14,8,3,133,2680,2677,28,24,2,1,137,2869
2020-01-24,세종,부산,133,0,0,1,4,4,142,22,0,1,1,4,0,28
2020-01-24,세종,서울,104,0,0,0,0,3,107,85,2,4,0,0,2,93
2020-01-24,세종,세종,613,18,4,1,1,31,668,613,18,4,1,1,31,668
2020-01-24,세종,울산,69,0,0,0,0,1,70,61,0,0,0,1,1,63
2020-01-24,세종,전남,1330,1,4,2,3,26,1366,278,0,0,0,3,6,287
2020-01-24,세종,전북,2466,7,11,8,5,60,2557,736,6,5,1,6,18,772
2020-01-24,세종,충남,11543,65,51,41,29,387,12116,5523,66,51,19,40,196,5895
2020-01-24,세종,충북,553,1,8,4,0,24,590,286,4,5,2,2,14,313
2020-01-24,울산,강원,8,0,1,0,0,0,9,6,0,0,0,1,0,7
2020-01-24,울산,경기,153,0,3,4,11,4,175,154,0,5,1,4,4,168
2020-01-24,울산,경남,15502,140,273,52,132,686,16785,11419,170,264,89,93,541,12576
2020-01-24,울산,경북,11985,26,102,49,369,489,13020,7109,38,117,89,356,305,8014
2020-01-24,울산,광주,314,0,12,2,1,5,334,96,0,10,0,0,3,109
2020-01-24,울산,대구,3330,9,97,10,94,125,3665,2021,11,100,11,58,74,2275
2020-01-24,울산,대전,385,0,10,1,3,10,409,306,0,9,1,1,5,322
2020-01-24,울산,부산,23523,114,73,52,734,1084,25580,16832,114,133,71,850,881,18881
2020-01-24,울산,서울,129,0,15,0,1,3,148,120,0,31,0,0,3,154
2020-01-24,울산,세종,61,0,0,0,1,1,63,69,0,0,0,0,1,70
2020-01-24,울산,울산,6256,49,62,21,66,452,6906,6256,49,62,21,66,452,6906
2020-01-24,울산,전남,925,3,5,8,10,19,970,289,3,5,4,11,17,329
2020-01-24,울산,전북,353,0,9,0,10,8,380,72,0,5,2,3,1,83
2020-01-24,울산,충남,576,0,2,5,19,13,615,426,0,4,7,27,5,469
2020-01-24,울산,충북,112,0,2,3,7,1,125,124,0,0,0,4,7,135
2020-01-24,전남,강원,134,1,1,0,3,4,143,136,0,1,0,0,3,140
2020-01-24,전남,경기,1750,1,65,17,19,51,1903,8006,6,119,20,11,188,8350
2020-01-24,전남,경남,8036,82,193,85,218,290,8904,14400,83,187,97,269,481,15517
2020-01-24,전남,경북,2091,10,23,12,197,55,2388,3148,8,19,16,83,98,3372
2020-01-24,전남,광주,37651,328,668,66,168,875,39756,58014,344,700,84,172,1592,60906
2020-01-24,전남,대구,853,5,37,7,14,27,943,1383,3,37,5,14,44,1486
2020-01-24,전남,대전,503,1,3,1,10,12,530,1095,1,2,3,4,45,1150
2020-01-24,전남,부산,2778,9,52,15,176,93,3123,4615,10,44,14,166,118,4967
2020-01-24,전남,서울,1512,3,26,5,4,42,1592,8391,10,231,8,1,169,8810
2020-01-24,전남,세종,278,0,0,0,3,6,287,1330,1,4,2,3,26,1366
2020-01-24,전남,울산,289,3,5,4,11,17,329,925,3,5,8,10,19,970
2020-01-24,전남,전남,91084,409,697,218,497,2033,94938,91084,409,697,218,497,2033,94938
2020-01-24,전남,전북,9225,69,180,128,392,267,10261,18366,74,191,168,478,392,19669
2020-01-24,전남,충남,7428,10,365,52,140,205,8200,28957,13,296,79,157,633,30135
2020-01-24,전남,충북,723,3,9,5,34,27,801,1977,0,8,13,53,49,2100
2020-01-24,전북,강원,283,1,2,2,1,11,300,216,1,2,1,0,15,235
2020-01-24,전북,경기,2244,1,76,21,23,72,2437,9259,9,161,12,30,260,9731
2020-01-24,전북,경남,2433,11,70,14,17,75,2620,3971,10,84,16,16,122,4219
2020-01-24,전북,경북,2340,28,54,21,39,58,2540,3823,23,47,27,26,97,4043
2020-01-24,전북,광주,11021,137,215,66,48,287,11774,10803,125,214,48,29,324,11543
2020-01-24,전북,대구,561,2,27,3,4,18,615,854,1,32,3,5,27,922
2020-01-24,전북,대전,3493,39,49,4,6,118,3709,5700,24,50,4,5,197,5980
2020-01-24,전북,부산,579,1,26,0,16,20,642,919,0,14,4,23,35,995
2020-01-24,전북,서울,1891,1,41,3,8,66,2010,9239,7,472,5,7,237,9967
2020-01-24,전북,세종,736,6,5,1,6,18,772,2466,7,11,8,5,60,2557
2020-01-24,전북,울산,72,0,5,2,3,1,83,353,0,9,0,10,8,380
2020-01-24,전북,전남,18366,74,191,168,478,392,19669,9225,69,180,128,392,267,10261
2020-01-24,전북,전북,25049,220,374,133,108,728,26612,25049,220,374,133,108,728,26612
2020-01-24,전북,충남,17158,121,927,145,228,556,19135,42750,120,584,140,261,1211,45066
2020-01-24,전북,충북,2180,19,31,27,39,80,2376,4843,24,38,36,36,149,5126
2020-01-24,충남,강원,756,2,9,4,10,27,808,254,0,8,0,1,16,279
2020-01-24,충남,경기,35269,285,1153,257,615,1516,39095,61239,250,915,248,515,2161,65328
2020-01-24,충남,경남,8178,7,56,60,89,206,8596,2735,8,34,19,23,94,2913
2020-01-24,충남,경북,9225,11,76,52,92,252,9708,4616,12,57,48,85,151,4969
2020-01-24,충남,광주,17841,25,314,80,47,425,18732,6893,29,546,29,23,185,7705
2020-01-24,충남,대구,3787,3,20,29,29,117,3985,2807,3,28,24,34,73,2969
2020-01-24,충남,대전,10411,65,208,12,14,472,11182,16513,74,197,20,31,751,17586
2020-01-24,충남,부산,679,0,9,2,36,14,740,268,0,10,4,15,10,307
2020-01-24,충남,서울,33195,84,2144,71,72,1316,36882,52179,70,1560,121,72,1599,55601
2020-01-24,충남,세종,5523,66,51,19,40,196,5895,11543,65,51,41,29,387,12116
2020-01-24,충남,울산,426,0,4,7,27,5,469,576,0,2,5,19,13,615
2020-01-24,충남,전남,28957,13,296,79,157,633,30135,7428,10,365,52,140,205,8200
2020-01-24,충남,전북,42750,120,584,140,261,1211,45066,17158,121,927,145,228,556,19135
2020-01-24,충남,충남,153504,847,3443,715,1531,5017,165057,153504,847,3443,715,1531,5017,165057
2020-01-24,충남,충북,9967,87,203,91,195,399,10942,7021,123,197,62,151,315,7869
2020-01-24,충북,강원,7869,59,108,21,23,302,8382,5896,50,69,10,23,256,6304
2020-01-24,충북,경기,24323,420,647,359,478,1068,27295,57255,379,628,291,405,1764,60722
2020-01-24,충북,경남,10497,11,68,93,88,274,11031,3026,4,43,24,48,96,3241
2020-01-24,충북,경북,19603,49,188,97,124,548,20609,8502,39,152,79,128,265,9165
2020-01-24,충북,광주,1978,2,35,17,5,44,2081,907,3,33,9,2,25,979
2020-01-24,충북,대구,5484,15,53,43,38,128,5761,3682,13,79,26,84,104,3988
2020-01-24,충북,대전,5937,57,151,14,5,290,6454,8995,116,177,16,7,434,9745
2020-01-24,충북,부산,657,1,6,11,24,20,719,188,0,4,3,41,7,243
2020-01-24,충북,서울,15851,60,772,116,57,697,17553,30018,62,935,73,42,885,32015
2020-01-24,충북,세종,286,4,5,2,2,14,313,553,1,8,4,0,24,590
2020-01-24,충북,울산,124,0,0,0,4,7,135,112,0,2,3,7,1,125
2020-01-24,충북,전남,1977,0,8,13,53,49,2100,723,3,9,5,34,27,801
2020-01-24,충북,전북,4843,24,38,36,36,149,5126,2180,19,31,27,39,80,2376
2020-01-24,충북,충남,7021,123,197,62,151,315,7869,9967,87,203,91,195,399,10942
2020-01-24,충북,충북,43768,517,605,285,379,1486,47040,43768,517,605,285,379,1486,47040
2020-01-25,강원,강원,146565,346,1696,84,62,5766,154519,146565,346,1696,84,62,5766,154519
2020-01-25,강원,경기,52286,107,690,49,56,1959,55147,51362,87,669,14,54,1826,54012
2020-01-25,강원,경남,405,0,3,0,1,14,423,200,0,0,1,0,4,205
2020-01-25,강원,경북,2441,4,16,1,0,75,2537,1838,3,17,0,2,45,1905
2020-01-25,강원,광주,118,0,9,0,0,3,130,89,0,7,0,0,2,98
2020-01-25,강원,대구,384,2,2,0,0,14,402,576,2,7,0,0,15,600
2020-01-25,강원,대전,174,0,17,0,0,3,194,198,0,13,0,0,6,217
2020-01-25,강원,부산,5,0,0,0,0,0,5,11,0,0,0,0,0,11
2020-01-25,강원,서울,2378,7,418,1,0,87,2891,1928,2,330,0,0,56,2316
2020-01-25,강원,세종,12,0,0,0,0,0,12,6,0,0,0,0,1,7
2020-01-25,강원,울산,7,0,0,0,0,1,8,6,0,0,0,0,1,7
2020-01-25,강원,전남,91,0,0,0,0,1,92,80,0,0,1,0,2,83
2020-01-25,강원,전북,216,0,2,0,0,8,226,137,0,2,0,0,6,145
2020-01-25,강원,충남,339,0,8,0,0,11,358,409,1,10,0,0,6,426
2020-01-25,강원,충북,8890,13,58,2,7,333,9303,9216,8,71,0,8,306,9609
2020-01-25,경기,강원,51362,87,669,14,54,1826,54012,52286,107,690,49,56,1959,55147
2020-01-25,경기,경기,442540,1359,3771,589,740,19648,468647,442540,1359,3771,589,740,19648,468647
2020-01-25,경기,경남,6310,8,160,14,11,162,6665,3408,8,106,8,3,89,3622
2020-01-25,경기,경북,14556,13,111,11,21,395,15107,11448,17,72,13,12,336,11898
2020-01-25,경기,광주,2389,3,132,4,1,43,2572,1255,1,122,2,2,36,1418
2020-01-25,경기,대구,4492,3,77,9,4,128,4713,3847,5,68,6,5,104,4035
2020-01-25,경기,대전,3778,2,134,1,2,122,4039,3422,2,117,5,0,126,3672
2020-01-25,경기,부산,213,0,7,0,1,6,227,204,2,14,1,1,9,231
2020-01-25,경기,서울,146229,402,2827,374,105,6247,156184,130007,366,2729,375,84,5734,139295
2020-01-25,경기,세종,103,0,0,2,0,4,109,75,0,1,0,0,4,80
2020-01-25,경기,울산,70,0,2,2,4,0,78,57,0,4,0,3,2,66
2020-01-25,경기,전남,4066,4,66,2,8,87,4233,3020,3,61,2,6,69,3161
2020-01-25,경기,전북,6055,5,110,6,9,156,6341,4336,7,108,8,8,135,4602
2020-01-25,경기,충남,58343,100,726,68,160,1943,61340,52941,80,532,40,153,1720,55466
2020-01-25,경기,충북,46775,181,411,77,149,1481,49074,53563,169,388,81,152,1806,56159
2020-01-25,경남,강원,200,0,0,1,0,4,205,405,0,3,0,1,14,423
2020-01-25,경남,경기,3408,8,106,8,3,89,3622,6310,8,160,14,11,162,6665
2020-01-25,경남,경남,312393,693,2032,158,135,12769,328180,312393,693,2032,158,135,12769,328180
2020-01-25,경남,경북,33637,41,182,26,26,1129,35041,40473,51,219,49,27,1408,42227
2020-01-25,경남,광주,3316,1,87,5,2,89,3500,3673,1,88,2,0,100,3864
2020-01-25,경남,대구,32559,35,268,29,38,1168,34097,24828,18,245,9,16,790,25906
2020-01-25,경남,대전,2767,0,66,0,1,66,2900,3172,2,71,1,0,88,3334
2020-01-25,경남,부산,134968,183,1250,37,77,5515,142030,132426,191,1142,30,75,5751,139615
2020-01-25,경남,서울,2851,5,507,4,0,73,3440,5326,5,488,0,2,161,5982
2020-01-25,경남,세종,1404,0,7,0,0,36,1447,1004,1,11,0,0,31,1047
2020-01-25,경남,울산,18577,41,198,11,27,859,19713,18089,35,203,7,25,818,19177
2020-01-25,경남,전남,16244,32,132,16,35,476,16935,16879,31,141,14,41,510,17616
2020-01-25,경남,전북,4503,11,62,6,4,133,4719,4788,12,73,4,1,147,5025
2020-01-25,경남,충남,4583,3,19,4,6,128,4743,5005,4,26,7,6,129,5177
2020-01-25,경남,충북,6195,0,37,8,10,169,6419,4609,2,33,19,13,110,4786
2020-01-25,경북,강원,1838,3,17,0,2,45,1905,2441,4,16,1,0,75,2537
2020-01-25,경북,경기,11448,17,72,13,12,336,11898,14556,13,111,11,21,395,15107
2020-01-25,경북,경남,40473,51,219,49,27,1408,42227,33637,41,182,26,26,1129,35041
2020-01-25,경북,경북,187860,340,838,85,119,5937,195179,187860,340,838,85,119,5937,195179
2020-01-25,경북,광주,2541,5,23,6,1,55,2631,2584,6,18,6,1,59,2674
2020-01-25,경북,대구,122473,173,723,49,41,4218,127677,123273,179,754,61,36,4071,128374
2020-01-25,경북,대전,4841,2,45,2,1,154,5045,5123,5,41,1,0,168,5338
2020-01-25,경북,부산,15656,7,174,1,9,507,16354,16389,8,194,6,19,527,17143
2020-01-25,경북,서울,6104,4,293,3,1,161,6566,8345,8,254,1,4,194,8806
2020-01-25,경북,세종,1041,0,4,2,1,34,1082,872,1,5,1,1,21,901
2020-01-25,경북,울산,16551,9,82,14,86,588,17330,14820,13,74,8,76,534,15525
2020-01-25,경북,전남,3677,8,7,1,28,82,3803,3773,5,14,3,40,101,3936
2020-01-25,경북,전북,5217,10,19,9,5,111,5371,5285,11,26,3,4,118,5447
2020-01-25,경북,충남,8669,6,23,8,15,235,8956,8079,7,25,6,9,231,8357
2020-01-25,경북,충북,24533,23,149,18,32,581,25336,19723,14,106,19,31,512,20405
2020-01-25,광주,강원,89,0,7,0,0,2,98,118,0,9,0,0,3,130
2020-01-25,광주,경기,1255,1,122,2,2,36,1418,2389,3,132,4,1,43,2572
2020-01-25,광주,경남,3673,1,88,2,0,100,3864,3316,1,87,5,2,89,3500
2020-01-25,광주,경북,2584,6,18,6,1,59,2674,2541,5,23,6,1,55,2631
2020-01-25,광주,광주,26340,43,323,3,1,571,27281,26340,43,323,3,1,571,27281
2020-01-25,광주,대구,1129,1,45,1,0,16,1192,1292,2,47,2,0,27,1370
2020-01-25,광주,대전,1001,0,2,0,0,27,1030,1061,1,3,0,0,30,1095
2020-01-25,광주,부산,534,0,15,0,0,15,564,725,0,20,0,0,20,765
2020-01-25,광주,서울,1112,5,262,0,0,26,1405,1764,3,123,0,0,42,1932
2020-01-25,광주,세종,474,0,0,0,0,11,485,306,0,0,0,0,10,316
2020-01-25,광주,울산,121,0,9,0,0,2,132,125,0,6,0,0,2,133
2020-01-25,광주,전남,66455,109,511,19,23,1410,68527,67221,122,453,16,16,1306,69134
2020-01-25,광주,전북,13917,26,116,2,7,331,14399,14884,27,127,7,12,345,15402
2020-01-25,광주,충남,12193,6,193,12,6,268,12678,9971,7,310,15,7,242,10552
2020-01-25,광주,충북,1350,3,27,3,0,30,1413,1494,1,25,2,1,37,1560
2020-01-25,대구,강원,576,2,7,0,0,15,600,384,2,2,0,0,14,402
2020-01-25,대구,경기,3847,5,68,6,5,104,4035,4492,3,77,9,4,128,4713
2020-01-25,대구,경남,24828,18,245,9,16,790,25906,32559,35,268,29,38,1168,34097
2020-01-25,대구,경북,123273,179,754,61,36,4071,128374,122473,173,723,49,41,4218,127677
2020-01-25,대구,광주,1292,2,47,2,0,27,1370,1129,1,45,1,0,16,1192
2020-01-25,대구,대구,65522,83,216,19,14,2517,68371,65522,83,216,19,14,2517,68371
2020-01-25,대구,대전,2614,1,20,0,0,95,2730,2048,2,18,0,0,42,2110
2020-01-25,대구,부산,1607,1,21,0,1,42,1672,6091,1,81,4,0,165,6342
2020-01-25,대구,서울,2869,2,205,1,0,90,3167,3405,1,145,0,0,75,3626
2020-01-25,대구,세종,786,0,2,0,0,20,808,518,0,1,0,0,8,527
2020-01-25,대구,울산,4014,2,74,2,20,139,4251,4018,1,74,2,25,126,4246
2020-01-25,대구,전남,1561,2,16,1,2,40,1622,1274,3,15,1,3,42,1338
2020-01-25,대구,전북,979,1,22,2,0,26,1030,901,0,23,0,0,23,947
2020-01-25,대구,충남,4659,0,11,1,8,87,4766,2962,0,7,3,1,77,3050
2020-01-25,대구,충북,5598,6,51,6,11,170,5842,3541,5,33,9,7,90,3685
2020-01-25,대전,강원,198,0,13,0,0,6,217,174,0,17,0,0,3,194
2020-01-25,대전,경기,3422,2,117,5,0,126,3672,3778,2,134,1,2,122,4039
2020-01-25,대전,경남,3172,2,71,1,0,88,3334,2767,0,66,0,1,66,2900
2020-01-25,대전,경북,5123,5,41,1,0,168,5338,4841,2,45,2,1,154,5045
2020-01-25,대전,광주,1061,1,3,0,0,30,1095,1001,0,2,0,0,27,1030
2020-01-25,대전,대구,2048,2,18,0,0,42,2110,2614,1,20,0,0,95,2730
2020-01-25,대전,대전,17056,11,57,2,3,714,17843,17056,11,57,2,3,714,17843
2020-01-25,대전,부산,184,1,1,0,0,4,190,236,0,5,0,0,8,249
2020-01-25,대전,서울,2780,2,267,0,0,82,3131,3285,2,230,1,0,125,3643
2020-01-25,대전,세종,4137,2,10,0,2,159,4310,3559,2,7,1,1,138,3708
2020-01-25,대전,울산,267,0,9,0,0,7,283,255,0,8,0,0,10,273
2020-01-25,대전,전남,1164,0,4,0,4,36,1208,951,0,0,0,2,30,983
2020-01-25,대전,전북,7059,13,39,0,0,242,7353,6759,10,41,4,3,240,7057
2020-01-25,대전,충남,20471,24,138,6,6,778,21423,20587,24,138,1,7,777,21534
2020-01-25,대전,충북,13897,20,149,3,1,572,14642,11422,28,153,3,3,468,12077
2020-01-25,부산,강원,11,0,0,0,0,0,11,5,0,0,0,0,0,5
2020-01-25,부산,경기,204,2,14,1,1,9,231,213,0,7,0,1,6,227
2020-01-25,부산,경남,132426,191,1142,30,75,5751,139615,134968,183,1250,37,77,5515,142030
2020-01-25,부산,경북,16389,8,194,6,19,527,17143,15656,7,174,1,9,507,16354
2020-01-25,부산,광주,725,0,20,0,0,20,765,534,0,15,0,0,15,564
2020-01-25,부산,대구,6091,1,81,4,0,165,6342,1607,1,21,0,1,42,1672
2020-01-25,부산,대전,236,0,5,0,0,8,249,184,1,1,0,0,4,190
2020-01-25,부산,부산,48359,34,76,14,34,1901,50418,48359,34,76,14,34,1901,50418
2020-01-25,부산,서울,145,0,45,0,0,3,193,178,0,17,0,0,7,202
2020-01-25,부산,세종,59,0,5,0,0,0,64,34,0,2,0,0,0,36
2020-01-25,부산,울산,31107,18,75,12,84,1261,32557,30959,27,49,13,100,1271,32419
2020-01-25,부산,전남,3739,4,24,2,25,122,3916,2868,4,20,0,19,69,2980
2020-01-25,부산,전북,664,1,11,0,5,23,704,506,0,8,1,4,13,532
2020-01-25,부산,충남,394,0,7,0,2,10,413,314,0,3,0,2,6,325
2020-01-25,부산,충북,274,0,8,2,0,6,290,175,0,2,0,2,5,184
2020-01-25,서울,강원,1928,2,330,0,0,56,2316,2378,7,418,1,0,87,2891
2020-01-25,서울,경기,130007,366,2729,375,84,5734,139295,146229,402,2827,374,105,6247,156184
2020-01-25,서울,경남,5326,5,488,0,2,161,5982,2851,5,507,4,0,73,3440
2020-01-25,서울,경북,8345,8,254,1,4,194,8806,6104,4,293,3,1,161,6566
2020-01-25,서울,광주,1764,3,123,0,0,42,1932,1112,5,262,0,0,26,1405
2020-01-25,서울,대구,3405,1,145,0,0,75,3626,2869,2,205,1,0,90,3167
2020-01-25,서울,대전,3285,2,230,1,0,125,3643,2780,2,267,0,0,82,3131
2020-01-25,서울,부산,178,0,17,0,0,7,202,145,0,45,0,0,3,193
2020-01-25,서울,서울,330,0,9,0,0,22,361,330,0,9,0,0,22,361
2020-01-25,서울,세종,73,0,2,0,0,6,81,54,0,4,0,0,1,59
2020-01-25,서울,울산,74,0,3,0,0,1,78,37,0,12,0,0,2,51
2020-01-25,서울,전남,3068,3,70,1,0,76,3218,2974,4,168,6,1,51,3204
2020-01-25,서울,전북,4381,4,190,2,1,105,4683,4010,2,392,0,3,90,4497
2020-01-25,서울,충남,44119,42,1486,19,21,1378,47065,40795,43,1320,14,18,1203,43393
2020-01-25,서울,충북,24360,28,809,27,16,700,25940,22933,31,916,39,15,741,24675
2020-01-25,세종,강원,6,0,0,0,0,1,7,12,0,0,0,0,0,12
2020-01-25,세종,경기,75,0,1,0,0,4,80,103,0,0,2,0,4,109
2020-01-25,세종,경남,1004,1,11,0,0,31,1047,1404,0,7,0,0,36,1447
2020-01-25,세종,경북,872,1,5,1,1,21,901,1041,0,4,2,1,34,1082
2020-01-25,세종,광주,306,0,0,0,0,10,316,474,0,0,0,0,11,485
2020-01-25,세종,대구,518,0,1,0,0,8,527,786,0,2,0,0,20,808
2020-01-25,세종,대전,3559,2,7,1,1,138,3708,4137,2,10,0,2,159,4310
2020-01-25,세종,부산,34,0,2,0,0,0,36,59,0,5,0,0,0,64
2020-01-25,세종,서울,54,0,4,0,0,1,59,73,0,2,0,0,6,81
2020-01-25,세종,세종,1136,0,1,0,1,44,1182,1136,0,1,0,1,44,1182
2020-01-25,세종,울산,20,0,0,0,1,0,21,41,0,0,0,0,2,43
2020-01-25,세종,전남,591,0,1,0,1,11,604,872,0,0,0,0,24,896
2020-01-25,세종,전북,1875,0,5,1,4,43,1928,2348,1,5,2,6,63,2425
2020-01-25,세종,충남,12344,16,32,8,16,340,12756,11834,12,31,2,12,330,12221
2020-01-25,세종,충북,713,0,0,4,0,32,749,586,0,0,0,0,15,601
2020-01-25,울산,강원,6,0,0,0,0,1,7,7,0,0,0,0,1,8
2020-01-25,울산,경기,57,0,4,0,3,2,66,70,0,2,2,4,0,78
2020-01-25,울산,경남,18089,35,203,7,25,818,19177,18577,41,198,11,27,859,19713
2020-01-25,울산,경북,14820,13,74,8,76,534,15525,16551,9,82,14,86,588,17330
2020-01-25,울산,광주,125,0,6,0,0,2,133,121,0,9,0,0,2,132
2020-01-25,울산,대구,4018,1,74,2,25,126,4246,4014,2,74,2,20,139,4251
2020-01-25,울산,대전,255,0,8,0,0,10,273,267,0,9,0,0,7,283
2020-01-25,울산,부산,30959,27,49,13,100,1271,32419,31107,18,75,12,84,1261,32557
2020-01-25,울산,서울,37,0,12,0,0,2,51,74,0,3,0,0,1,78
2020-01-25,울산,세종,41,0,0,0,0,2,43,20,0,0,0,1,0,21
2020-01-25,울산,울산,9577,7,57,13,14,482,10150,9577,7,57,13,14,482,10150
2020-01-25,울산,전남,419,1,0,0,2,20,442,351,0,0,3,2,5,361
2020-01-25,울산,전북,151,0,7,0,3,6,167,129,0,7,0,2,2,140
2020-01-25,울산,충남,346,0,3,1,5,9,364,353,0,2,1,4,14,374
2020-01-25,울산,충북,74,0,1,2,0,1,78,93,0,0,0,1,5,99
2020-01-25,전남,강원,80,0,0,1,0,2,83,91,0,0,0,0,1,92
2020-01-25,전남,경기,3020,3,61,2,6,69,3161,4066,4,66,2,8,87,4233
2020-01-25,전남,경남,16879,31,141,14,41,510,17616,16244,32,132,16,35,476,16935
2020-01-25,전남,경북,3773,5,14,3,40,101,3936,3677,8,7,1,28,82,3803
2020-01-25,전남,광주,67221,122,453,16,16,1306,69134,66455,109,511,19,23,1410,68527
2020-01-25,전남,대구,1274,3,15,1,3,42,1338,1561,2,16,1,2,40,1622
2020-01-25,전남,대전,951,0,0,0,2,30,983,1164,0,4,0,4,36,1208
2020-01-25,전남,부산,2868,4,20,0,19,69,2980,3739,4,24,2,25,122,3916
2020-01-25,전남,서울,2974,4,168,6,1,51,3204,3068,3,70,1,0,76,3218
2020-01-25,전남,세종,872,0,0,0,0,24,896,591,0,1,0,1,11,604
2020-01-25,전남,울산,351,0,0,3,2,5,361,419,1,0,0,2,20,442
2020-01-25,전남,전남,128954,150,404,37,88,2349,131982,128954,150,404,37,88,2349,131982
2020-01-25,전남,전북,18767,26,74,38,103,394,19402,17125,27,49,41,107,386,17735
2020-01-25,전남,충남,19095,5,107,8,40,429,19684,15567,9,211,9,40,314,16150
2020-01-25,전남,충북,1559,1,6,0,7,28,1601,1559,3,6,2,13,35,1618
2020-01-25,전북,강원,137,0,2,0,0,6,145,216,0,2,0,0,8,226
2020-01-25,전북,경기,4336,7,108,8,8,135,4602,6055,5,110,6,9,156,6341
2020-01-25,전북,경남,4788,12,73,4,1,147,5025,4503,11,62,6,4,133,4719
2020-01-25,전북,경북,5285,11,26,3,4,118,5447,5217,10,19,9,5,111,5371
2020-01-25,전북,광주,14884,27,127,7,12,345,15402,13917,26,116,2,7,331,14399
2020-01-25,전북,대구,901,0,23,0,0,23,947,979,1,22,2,0,26,1030
2020-01-25,전북,대전,6759,10,41,4,3,240,7057,7059,13,39,0,0,242,7353
2020-01-25,전북,부산,506,0,8,1,4,13,532,664,1,11,0,5,23,704
2020-01-25,전북,서울,4010,2,392,0,3,90,4497,4381,4,190,2,1,105,4683
2020-01-25,전북,세종,2348,1,5,2,6,63,2425,1875,0,5,1,4,43,1928
2020-01-25,전북,울산,129,0,7,0,2,2,140,151,0,7,0,3,6,167
2020-01-25,전북,전남,17125,27,49,41,107,386,17735,18767,26,74,38,103,394,19402
2020-01-25,전북,전북,41749,76,231,64,17,1024,43161,41749,76,231,64,17,1024,43161
2020-01-25,전북,충남,42274,48,372,35,87,1138,43954,35453,54,513,31,91,967,37109
2020-01-25,전북,충북,5958,3,13,17,20,171,6182,4348,6,9,11,14,153,4541
2020-01-25,충남,강원,409,1,10,0,0,6,426,339,0,8,0,0,11,358
2020-01-25,충남,경기,52941,80,532,40,153,1720,55466,58343,100,726,68,160,1943,61340
2020-01-25,충남,경남,5005,4,26,7,6,129,5177,4583,3,19,4,6,128,4743
2020-01-25,충남,경북,8079,7,25,6,9,231,8357,8669,6,23,8,15,235,8956
2020-01-25,충남,광주,9971,7,310,15,7,242,10552,12193,6,193,12,6,268,12678
2020-01-25,충남,대구,2962,0,7,3,1,77,3050,4659,0,11,1,8,87,4766
2020-01-25,충남,대전,20587,24,138,1,7,777,21534,20471,24,138,6,6,778,21423
2020-01-25,충남,부산,314,0,3,0,2,6,325,394,0,7,0,2,10,413
2020-01-25,충남,서울,40795,43,1320,14,18,1203,43393,44119,42,1486,19,21,1378,47065
2020-01-25,충남,세종,11834,12,31,2,12,330,12221,12344,16,32,8,16,340,12756
2020-01-25,충남,울산,353,0,2,1,4,14,374,346,0,3,1,5,9,364
2020-01-25,충남,전남,15567,9,211,9,40,314,16150,19095,5,107,8,40,429,19684
2020-01-25,충남,전북,35453,54,513,31,91,967,37109,42274,48,372,35,87,1138,43954
2020-01-25,충남,충남,198175,383,1917,187,455,5869,206986,198175,383,1917,187,455,5869,206986
2020-01-25,충남,충북,13460,30,168,21,32,476,14187,12507,32,156,18,38,499,13250
2020-01-25,충북,강원,9216,8,71,0,8,306,9609,8890,13,58,2,7,333,9303
2020-01-25,충북,경기,53563,169,388,81,152,1806,56159,46775,181,411,77,149,1481,49074
2020-01-25,충북,경남,4609,2,33,19,13,110,4786,6195,0,37,8,10,169,6419
2020-01-25,충북,경북,19723,14,106,19,31,512,20405,24533,23,149,18,32,581,25336
2020-01-25,충북,광주,1494,1,25,2,1,37,1560,1350,3,27,3,0,30,1413
2020-01-25,충북,대구,3541,5,33,9,7,90,3685,5598,6,51,6,11,170,5842
2020-01-25,충북,대전,11422,28,153,3,3,468,12077,13897,20,149,3,1,572,14642
2020-01-25,충북,부산,175,0,2,0,2,5,184,274,0,8,2,0,6,290
2020-01-25,충북,서울,22933,31,916,39,15,741,24675,24360,28,809,27,16,700,25940
2020-01-25,충북,세종,586,0,0,0,0,15,601,713,0,0,4,0,32,749
2020-01-25,충북,울산,93,0,0,0,1,5,99,74,0,1,2,0,1,78
2020-01-25,충북,전남,1559,3,6,2,13,35,1618,1559,1,6,0,7,28,1601
2020-01-25,충북,전북,4348,6,9,11,14,153,4541,5958,3,13,17,20,171,6182
2020-01-25,충북,충남,12507,32,156,18,38,499,13250,13460,30,168,21,32,476,14187
2020-01-25,충북,충북,71536,184,390,63,150,2052,74375,71536,184,390,63,150,2052,74375
2020-01-26,강원,강원,120492,457,1960,139,213,4895,128156,120492,457,1960,139,213,4895,128156
2020-01-26,강원,경기,60330,118,744,65,82,2095,63434,37751,97,751,49,103,1426,40177
2020-01-26,강원,경남,655,2,11,0,1,15,684,312,1,4,0,0,13,330
2020-01-26,강원,경북,1574,6,18,6,0,49,1653,1770,3,16,8,0,46,1843
2020-01-26,강원,광주,226,0,14,1,0,1,242,121,0,6,3,0,4,134
2020-01-26,강원,대구,490,4,7,1,0,9,511,938,0,7,1,1,23,970
2020-01-26,강원,대전,340,1,23,0,0,9,373,178,0,11,0,0,4,193
2020-01-26,강원,부산,14,0,1,0,0,0,15,11,0,1,0,0,0,12
2020-01-26,강원,서울,2714,3,452,1,2,87,3259,1194,1,274,1,1,39,1510
2020-01-26,강원,세종,14,0,0,0,0,2,16,4,0,1,0,0,0,5
2020-01-26,강원,울산,10,0,0,0,0,0,10,6,0,0,0,0,0,6
2020-01-26,강원,전남,151,0,1,0,0,0,152,100,0,0,0,0,3,103
2020-01-26,강원,전북,290,0,3,2,0,8,303,216,1,3,0,0,5,225
2020-01-26,강원,충남,662,0,10,1,0,23,696,356,0,10,0,3,16,385
2020-01-26,강원,충북,8681,32,95,13,17,347,9185,7611,18,88,13,22,304,8056
2020-01-26,경기,강원,37751,97,751,49,103,1426,40177,60330,118,744,65,82,2095,63434
2020-01-26,경기,경기,343612,2408,4531,1373,1521,17276,370721,343612,2408,4531,1373,1521,17276,370721
2020-01-26,경기,경남,4732,10,182,39,25,145,5133,7604,3,151,28,10,166,7962
2020-01-26,경기,경북,5821,19,137,72,24,212,6285,17066,29,99,56,17,460,17727
2020-01-26,경기,광주,1470,2,129,13,2,35,1651,2532,2,174,6,1,58,2773
2020-01-26,경기,대구,2706,3,101,33,9,64,2916,9088,3,104,20,13,222,9450
2020-01-26,경기,대전,2383,6,146,2,0,103,2640,3651,10,127,3,2,128,3921
2020-01-26,경기,부산,151,0,5,2,0,8,166,683,0,27,5,4,23,742
2020-01-26,경기,서울,117884,763,3051,542,241,5550,128031,108333,806,2981,541,237,5630,118528
2020-01-26,경기,세종,83,1,0,3,1,3,91,80,1,1,1,1,3,87
2020-01-26,경기,울산,67,0,0,0,1,6,74,131,0,8,0,4,6,149
2020-01-26,경기,전남,1708,3,59,9,8,38,1825,6583,3,88,10,9,156,6849
2020-01-26,경기,전북,2374,5,73,12,19,81,2564,7611,2,140,12,10,223,7998
2020-01-26,경기,충남,37336,136,988,177,357,1514,40508,55118,118,611,136,296,1800,58079
2020-01-26,경기,충북,27288,271,519,190,236,1075,29579,48612,242,477,198,219,1593,51341
2020-01-26,경남,강원,312,1,4,0,0,13,330,655,2,11,0,1,15,684
2020-01-26,경남,경기,7604,3,151,28,10,166,7962,4732,10,182,39,25,145,5133
2020-01-26,경남,경남,221442,966,2383,314,316,10773,236194,221442,966,2383,314,316,10773,236194
2020-01-26,경남,경북,23427,54,261,71,56,873,24742,35243,111,315,103,72,1348,37192
2020-01-26,경남,광주,2650,6,83,4,4,70,2817,3732,6,96,9,2,83,3928
2020-01-26,경남,대구,31735,76,394,87,94,1070,33456,19843,42,313,22,30,778,21028
2020-01-26,경남,대전,2713,2,70,0,2,86,2873,2330,0,72,1,0,93,2496
2020-01-26,경남,부산,109946,274,1412,64,227,4881,116804,88978,276,1284,61,249,4494,95342
2020-01-26,경남,서울,7578,2,662,16,5,155,8418,4997,5,561,10,6,188,5767
2020-01-26,경남,세종,2239,0,7,2,3,54,2305,450,0,12,0,0,15,477
2020-01-26,경남,울산,17485,65,219,39,57,822,18687,13442,48,212,26,60,630,14418
2020-01-26,경남,전남,10847,39,154,36,89,375,11540,16254,46,181,33,79,497,17090
2020-01-26,경남,전북,3527,9,62,9,3,85,3695,4499,8,81,6,4,115,4713
2020-01-26,경남,충남,4477,6,44,11,9,126,4673,3572,8,38,15,26,105,3764
2020-01-26,경남,충북,6912,2,68,20,29,175,7206,3678,10,75,43,37,124,3967
2020-01-26,경북,강원,1770,3,16,8,0,46,1843,1574,6,18,6,0,49,1653
2020-01-26,경북,경기,17066,29,99,56,17,460,17727,5821,19,137,72,24,212,6285
2020-01-26,경북,경남,35243,111,315,103,72,1348,37192,23427,54,261,71,56,873,24742
2020-01-26,경북,경북,125731,426,965,178,217,4436,131953,125731,426,965,178,217,4436,131953
2020-01-26,경북,광주,1956,7,36,25,4,45,2073,2579,12,34,24,3,72,2724
2020-01-26,경북,대구,90522,226,801,95,87,3522,95253,83321,268,914,129,123,3153,87908
2020-01-26,경북,대전,4454,5,46,1,3,188,4697,3254,5,47,1,2,148,3457
2020-01-26,경북,부산,13264,23,191,4,27,440,13949,12681,15,237,3,36,422,13394
2020-01-26,경북,서울,11307,11,350,4,5,269,11946,4555,5,287,6,6,142,5001
2020-01-26,경북,세종,1305,1,5,5,1,33,1350,455,0,5,3,0,13,476
2020-01-26,경북,울산,13215,11,96,37,191,496,14046,9114,10,86,14,178,349,9751
2020-01-26,경북,전남,2510,5,23,14,57,69,2678,4193,7,23,12,81,85,4401
2020-01-26,경북,전북,3329,14,47,21,11,86,3508,4871,11,41,18,18,121,5080
2020-01-26,경북,충남,8365,8,40,17,43,259,8732,4965,15,50,20,44,157,5251
2020-01-26,경북,충북,20366,31,189,67,90,529,21272,10137,29,134,47,77,339,10763
2020-01-26,광주,강원,121,0,6,3,0,4,134,226,0,14,1,0,1,242
2020-01-26,광주,경기,2532,2,174,6,1,58,2773,1470,2,129,13,2,35,1651
2020-01-26,광주,경남,3732,6,96,9,2,83,3928,2650,6,83,4,4,70,2817
2020-01-26,광주,경북,2579,12,34,24,3,72,2724,1956,7,36,25,4,45,2073
2020-01-26,광주,광주,19252,70,388,18,11,514,20253,19252,70,388,18,11,514,20253
2020-01-26,광주,대구,1318,4,43,8,0,41,1414,1132,5,49,8,1,25,1220
2020-01-26,광주,대전,1139,1,9,1,0,30,1180,761,1,2,0,1,12,777
2020-01-26,광주,부산,918,0,17,1,1,17,954,994,0,39,0,3,35,1071
2020-01-26,광주,서울,3374,4,417,2,0,58,3855,1375,4,19,1,2,41,1442
2020-01-26,광주,세종,783,0,1,0,1,11,796,177,0,3,0,2,7,189
2020-01-26,광주,울산,232,0,12,0,0,2,246,78,0,9,0,0,3,90
2020-01-26,광주,전남,46875,132,640,67,79,1195,48988,54557,123,512,63,79,1269,56603
2020-01-26,광주,전북,13399,40,146,20,19,305,13929,12348,41,164,21,17,313,12904
2020-01-26,광주,충남,14175,14,178,32,11,303,14713,6267,16,573,32,4,164,7056
2020-01-26,광주,충북,1581,6,34,6,2,40,1669,1084,1,27,9,2,27,1150
2020-01-26,대구,강원,938,0,7,1,1,23,970,490,4,7,1,0,9,511
2020-01-26,대구,경기,9088,3,104,20,13,222,9450,2706,3,101,33,9,64,2916
2020-01-26,대구,경남,19843,42,313,22,30,778,21028,31735,76,394,87,94,1070,33456
2020-01-26,대구,경북,83321,268,914,129,123,3153,87908,90522,226,801,95,87,3522,95253
2020-01-26,대구,광주,1132,5,49,8,1,25,1220,1318,4,43,8,0,41,1414
2020-01-26,대구,대구,47194,122,292,47,36,2133,49824,47194,122,292,47,36,2133,49824
2020-01-26,대구,대전,2947,0,25,2,2,73,3049,1183,0,17,0,1,47,1248
2020-01-26,대구,부산,1214,2,19,2,38,31,1306,7350,10,123,9,26,241,7759
2020-01-26,대구,서울,7972,5,306,4,0,175,8462,2606,4,163,1,0,86,2860
2020-01-26,대구,세종,1392,0,6,0,1,33,1432,236,0,1,0,0,10,247
2020-01-26,대구,울산,3402,2,78,3,52,147,3684,2431,1,81,5,66,104,2688
2020-01-26,대구,전남,1156,2,18,4,9,47,1236,1548,4,17,3,5,34,1611
2020-01-26,대구,전북,738,0,25,0,2,24,789,978,1,27,0,0,29,1035
2020-01-26,대구,충남,5097,6,23,12,11,146,5295,1684,4,12,10,9,51,1770
2020-01-26,대구,충북,6753,12,82,25,39,164,7075,2448,10,65,15,11,83,2632
2020-01-26,대전,강원,178,0,11,0,0,4,193,340,1,23,0,0,9,373
2020-01-26,대전,경기,3651,10,127,3,2,128,3921,2383,6,146,2,0,103,2640
2020-01-26,대전,경남,2330,0,72,1,0,93,2496,2713,2,70,0,2,86,2873
2020-01-26,대전,경북,3254,5,47,1,2,148,3457,4454,5,46,1,3,188,4697
2020-01-26,대전,광주,761,1,2,0,1,12,777,1139,1,9,1,0,30,1180
2020-01-26,대전,대구,1183,0,17,0,1,47,1248,2947,0,25,2,2,73,3049
2020-01-26,대전,대전,11915,23,95,13,1,662,12709,11915,23,95,13,1,662,12709
2020-01-26,대전,부산,141,0,1,0,0,4,146,355,1,3,0,0,7,366
2020-01-26,대전,서울,3524,3,271,2,0,111,3911,2268,5,237,0,0,103,2613
2020-01-26,대전,세종,3269,13,17,2,1,152,3454,2127,12,14,1,0,122,2276
2020-01-26,대전,울산,328,0,9,0,3,8,348,287,0,9,0,2,11,309
2020-01-26,대전,전남,642,0,8,1,1,12,664,1293,0,2,0,2,35,1332
2020-01-26,대전,전북,4665,13,47,1,1,163,4890,5886,10,43,0,1,216,6156
2020-01-26,대전,충남,11897,27,145,11,5,565,12650,15515,36,157,15,6,679,16408
2020-01-26,대전,충북,8886,42,168,6,8,425,9535,8173,37,145,4,6,450,8815
2020-01-26,부산,강원,11,0,1,0,0,0,12,14,0,1,0,0,0,15
2020-01-26,부산,경기,683,0,27,5,4,23,742,151,0,5,2,0,8,166
2020-01-26,부산,경남,88978,276,1284,61,249,4494,95342,109946,274,1412,64,227,4881,116804
2020-01-26,부산,경북,12681,15,237,3,36,422,13394,13264,23,191,4,27,440,13949
2020-01-26,부산,광주,994,0,39,0,3,35,1071,918,0,17,1,1,17,954
2020-01-26,부산,대구,7350,10,123,9,26,241,7759,1214,2,19,2,38,31,1306
2020-01-26,부산,대전,355,1,3,0,0,7,366,141,0,1,0,0,4,146
2020-01-26,부산,부산,51760,61,77,19,161,2196,54274,51760,61,77,19,161,2196,54274
2020-01-26,부산,서울,517,0,73,0,0,15,605,175,0,6,0,1,5,187
2020-01-26,부산,세종,179,0,2,0,0,3,184,19,0,2,0,0,1,22
2020-01-26,부산,울산,25659,42,84,29,221,1156,27191,21505,38,48,16,220,1061,22888
2020-01-26,부산,전남,3288,6,60,5,66,132,3557,4642,4,27,5,63,118,4859
2020-01-26,부산,전북,739,0,22,0,10,18,789,787,0,10,0,7,19,823
2020-01-26,부산,충남,822,0,7,0,5,12,846,281,0,0,1,0,3,285
2020-01-26,부산,충북,632,0,5,6,4,26,673,152,0,4,2,5,6,169
2020-01-26,서울,강원,1194,1,274,1,1,39,1510,2714,3,452,1,2,87,3259
2020-01-26,서울,경기,108333,806,2981,541,237,5630,118528,117884,763,3051,542,241,5550,128031
2020-01-26,서울,경남,4997,5,561,10,6,188,5767,7578,2,662,16,5,155,8418
2020-01-26,서울,경북,4555,5,287,6,6,142,5001,11307,11,350,4,5,269,11946
2020-01-26,서울,광주,1375,4,19,1,2,41,1442,3374,4,417,2,0,58,3855
2020-01-26,서울,대구,2606,4,163,1,0,86,2860,7972,5,306,4,0,175,8462
2020-01-26,서울,대전,2268,5,237,0,0,103,2613,3524,3,271,2,0,111,3911
2020-01-26,서울,부산,175,0,6,0,1,5,187,517,0,73,0,0,15,605
2020-01-26,서울,서울,334,2,2,0,0,15,353,334,2,2,0,0,15,353
2020-01-26,서울,세종,81,0,0,0,0,1,82,75,0,3,0,0,3,81
2020-01-26,서울,울산,80,0,4,0,0,3,87,95,0,18,0,1,1,115
2020-01-26,서울,전남,1698,1,19,6,0,44,1768,7909,6,299,9,1,165,8389
2020-01-26,서울,전북,2475,2,38,0,1,59,2575,9279,6,574,1,3,223,10086
2020-01-26,서울,충남,32926,36,1982,41,48,1235,36268,59766,55,1216,49,32,1639,62757
2020-01-26,서울,충북,14682,32,768,69,45,579,16175,24318,40,1026,73,39,800,26296
2020-01-26,세종,강원,4,0,1,0,0,0,5,14,0,0,0,0,2,16
2020-01-26,세종,경기,80,1,1,1,1,3,87,83,1,0,3,1,3,91
2020-01-26,세종,경남,450,0,12,0,0,15,477,2239,0,7,2,3,54,2305
2020-01-26,세종,경북,455,0,5,3,0,13,476,1305,1,5,5,1,33,1350
2020-01-26,세종,광주,177,0,3,0,2,7,189,783,0,1,0,1,11,796
2020-01-26,세종,대구,236,0,1,0,0,10,247,1392,0,6,0,1,33,1432
2020-01-26,세종,대전,2127,12,14,1,0,122,2276,3269,13,17,2,1,152,3454
2020-01-26,세종,부산,19,0,2,0,0,1,22,179,0,2,0,0,3,184
2020-01-26,세종,서울,75,0,3,0,0,3,81,81,0,0,0,0,1,82
2020-01-26,세종,세종,519,3,1,0,0,25,548,519,3,1,0,0,25,548
2020-01-26,세종,울산,35,0,0,0,0,0,35,48,0,0,0,0,0,48
2020-01-26,세종,전남,255,0,2,0,2,8,267,1085,1,2,1,1,25,1115
2020-01-26,세종,전북,991,2,5,2,6,32,1038,2607,3,5,2,4,61,2682
2020-01-26,세종,충남,5999,25,47,8,15,234,6328,9203,26,72,15,30,311,9657
2020-01-26,세종,충북,296,1,1,3,0,10,311,505,5,1,2,0,21,534
2020-01-26,울산,강원,6,0,0,0,0,0,6,10,0,0,0,0,0,10
2020-01-26,울산,경기,131,0,8,0,4,6,149,67,0,0,0,1,6,74
2020-01-26,울산,경남,13442,48,212,26,60,630,14418,17485,65,219,39,57,822,18687
2020-01-26,울산,경북,9114,10,86,14,178,349,9751,13215,11,96,37,191,496,14046
2020-01-26,울산,광주,78,0,9,0,0,3,90,232,0,12,0,0,2,246
2020-01-26,울산,대구,2431,1,81,5,66,104,2688,3402,2,78,3,52,147,3684
2020-01-26,울산,대전,287,0,9,0,2,11,309,328,0,9,0,3,8,348
2020-01-26,울산,부산,21505,38,48,16,220,1061,22888,25659,42,84,29,221,1156,27191
2020-01-26,울산,서울,95,0,18,0,1,1,115,80,0,4,0,0,3,87
2020-01-26,울산,세종,48,0,0,0,0,0,48,35,0,0,0,0,0,35
2020-01-26,울산,울산,7041,14,45,7,38,439,7584,7041,14,45,7,38,439,7584
2020-01-26,울산,전남,326,0,1,2,7,12,348,765,0,1,2,5,18,791
2020-01-26,울산,전북,103,0,6,0,1,4,114,272,0,6,0,2,7,287
2020-01-26,울산,충남,339,0,2,1,7,7,356,431,0,2,1,6,10,450
2020-01-26,울산,충북,87,0,1,1,5,2,96,85,0,1,0,3,3,92
2020-01-26,전남,강원,100,0,0,0,0,3,103,151,0,1,0,0,0,152
2020-01-26,전남,경기,6583,3,88,10,9,156,6849,1708,3,59,9,8,38,1825
2020-01-26,전남,경남,16254,46,181,33,79,497,17090,10847,39,154,36,89,375,11540
2020-01-26,전남,경북,4193,7,23,12,81,85,4401,2510,5,23,14,57,69,2678
2020-01-26,전남,광주,54557,123,512,63,79,1269,56603,46875,132,640,67,79,1195,48988
2020-01-26,전남,대구,1548,4,17,3,5,34,1611,1156,2,18,4,9,47,1236
2020-01-26,전남,대전,1293,0,2,0,2,35,1332,642,0,8,1,1,12,664
2020-01-26,전남,부산,4642,4,27,5,63,118,4859,3288,6,60,5,66,132,3557
2020-01-26,전남,서울,7909,6,299,9,1,165,8389,1698,1,19,6,0,44,1768
2020-01-26,전남,세종,1085,1,2,1,1,25,1115,255,0,2,0,2,8,267
2020-01-26,전남,울산,765,0,1,2,5,18,791,326,0,1,2,7,12,348
2020-01-26,전남,전남,93998,233,587,146,211,1920,97095,93998,233,587,146,211,1920,97095
2020-01-26,전남,전북,18374,42,138,75,200,413,19242,10936,38,129,68,236,254,11661
2020-01-26,전남,충남,25964,13,128,47,105,516,26773,7576,11,340,30,88,180,8225
2020-01-26,전남,충북,1875,2,6,4,20,48,1955,901,1,7,8,36,35,988
2020-01-26,전북,강원,216,1,3,0,0,5,225,290,0,3,2,0,8,303
2020-01-26,전북,경기,7611,2,140,12,10,223,7998,2374,5,73,12,19,81,2564
2020-01-26,전북,경남,4499,8,81,6,4,115,4713,3527,9,62,9,3,85,3695
2020-01-26,전북,경북,4871,11,41,18,18,121,5080,3329,14,47,21,11,86,3508
2020-01-26,전북,광주,12348,41,164,21,17,313,12904,13399,40,146,20,19,305,13929
2020-01-26,전북,대구,978,1,27,0,0,29,1035,738,0,25,0,2,24,789
2020-01-26,전북,대전,5886,10,43,0,1,216,6156,4665,13,47,1,1,163,4890
2020-01-26,전북,부산,787,0,10,0,7,19,823,739,0,22,0,10,18,789
2020-01-26,전북,서울,9279,6,574,1,3,223,10086,2475,2,38,0,1,59,2575
2020-01-26,전북,세종,2607,3,5,2,4,61,2682,991,2,5,2,6,32,1038
2020-01-26,전북,울산,272,0,6,0,2,7,287,103,0,6,0,1,4,114
2020-01-26,전북,전남,10936,38,129,68,236,254,11661,18374,42,138,75,200,413,19242
2020-01-26,전북,전북,29402,84,319,86,31,843,30765,29402,84,319,86,31,843,30765
2020-01-26,전북,충남,41512,60,321,66,111,1140,43210,19469,54,847,54,136,579,21139
2020-01-26,전북,충북,5840,12,29,29,32,171,6113,2912,11,23,17,28,82,3073
2020-01-26,충남,강원,356,0,10,0,3,16,385,662,0,10,1,0,23,696
2020-01-26,충남,경기,55118,118,611,136,296,1800,58079,37336,136,988,177,357,1514,40508
2020-01-26,충남,경남,3572,8,38,15,26,105,3764,4477,6,44,11,9,126,4673
2020-01-26,충남,경북,4965,15,50,20,44,157,5251,8365,8,40,17,43,259,8732
2020-01-26,충남,광주,6267,16,573,32,4,164,7056,14175,14,178,32,11,303,14713
2020-01-26,충남,대구,1684,4,12,10,9,51,1770,5097,6,23,12,11,146,5295
2020-01-26,충남,대전,15515,36,157,15,6,679,16408,11897,27,145,11,5,565,12650
2020-01-26,충남,부산,281,0,0,1,0,3,285,822,0,7,0,5,12,846
2020-01-26,충남,서울,59766,55,1216,49,32,1639,62757,32926,36,1982,41,48,1235,36268
2020-01-26,충남,세종,9203,26,72,15,30,311,9657,5999,25,47,8,15,234,6328
2020-01-26,충남,울산,431,0,2,1,6,10,450,339,0,2,1,7,7,356
2020-01-26,충남,전남,7576,11,340,30,88,180,8225,25964,13,128,47,105,516,26773
2020-01-26,충남,전북,19469,54,847,54,136,579,21139,41512,60,321,66,111,1140,43210
2020-01-26,충남,충남,165422,541,2758,454,725,5222,175122,165422,541,2758,454,725,5222,175122
2020-01-26,충남,충북,9397,53,171,45,96,361,10123,9882,47,179,38,93,452,10691
2020-01-26,충북,강원,7611,18,88,13,22,304,8056,8681,32,95,13,17,347,9185
2020-01-26,충북,경기,48612,242,477,198,219,1593,51341,27288,271,519,190,236,1075,29579
2020-01-26,충북,경남,3678,10,75,43,37,124,3967,6912,2,68,20,29,175,7206
2020-01-26,충북,경북,10137,29,134,47,77,339,10763,20366,31,189,67,90,529,21272
2020-01-26,충북,광주,1084,1,27,9,2,27,1150,1581,6,34,6,2,40,1669
2020-01-26,충북,대구,2448,10,65,15,11,83,2632,6753,12,82,25,39,164,7075
2020-01-26,충북,대전,8173,37,145,4,6,450,8815,8886,42,168,6,8,425,9535
2020-01-26,충북,부산,152,0,4,2,5,6,169,632,0,5,6,4,26,673
2020-01-26,충북,서울,24318,40,1026,73,39,800,26296,14682,32,768,69,45,579,16175
2020-01-26,충북,세종,505,5,1,2,0,21,534,296,1,1,3,0,10,311
2020-01-26,충북,울산,85,0,1,0,3,3,92,87,0,1,1,5,2,96
2020-01-26,충북,전남,901,1,7,8,36,35,988,1875,2,6,4,20,48,1955
2020-01-26,충북,전북,2912,11,23,17,28,82,3073,5840,12,29,29,32,171,6113
2020-01-26,충북,충남,9882,47,179,38,93,452,10691,9397,53,171,45,96,361,10123
2020-01-26,충북,충북,47496,232,488,135,266,1480,50097,47496,232,488,135,266,1480,50097
2020-01-27,강원,강원,75564,938,2153,325,471,4120,83571,75564,938,2153,325,471,4120,83571
2020-01-27,강원,경기,46361,251,935,212,171,1855,49785,23357,215,911,136,228,1192,26039
2020-01-27,강원,경남,592,1,9,2,2,20,626,270,0,3,4,5,14,296
2020-01-27,강원,경북,997,17,25,7,6,32,1084,1107,11,19,12,2,50,1201
2020-01-27,강원,광주,200,2,17,1,0,5,225,205,0,12,3,1,3,224
2020-01-27,강원,대구,546,3,4,3,1,21,578,765,3,15,6,1,26,816
2020-01-27,강원,대전,295,0,25,2,0,13,335,241,1,24,0,0,11,277
2020-01-27,강원,부산,14,0,0,0,0,0,14,15,0,0,0,0,1,16
2020-01-27,강원,서울,2137,10,362,4,3,53,2569,751,8,248,1,3,30,1041
2020-01-27,강원,세종,11,0,0,0,0,0,11,5,0,2,0,0,0,7
2020-01-27,강원,울산,10,0,0,0,1,0,11,4,0,0,0,0,0,4
2020-01-27,강원,전남,144,0,1,0,1,1,147,160,0,1,0,2,5,168
2020-01-27,강원,전북,231,1,1,3,1,16,253,312,2,3,5,0,12,334
2020-01-27,강원,충남,698,1,10,10,8,23,750,445,1,10,3,9,19,487
2020-01-27,강원,충북,6147,99,120,47,50,302,6765,5461,75,142,27,43,294,6042
2020-01-27,경기,강원,23357,215,911,136,228,1192,26039,46361,251,935,212,171,1855,49785
2020-01-27,경기,경기,274119,6175,7610,4017,3540,16728,312189,274119,6175,7610,4017,3540,16728,312189
2020-01-27,경기,경남,3907,18,283,125,43,153,4529,7229,7,202,127,65,218,7848
2020-01-27,경기,경북,4258,25,214,188,87,179,4951,12545,41,205,221,66,411,13489
2020-01-27,경기,광주,1080,3,135,39,8,30,1295,2745,5,209,44,7,81,3091
2020-01-27,경기,대구,2054,8,138,74,33,78,2385,10033,18,193,74,64,279,10661
2020-01-27,경기,대전,1729,27,160,15,4,92,2027,3265,41,160,21,11,145,3643
2020-01-27,경기,부산,166,1,9,16,8,2,202,991,4,30,12,25,33,1095
2020-01-27,경기,서울,87976,2407,4122,1203,558,4981,101247,101367,2404,4153,1254,584,6004,115766
2020-01-27,경기,세종,37,0,1,3,1,1,43,77,1,3,0,0,3,84
2020-01-27,경기,울산,66,0,0,0,5,6,77,127,1,8,0,12,7,155
2020-01-27,경기,전남,1190,2,63,17,14,41,1327,5293,8,105,32,14,155,5607
2020-01-27,경기,전북,1535,9,95,27,30,69,1765,6120,16,146,45,54,192,6573
2020-01-27,경기,충남,30569,412,1262,539,823,1510,35115,47979,388,1144,419,777,1939,52646
2020-01-27,경기,충북,21643,579,957,642,590,1111,25522,36049,580,913,619,452,1632,40245
2020-01-27,경남,강원,270,0,3,4,5,14,296,592,1,9,2,2,20,626
2020-01-27,경남,경기,7229,7,202,127,65,218,7848,3907,18,283,125,43,153,4529
2020-01-27,경남,경남,126349,3218,3574,1013,954,8165,143273,126349,3218,3574,1013,954,8165,143273
2020-01-27,경남,경북,13731,163,425,148,226,605,15298,19067,262,509,239,278,850,21205
2020-01-27,경남,광주,1822,12,109,36,14,57,2050,2177,10,106,33,6,73,2405
2020-01-27,경남,대구,22382,222,619,220,384,895,24722,11892,152,441,89,81,576,13231
2020-01-27,경남,대전,1862,3,87,29,16,70,2067,1793,4,87,11,3,79,1977
2020-01-27,경남,부산,63362,796,1594,221,643,3623,70239,61605,811,1512,214,794,3793,68729
2020-01-27,경남,서울,7329,17,692,110,36,180,8364,4355,16,588,24,8,147,5138
2020-01-27,경남,세종,1754,3,7,0,10,46,1820,348,0,14,0,1,15,378
2020-01-27,경남,울산,10074,228,280,69,98,476,11225,8329,213,287,57,100,470,9456
2020-01-27,경남,전남,7057,83,201,105,230,305,7981,8391,75,208,78,213,350,9315
2020-01-27,경남,전북,1939,13,63,34,28,67,2144,2667,14,73,32,20,81,2887
2020-01-27,경남,충남,3330,5,41,40,47,125,3588,2251,15,52,45,60,89,2512
2020-01-27,경남,충북,3755,8,68,67,91,141,4130,2517,20,93,97,105,115,2947
2020-01-27,경북,강원,1107,11,19,12,2,50,1201,997,17,25,7,6,32,1084
2020-01-27,경북,경기,12545,41,205,221,66,411,13489,4258,25,214,188,87,179,4951
2020-01-27,경북,경남,19067,262,509,239,278,850,21205,13731,163,425,148,226,605,15298
2020-01-27,경북,경북,65682,1139,1571,662,605,3223,72882,65682,1139,1571,662,605,3223,72882
2020-01-27,경북,광주,1453,14,58,52,16,41,1634,1704,16,43,45,13,50,1871
2020-01-27,경북,대구,53935,711,1119,295,241,2646,58947,56445,839,1318,373,346,2682,62003
2020-01-27,경북,대전,2808,18,72,38,21,140,3097,2270,13,68,7,6,92,2456
2020-01-27,경북,부산,6968,27,250,28,51,305,7629,7110,32,280,27,73,280,7802
2020-01-27,경북,서울,9083,16,363,83,24,272,9841,3462,13,298,41,9,136,3959
2020-01-27,경북,세종,919,2,9,9,1,39,979,321,1,8,5,2,17,354
2020-01-27,경북,울산,6584,35,134,165,341,312,7571,4909,33,109,60,424,229,5764
2020-01-27,경북,전남,1773,11,31,25,90,53,1983,2509,12,35,20,158,87,2821
2020-01-27,경북,전북,1945,23,75,54,35,74,2206,2476,30,70,52,27,71,2726
2020-01-27,경북,충남,5679,20,65,86,113,221,6184,3430,24,87,62,131,134,3868
2020-01-27,경북,충북,10635,56,220,193,224,434,11762,6187,64,265,153,193,261,7123
2020-01-27,광주,강원,205,0,12,3,1,3,224,200,2,17,1,0,5,225
2020-01-27,광주,경기,2745,5,209,44,7,81,3091,1080,3,135,39,8,30,1295
2020-01-27,광주,경남,2177,10,106,33,6,73,2405,1822,12,109,36,14,57,2050
2020-01-27,광주,경북,1704,16,43,45,13,50,1871,1453,14,58,52,16,41,1634
2020-01-27,광주,광주,10123,180,466,97,32,412,11310,10123,180,466,97,32,412,11310
2020-01-27,광주,대구,998,4,77,37,4,30,1150,959,4,80,12,3,32,1090
2020-01-27,광주,대전,837,6,7,5,6,25,886,585,6,11,2,3,15,622
2020-01-27,광주,부산,786,2,45,3,4,29,869,869,1,48,6,8,27,959
2020-01-27,광주,서울,3453,6,286,32,1,65,3843,922,4,15,5,3,41,990
2020-01-27,광주,세종,561,1,6,1,1,11,581,159,1,2,0,0,2,164
2020-01-27,광주,울산,165,0,11,0,1,3,180,76,0,10,1,1,1,89
2020-01-27,광주,전남,29287,354,760,152,145,1010,31708,32098,338,670,160,132,1203,34601
2020-01-27,광주,전북,9060,134,254,100,43,262,9853,8489,156,245,87,34,287,9298
2020-01-27,광주,충남,11812,25,343,131,57,300,12668,4721,25,632,114,30,160,5682
2020-01-27,광주,충북,1295,6,42,17,15,35,1410,785,6,35,32,16,28,902
2020-01-27,대구,강원,765,3,15,6,1,26,816,546,3,4,3,1,21,578
2020-01-27,대구,경기,10033,18,193,74,64,279,10661,2054,8,138,74,33,78,2385
2020-01-27,대구,경남,11892,152,441,89,81,576,13231,22382,222,619,220,384,895,24722
2020-01-27,대구,경북,56445,839,1318,373,346,2682,62003,53935,711,1119,295,241,2646,58947
2020-01-27,대구,광주,959,4,80,12,3,32,1090,998,4,77,37,4,30,1150
2020-01-27,대구,대구,35195,540,620,147,173,2012,38687,35195,540,620,147,173,2012,38687
2020-01-27,대구,대전,2009,1,31,15,5,75,2136,778,2,23,13,3,28,847
2020-01-27,대구,부산,558,5,49,15,31,15,673,5926,30,185,20,37,220,6418
2020-01-27,대구,서울,8276,6,348,40,18,222,8910,2081,13,202,12,3,56,2367
2020-01-27,대구,세종,1392,1,8,1,1,38,1441,182,0,1,0,0,6,189
2020-01-27,대구,울산,2135,12,105,12,77,83,2424,1454,16,95,15,79,52,1711
2020-01-27,대구,전남,806,0,26,10,20,28,890,953,5,27,7,4,33,1029
2020-01-27,대구,전북,539,0,29,3,4,23,598,619,2,31,3,3,18,676
2020-01-27,대구,충남,3761,14,32,36,58,149,4050,1085,6,19,20,21,40,1191
2020-01-27,대구,충북,5188,19,134,65,74,168,5648,1731,23,66,56,20,66,1962
2020-01-27,대전,강원,241,1,24,0,0,11,277,295,0,25,2,0,13,335
2020-01-27,대전,경기,3265,41,160,21,11,145,3643,1729,27,160,15,4,92,2027
2020-01-27,대전,경남,1793,4,87,11,3,79,1977,1862,3,87,29,16,70,2067
2020-01-27,대전,경북,2270,13,68,7,6,92,2456,2808,18,72,38,21,140,3097
2020-01-27,대전,광주,585,6,11,2,3,15,622,837,6,7,5,6,25,886
2020-01-27,대전,대구,778,2,23,13,3,28,847,2009,1,31,15,5,75,2136
2020-01-27,대전,대전,8325,131,119,44,6,623,9248,8325,131,119,44,6,623,9248
2020-01-27,대전,부산,96,0,1,0,0,2,99,279,0,4,3,1,9,296
2020-01-27,대전,서울,3080,5,238,5,1,128,3457,1619,7,253,5,2,87,1973
2020-01-27,대전,세종,2433,33,28,6,1,156,2657,1665,37,22,5,1,124,1854
2020-01-27,대전,울산,253,0,10,2,5,5,275,203,2,10,2,7,6,230
2020-01-27,대전,전남,503,1,9,5,6,18,542,839,0,2,3,3,26,873
2020-01-27,대전,전북,3115,27,40,6,4,145,3337,4356,45,57,18,16,183,4675
2020-01-27,대전,충남,9834,123,222,50,52,567,10848,9911,129,219,50,58,570,10937
2020-01-27,대전,충북,6896,166,239,33,23,463,7820,6263,139,225,33,18,435,7113
2020-01-27,부산,강원,15,0,0,0,0,1,16,14,0,0,0,0,0,14
2020-01-27,부산,경기,991,4,30,12,25,33,1095,166,1,9,16,8,2,202
2020-01-27,부산,경남,61605,811,1512,214,794,3793,68729,63362,796,1594,221,643,3623,70239
2020-01-27,부산,경북,7110,32,280,27,73,280,7802,6968,27,250,28,51,305,7629
2020-01-27,부산,광주,869,1,48,6,8,27,959,786,2,45,3,4,29,869
2020-01-27,부산,대구,5926,30,185,20,37,220,6418,558,5,49,15,31,15,673
2020-01-27,부산,대전,279,0,4,3,1,9,296,96,0,1,0,0,2,99
2020-01-27,부산,부산,30388,167,197,106,436,1686,32980,30388,167,197,106,436,1686,32980
2020-01-27,부산,서울,684,0,68,15,5,21,793,218,0,7,2,0,4,231
2020-01-27,부산,세종,193,0,0,0,1,5,199,11,0,0,0,0,0,11
2020-01-27,부산,울산,16684,92,124,151,673,903,18627,13469,98,83,69,720,766,15205
2020-01-27,부산,전남,2747,11,71,27,172,106,3134,2711,8,65,19,148,90,3041
2020-01-27,부산,전북,616,2,25,6,18,17,684,614,0,25,5,10,16,670
2020-01-27,부산,충남,558,5,13,10,12,12,610,169,2,8,5,8,5,197
2020-01-27,부산,충북,570,3,17,17,26,23,656,107,0,7,12,10,8,144
2020-01-27,서울,강원,751,8,248,1,3,30,1041,2137,10,362,4,3,53,2569
2020-01-27,서울,경기,101367,2404,4153,1254,584,6004,115766,87976,2407,4122,1203,558,4981,101247
2020-01-27,서울,경남,4355,16,588,24,8,147,5138,7329,17,692,110,36,180,8364
2020-01-27,서울,경북,3462,13,298,41,9,136,3959,9083,16,363,83,24,272,9841
2020-01-27,서울,광주,922,4,15,5,3,41,990,3453,6,286,32,1,65,3843
2020-01-27,서울,대구,2081,13,202,12,3,56,2367,8276,6,348,40,18,222,8910
2020-01-27,서울,대전,1619,7,253,5,2,87,1973,3080,5,238,5,1,128,3457
2020-01-27,서울,부산,218,0,7,2,0,4,231,684,0,68,15,5,21,793
2020-01-27,서울,서울,185,3,11,1,2,9,211,185,3,11,1,2,9,211
2020-01-27,서울,세종,37,0,0,0,0,1,38,80,1,1,0,0,1,83
2020-01-27,서울,울산,75,0,1,0,0,2,78,87,0,20,0,1,2,110
2020-01-27,서울,전남,1239,5,15,3,3,39,1304,7183,4,212,21,7,147,7574
2020-01-27,서울,전북,1499,4,25,1,4,41,1574,7569,12,342,12,11,191,8137
2020-01-27,서울,충남,27844,91,2265,222,166,1278,31866,51434,127,1573,390,171,1755,55450
2020-01-27,서울,충북,12585,107,871,201,149,630,14543,19012,114,956,194,103,787,21166
2020-01-27,세종,강원,5,0,2,0,0,0,7,11,0,0,0,0,0,11
2020-01-27,세종,경기,77,1,3,0,0,3,84,37,0,1,3,1,1,43
2020-01-27,세종,경남,348,0,14,0,1,15,378,1754,3,7,0,10,46,1820
2020-01-27,세종,경북,321,1,8,5,2,17,354,919,2,9,9,1,39,979
2020-01-27,세종,광주,159,1,2,0,0,2,164,561,1,6,1,1,11,581
2020-01-27,세종,대구,182,0,1,0,0,6,189,1392,1,8,1,1,38,1441
2020-01-27,세종,대전,1665,37,22,5,1,124,1854,2433,33,28,6,1,156,2657
2020-01-27,세종,부산,11,0,0,0,0,0,11,193,0,0,0,1,5,199
2020-01-27,세종,서울,80,1,1,0,0,1,83,37,0,0,0,0,1,38
2020-01-27,세종,세종,326,18,0,4,0,20,368,326,18,0,4,0,20,368
2020-01-27,세종,울산,26,0,0,0,0,2,28,51,0,0,0,0,1,52
2020-01-27,세종,전남,218,0,1,1,8,5,233,815,0,3,0,6,15,839
2020-01-27,세종,전북,742,6,8,3,8,31,798,1731,8,8,6,20,62,1835
2020-01-27,세종,충남,4331,83,66,25,35,201,4741,5439,60,86,27,34,241,5887
2020-01-27,세종,충북,168,4,11,2,0,10,195,313,8,9,3,2,21,356
2020-01-27,울산,강원,4,0,0,0,0,0,4,10,0,0,0,1,0,11
2020-01-27,울산,경기,127,1,8,0,12,7,155,66,0,0,0,5,6,77
2020-01-27,울산,경남,8329,213,287,57,100,470,9456,10074,228,280,69,98,476,11225
2020-01-27,울산,경북,4909,33,109,60,424,229,5764,6584,35,134,165,341,312,7571
2020-01-27,울산,광주,76,0,10,1,1,1,89,165,0,11,0,1,3,180
2020-01-27,울산,대구,1454,16,95,15,79,52,1711,2135,12,105,12,77,83,2424
2020-01-27,울산,대전,203,2,10,2,7,6,230,253,0,10,2,5,5,275
2020-01-27,울산,부산,13469,98,83,69,720,766,15205,16684,92,124,151,673,903,18627
2020-01-27,울산,서울,87,0,20,0,1,2,110,75,0,1,0,0,2,78
2020-01-27,울산,세종,51,0,0,0,0,1,52,26,0,0,0,0,2,28
2020-01-27,울산,울산,4304,42,82,36,68,321,4853,4304,42,82,36,68,321,4853
2020-01-27,울산,전남,292,1,5,4,7,10,319,463,1,3,0,3,18,488
2020-01-27,울산,전북,89,0,7,0,2,2,100,170,0,8,0,1,6,185
2020-01-27,울산,충남,359,0,4,6,28,7,404,261,0,3,3,20,5,292
2020-01-27,울산,충북,62,1,1,2,10,5,81,62,1,0,1,6,2,72
2020-01-27,전남,강원,160,0,1,0,2,5,168,144,0,1,0,1,1,147
2020-01-27,전남,경기,5293,8,105,32,14,155,5607,1190,2,63,17,14,41,1327
2020-01-27,전남,경남,8391,75,208,78,213,350,9315,7057,83,201,105,230,305,7981
2020-01-27,전남,경북,2509,12,35,20,158,87,2821,1773,11,31,25,90,53,1983
2020-01-27,전남,광주,32098,338,670,160,132,1203,34601,29287,354,760,152,145,1010,31708
2020-01-27,전남,대구,953,5,27,7,4,33,1029,806,0,26,10,20,28,890
2020-01-27,전남,대전,839,0,2,3,3,26,873,503,1,9,5,6,18,542
2020-01-27,전남,부산,2711,8,65,19,148,90,3041,2747,11,71,27,172,106,3134
2020-01-27,전남,서울,7183,4,212,21,7,147,7574,1239,5,15,3,3,39,1304
2020-01-27,전남,세종,815,0,3,0,6,15,839,218,0,1,1,8,5,233
2020-01-27,전남,울산,463,1,3,0,3,18,488,292,1,5,4,7,10,319
2020-01-27,전남,전남,49989,421,883,366,511,1661,53831,49989,421,883,366,511,1661,53831
2020-01-27,전남,전북,9493,101,338,233,420,254,10839,6638,93,309,247,419,187,7893
2020-01-27,전남,충남,19435,30,300,246,312,479,20802,6026,17,424,66,211,189,6933
2020-01-27,전남,충북,1184,4,13,23,53,32,1309,627,5,17,21,70,26,766
2020-01-27,전북,강원,312,2,3,5,0,12,334,231,1,1,3,1,16,253
2020-01-27,전북,경기,6120,16,146,45,54,192,6573,1535,9,95,27,30,69,1765
2020-01-27,전북,경남,2667,14,73,32,20,81,2887,1939,13,63,34,28,67,2144
2020-01-27,전북,경북,2476,30,70,52,27,71,2726,1945,23,75,54,35,74,2206
2020-01-27,전북,광주,8489,156,245,87,34,287,9298,9060,134,254,100,43,262,9853
2020-01-27,전북,대구,619,2,31,3,3,18,676,539,0,29,3,4,23,598
2020-01-27,전북,대전,4356,45,57,18,16,183,4675,3115,27,40,6,4,145,3337
2020-01-27,전북,부산,614,0,25,5,10,16,670,616,2,25,6,18,17,684
2020-01-27,전북,서울,7569,12,342,12,11,191,8137,1499,4,25,1,4,41,1574
2020-01-27,전북,세종,1731,8,8,6,20,62,1835,742,6,8,3,8,31,798
2020-01-27,전북,울산,170,0,8,0,1,6,185,89,0,7,0,2,2,100
2020-01-27,전북,전남,6638,93,309,247,419,187,7893,9493,101,338,233,420,254,10839
2020-01-27,전북,전북,13970,219,503,322,78,543,15635,13970,219,503,322,78,543,15635
2020-01-27,전북,충남,29130,128,740,286,328,975,31587,13872,129,1054,188,290,519,16052
2020-01-27,전북,충북,3217,36,75,96,66,121,3611,1863,37,68,71,64,87,2190
2020-01-27,충남,강원,445,1,10,3,9,19,487,698,1,10,10,8,23,750
2020-01-27,충남,경기,47979,388,1144,419,777,1939,52646,30569,412,1262,539,823,1510,35115
2020-01-27,충남,경남,2251,15,52,45,60,89,2512,3330,5,41,40,47,125,3588
2020-01-27,충남,경북,3430,24,87,62,131,134,3868,5679,20,65,86,113,221,6184
2020-01-27,충남,광주,4721,25,632,114,30,160,5682,11812,25,343,131,57,300,12668
2020-01-27,충남,대구,1085,6,19,20,21,40,1191,3761,14,32,36,58,149,4050
2020-01-27,충남,대전,9911,129,219,50,58,570,10937,9834,123,222,50,52,567,10848
2020-01-27,충남,부산,169,2,8,5,8,5,197,558,5,13,10,12,12,610
2020-01-27,충남,서울,51434,127,1573,390,171,1755,55450,27844,91,2265,222,166,1278,31866
2020-01-27,충남,세종,5439,60,86,27,34,241,5887,4331,83,66,25,35,201,4741
2020-01-27,충남,울산,261,0,3,3,20,5,292,359,0,4,6,28,7,404
2020-01-27,충남,전남,6026,17,424,66,211,189,6933,19435,30,300,246,312,479,20802
2020-01-27,충남,전북,13872,129,1054,188,290,519,16052,29130,128,740,286,328,975,31587
2020-01-27,충남,충남,116954,990,4169,1540,2121,4681,130455,116954,990,4169,1540,2121,4681,130455
2020-01-27,충남,충북,7721,203,300,224,303,469,9220,8389,179,301,206,390,465,9930
2020-01-27,충북,강원,5461,75,142,27,43,294,6042,6147,99,120,47,50,302,6765
2020-01-27,충북,경기,36049,580,913,619,452,1632,40245,21643,579,957,642,590,1111,25522
2020-01-27,충북,경남,2517,20,93,97,105,115,2947,3755,8,68,67,91,141,4130
2020-01-27,충북,경북,6187,64,265,153,193,261,7123,10635,56,220,193,224,434,11762
2020-01-27,충북,광주,785,6,35,32,16,28,902,1295,6,42,17,15,35,1410
2020-01-27,충북,대구,1731,23,66,56,20,66,1962,5188,19,134,65,74,168,5648
2020-01-27,충북,대전,6263,139,225,33,18,435,7113,6896,166,239,33,23,463,7820
2020-01-27,충북,부산,107,0,7,12,10,8,144,570,3,17,17,26,23,656
2020-01-27,충북,서울,19012,114,956,194,103,787,21166,12585,107,871,201,149,630,14543
2020-01-27,충북,세종,313,8,9,3,2,21,356,168,4,11,2,0,10,195
2020-01-27,충북,울산,62,1,0,1,6,2,72,62,1,1,2,10,5,81
2020-01-27,충북,전남,627,5,17,21,70,26,766,1184,4,13,23,53,32,1309
2020-01-27,충북,전북,1863,37,68,71,64,87,2190,3217,36,75,96,66,121,3611
2020-01-27,충북,충남,8389,179,301,206,390,465,9930,7721,203,300,224,303,469,9220
2020-01-27,충북,충북,28759,599,725,531,437,1494,32545,28759,599,725,531,437,1494,32545
2020-01-28,강원,강원,60953,1731,2752,821,1233,4187,71677,60953,1731,2752,821,1233,4187,71677
2020-01-28,강원,경기,21924,483,1099,493,534,1007,25540,18498,486,1109,446,643,944,22126
2020-01-28,강원,경남,309,1,12,11,17,4,354,205,0,6,13,8,6,238
2020-01-28,강원,경북,520,19,32,17,19,11,618,549,13,32,27,16,20,657
2020-01-28,강원,광주,130,0,18,11,8,3,170,145,1,14,6,6,5,177
2020-01-28,강원,대구,258,3,8,10,7,3,289,491,4,19,13,14,10,551
2020-01-28,강원,대전,204,2,28,2,1,5,242,251,6,26,4,0,10,297
2020-01-28,강원,부산,8,0,1,0,0,1,10,2,0,0,1,0,0,3
2020-01-28,강원,서울,661,15,273,10,13,37,1009,608,12,249,10,4,34,917
2020-01-28,강원,세종,6,0,0,0,0,0,6,10,0,0,0,0,1,11
2020-01-28,강원,울산,5,0,0,0,3,0,8,2,0,1,0,0,0,3
2020-01-28,강원,전남,81,0,0,6,7,5,99,98,0,2,4,13,3,120
2020-01-28,강원,전북,181,2,8,10,8,4,213,258,2,5,12,10,10,297
2020-01-28,강원,충남,453,11,19,16,28,34,561,594,6,31,27,52,17,727
2020-01-28,강원,충북,4626,172,249,190,227,277,5741,4688,152,236,134,182,266,5658
2020-01-28,경기,강원,18498,486,1109,446,643,944,22126,21924,483,1099,493,534,1007,25540
2020-01-28,경기,경기,384708,19679,21291,15420,18165,29191,488454,384708,19679,21291,15420,18165,29191,488454
2020-01-28,경기,경남,3075,58,280,405,335,110,4263,3431,51,208,312,255,145,4402
2020-01-28,경기,경북,4145,150,428,476,414,153,5766,5226,145,401,619,382,182,6955
2020-01-28,경기,광주,865,24,173,158,88,32,1340,1461,19,152,151,68,35,1886
2020-01-28,경기,대구,1886,75,189,228,142,78,2598,5235,72,213,289,345,210,6364
2020-01-28,경기,대전,1829,72,191,63,36,95,2286,2714,82,184,60,54,150,3244
2020-01-28,경기,부산,219,12,17,79,67,8,402,642,15,21,82,158,29,947
2020-01-28,경기,서울,126923,6269,8039,3424,2200,8757,155612,139294,5978,8087,3785,2189,9570,168903
2020-01-28,경기,세종,41,3,4,2,0,3,53,61,3,3,2,1,1,71
2020-01-28,경기,울산,52,1,3,3,9,0,68,66,1,5,11,43,1,127
2020-01-28,경기,전남,963,16,94,112,83,27,1295,1685,12,95,77,86,59,2014
2020-01-28,경기,전북,1360,52,147,93,152,55,1859,2163,23,150,122,167,96,2721
2020-01-28,경기,충남,36074,1229,2399,1810,3534,1905,46951,37742,1197,2336,1805,3426,1964,48470
2020-01-28,경기,충북,26680,1839,2480,2380,2479,1404,37262,26607,1791,2392,2225,2564,1365,36944
2020-01-28,경남,강원,205,0,6,13,8,6,238,309,1,12,11,17,4,354
2020-01-28,경남,경기,3431,51,208,312,255,145,4402,3075,58,280,405,335,110,4263
2020-01-28,경남,경남,179469,8367,8675,4966,7503,14106,223086,179469,8367,8675,4966,7503,14106,223086
2020-01-28,경남,경북,10516,463,846,709,1271,500,14305,12652,661,1030,946,1939,590,17818
2020-01-28,경남,광주,1105,31,131,132,89,42,1530,1362,27,132,122,76,30,1749
2020-01-28,경남,대구,15282,619,922,810,1419,700,19752,10662,421,683,300,350,513,12929
2020-01-28,경남,대전,722,11,86,62,30,49,960,1134,13,94,66,39,56,1402
2020-01-28,경남,부산,81493,2100,2580,991,3443,5974,96581,83430,2159,2646,1110,3817,5906,99068
2020-01-28,경남,서울,3132,20,483,184,98,97,4014,3048,30,476,82,40,91,3767
2020-01-28,경남,세종,221,0,6,3,3,7,240,244,2,20,4,11,5,286
2020-01-28,경남,울산,9983,455,562,337,459,665,12461,9001,411,589,293,475,576,11345
2020-01-28,경남,전남,6179,206,383,360,1103,309,8540,5976,211,377,287,1031,273,8155
2020-01-28,경남,전북,1499,31,107,64,90,40,1831,1468,32,99,71,75,58,1803
2020-01-28,경남,충남,1757,29,96,172,202,68,2324,1783,30,131,174,319,61,2498
2020-01-28,경남,충북,1486,43,124,225,214,57,2149,1588,57,161,299,433,69,2607
2020-01-28,경북,강원,549,13,32,27,16,20,657,520,19,32,17,19,11,618
2020-01-28,경북,경기,5226,145,401,619,382,182,6955,4145,150,428,476,414,153,5766
2020-01-28,경북,경남,12652,661,1030,946,1939,590,17818,10516,463,846,709,1271,500,14305
2020-01-28,경북,경북,67744,3029,3486,2254,3147,3863,83523,67744,3029,3486,2254,3147,3863,83523
2020-01-28,경북,광주,891,36,101,125,69,21,1243,1006,28,81,99,42,31,1287
2020-01-28,경북,대구,65915,2326,2403,1083,1450,3782,76959,73106,2511,2817,1379,1989,4073,85875
2020-01-28,경북,대전,1701,38,91,100,82,85,2097,1934,31,90,75,56,103,2289
2020-01-28,경북,부산,4109,81,294,111,446,192,5233,5367,95,315,153,564,229,6723
2020-01-28,경북,서울,3512,59,317,243,95,126,4352,3152,58,304,108,54,112,3788
2020-01-28,경북,세종,289,5,13,20,6,16,349,280,12,13,13,10,7,335
2020-01-28,경북,울산,4922,115,273,348,848,287,6793,4662,106,247,271,1039,257,6582
2020-01-28,경북,전남,1128,32,61,83,373,36,1713,1104,34,79,76,490,32,1815
2020-01-28,경북,전북,1683,58,145,153,171,56,2266,1592,62,130,113,181,61,2139
2020-01-28,경북,충남,3960,100,286,409,446,151,5352,3317,100,299,347,583,129,4775
2020-01-28,경북,충북,5197,189,461,546,689,241,7323,4961,180,461,504,631,200,6937
2020-01-28,광주,강원,145,1,14,6,6,5,177,130,0,18,11,8,3,170
2020-01-28,광주,경기,1461,19,152,151,68,35,1886,865,24,173,158,88,32,1340
2020-01-28,광주,경남,1362,27,132,122,76,30,1749,1105,31,131,132,89,42,1530
2020-01-28,광주,경북,1006,28,81,99,42,31,1287,891,36,101,125,69,21,1243
2020-01-28,광주,광주,12531,406,565,295,159,546,14502,12531,406,565,295,159,546,14502
2020-01-28,광주,대구,621,23,75,76,18,15,828,746,17,90,52,20,24,949
2020-01-28,광주,대전,430,10,16,16,10,19,501,513,8,13,20,20,18,592
2020-01-28,광주,부산,601,8,46,23,59,17,754,574,7,49,41,76,23,770
2020-01-28,광주,서울,1522,16,25,40,27,51,1681,828,23,21,20,17,33,942
2020-01-28,광주,세종,228,2,7,2,0,7,246,163,3,5,4,1,4,180
2020-01-28,광주,울산,102,0,8,0,4,1,115,67,0,10,2,7,3,89
2020-01-28,광주,전남,33508,766,1116,638,1044,1372,38444,30688,771,954,597,815,1284,35109
2020-01-28,광주,전북,8200,338,438,303,273,293,9845,7529,370,384,238,262,292,9075
2020-01-28,광주,충남,6232,85,550,320,198,178,7563,4050,96,548,340,232,127,5393
2020-01-28,광주,충북,811,16,57,74,39,21,1018,646,23,69,114,57,15,924
2020-01-28,대구,강원,491,4,19,13,14,10,551,258,3,8,10,7,3,289
2020-01-28,대구,경기,5235,72,213,289,345,210,6364,1886,75,189,228,142,78,2598
2020-01-28,대구,경남,10662,421,683,300,350,513,12929,15282,619,922,810,1419,700,19752
2020-01-28,대구,경북,73106,2511,2817,1379,1989,4073,85875,65915,2326,2403,1083,1450,3782,76959
2020-01-28,대구,광주,746,17,90,52,20,24,949,621,23,75,76,18,15,828
2020-01-28,대구,대구,56812,1769,1489,623,603,3949,65245,56812,1769,1489,623,603,3949,65245
2020-01-28,대구,대전,1097,24,52,61,34,50,1318,622,18,37,27,17,29,750
2020-01-28,대구,부산,580,33,78,49,121,25,886,3360,65,210,65,185,165,4050
2020-01-28,대구,서울,4284,46,195,114,70,139,4848,1815,31,149,58,20,49,2122
2020-01-28,대구,세종,384,0,10,4,11,11,420,166,1,2,1,1,4,175
2020-01-28,대구,울산,1566,36,133,75,173,62,2045,1210,30,129,68,192,65,1694
2020-01-28,대구,전남,622,13,38,21,30,24,748,500,8,33,17,55,17,630
2020-01-28,대구,전북,473,12,38,10,14,20,567,345,7,33,12,10,9,416
2020-01-28,대구,충남,2495,58,113,131,181,93,3071,1056,54,81,98,133,33,1455
2020-01-28,대구,충북,2510,72,193,171,315,89,3350,1253,55,126,134,97,42,1707
2020-01-28,대전,강원,251,6,26,4,0,10,297,204,2,28,2,1,5,242
2020-01-28,대전,경기,2714,82,184,60,54,150,3244,1829,72,191,63,36,95,2286
2020-01-28,대전,경남,1134,13,94,66,39,56,1402,722,11,86,62,30,49,960
2020-01-28,대전,경북,1934,31,90,75,56,103,2289,1701,38,91,100,82,85,2097
2020-01-28,대전,광주,513,8,13,20,20,18,592,430,10,16,16,10,19,501
2020-01-28,대전,대구,622,18,37,27,17,29,750,1097,24,52,61,34,50,1318
2020-01-28,대전,대전,13009,363,389,185,167,1024,15137,13009,363,389,185,167,1024,15137
2020-01-28,대전,부산,93,3,7,3,23,1,130,116,5,6,7,16,5,155
2020-01-28,대전,서울,2287,27,196,28,12,113,2663,1681,28,191,14,5,72,1991
2020-01-28,대전,세종,3237,83,76,20,24,294,3734,3218,80,92,36,91,272,3789
2020-01-28,대전,울산,160,0,13,11,23,8,215,99,3,13,10,20,1,146
2020-01-28,대전,전남,339,3,11,28,26,6,413,294,6,10,11,19,10,350
2020-01-28,대전,전북,3330,65,63,50,36,170,3714,3103,81,79,48,26,144,3481
2020-01-28,대전,충남,16171,386,451,220,377,1230,18835,13798,369,429,200,260,1061,16117
2020-01-28,대전,충북,10855,397,432,172,154,777,12787,9069,362,379,144,135,670,10759
2020-01-28,부산,강원,2,0,0,1,0,0,3,8,0,1,0,0,1,10
2020-01-28,부산,경기,642,15,21,82,158,29,947,219,12,17,79,67,8,402
2020-01-28,부산,경남,83430,2159,2646,1110,3817,5906,99068,81493,2100,2580,991,3443,5974,96581
2020-01-28,부산,경북,5367,95,315,153,564,229,6723,4109,81,294,111,446,192,5233
2020-01-28,부산,광주,574,7,49,41,76,23,770,601,8,46,23,59,17,754
2020-01-28,부산,대구,3360,65,210,65,185,165,4050,580,33,78,49,121,25,886
2020-01-28,부산,대전,116,5,6,7,16,5,155,93,3,7,3,23,1,130
2020-01-28,부산,부산,38547,522,462,367,1696,2702,44296,38547,522,462,367,1696,2702,44296
2020-01-28,부산,서울,426,5,16,40,31,17,535,241,7,11,14,9,6,288
2020-01-28,부산,세종,36,1,1,3,2,1,44,16,0,1,0,1,3,21
2020-01-28,부산,울산,16959,284,372,558,2342,1168,21683,15210,305,288,314,2305,1103,19525
2020-01-28,부산,전남,2479,63,110,145,492,118,3407,1984,52,113,119,495,86,2849
2020-01-28,부산,전북,495,3,38,18,64,11,629,417,6,33,19,60,14,549
2020-01-28,부산,충남,343,8,21,54,85,15,526,200,5,14,35,152,7,413
2020-01-28,부산,충북,216,7,14,37,149,12,435,117,9,22,53,137,3,341
2020-01-28,서울,강원,608,12,249,10,4,34,917,661,15,273,10,13,37,1009
2020-01-28,서울,경기,139294,5978,8087,3785,2189,9570,168903,126923,6269,8039,3424,2200,8757,155612
2020-01-28,서울,경남,3048,30,476,82,40,91,3767,3132,20,483,184,98,97,4014
2020-01-28,서울,경북,3152,58,304,108,54,112,3788,3512,59,317,243,95,126,4352
2020-01-28,서울,광주,828,23,21,20,17,33,942,1522,16,25,40,27,51,1681
2020-01-28,서울,대구,1815,31,149,58,20,49,2122,4284,46,195,114,70,139,4848
2020-01-28,서울,대전,1681,28,191,14,5,72,1991,2287,27,196,28,12,113,2663
2020-01-28,서울,부산,241,7,11,14,9,6,288,426,5,16,40,31,17,535
2020-01-28,서울,서울,170,6,4,2,1,8,191,170,6,4,2,1,8,191
2020-01-28,서울,세종,30,0,0,0,0,0,30,44,0,1,0,0,5,50
2020-01-28,서울,울산,38,0,6,0,1,3,48,41,1,4,3,6,5,60
2020-01-28,서울,전남,1033,8,21,16,14,37,1129,1996,6,25,44,38,63,2172
2020-01-28,서울,전북,1345,11,40,14,10,40,1460,2129,21,43,28,23,55,2299
2020-01-28,서울,충남,27499,427,2254,561,562,1187,32490,28964,459,2254,919,818,1164,34578
2020-01-28,서울,충북,13965,382,1059,542,469,611,17028,12669,481,1112,640,580,578,16060
2020-01-28,세종,강원,10,0,0,0,0,1,11,6,0,0,0,0,0,6
2020-01-28,세종,경기,61,3,3,2,1,1,71,41,3,4,2,0,3,53
2020-01-28,세종,경남,244,2,20,4,11,5,286,221,0,6,3,3,7,240
2020-01-28,세종,경북,280,12,13,13,10,7,335,289,5,13,20,6,16,349
2020-01-28,세종,광주,163,3,5,4,1,4,180,228,2,7,2,0,7,246
2020-01-28,세종,대구,166,1,2,1,1,4,175,384,0,10,4,11,11,420
2020-01-28,세종,대전,3218,80,92,36,91,272,3789,3237,83,76,20,24,294,3734
2020-01-28,세종,부산,16,0,1,0,1,3,21,36,1,1,3,2,1,44
2020-01-28,세종,서울,44,0,1,0,0,5,50,30,0,0,0,0,0,30
2020-01-28,세종,세종,217,17,4,9,1,15,263,217,17,4,9,1,15,263
2020-01-28,세종,울산,18,0,0,2,3,0,23,19,0,0,1,1,3,24
2020-01-28,세종,전남,169,2,1,8,21,5,206,220,2,0,2,14,7,245
2020-01-28,세종,전북,652,13,16,10,46,29,766,678,14,20,11,64,31,818
2020-01-28,세종,충남,5730,142,143,86,126,321,6548,3871,105,135,96,115,210,4532
2020-01-28,세종,충북,315,17,15,6,9,32,394,262,12,17,11,6,26,334
2020-01-28,울산,강원,2,0,1,0,0,0,3,5,0,0,0,3,0,8
2020-01-28,울산,경기,66,1,5,11,43,1,127,52,1,3,3,9,0,68
2020-01-28,울산,경남,9001,411,589,293,475,576,11345,9983,455,562,337,459,665,12461
2020-01-28,울산,경북,4662,106,247,271,1039,257,6582,4922,115,273,348,848,287,6793
2020-01-28,울산,광주,67,0,10,2,7,3,89,102,0,8,0,4,1,115
2020-01-28,울산,대구,1210,30,129,68,192,65,1694,1566,36,133,75,173,62,2045
2020-01-28,울산,대전,99,3,13,10,20,1,146,160,0,13,11,23,8,215
2020-01-28,울산,부산,15210,305,288,314,2305,1103,19525,16959,284,372,558,2342,1168,21683
2020-01-28,울산,서울,41,1,4,3,6,5,60,38,0,6,0,1,3,48
2020-01-28,울산,세종,19,0,0,1,1,3,24,18,0,0,2,3,0,23
2020-01-28,울산,울산,7235,179,421,214,390,701,9140,7235,179,421,214,390,701,9140
2020-01-28,울산,전남,237,7,14,6,19,10,293,256,12,13,6,29,7,323
2020-01-28,울산,전북,48,0,6,2,13,0,69,66,1,6,0,2,3,78
2020-01-28,울산,충남,241,5,20,22,106,16,410,194,5,9,26,89,1,324
2020-01-28,울산,충북,31,2,2,11,39,0,85,15,0,7,6,25,1,54
2020-01-28,전남,강원,98,0,2,4,13,3,120,81,0,0,6,7,5,99
2020-01-28,전남,경기,1685,12,95,77,86,59,2014,963,16,94,112,83,27,1295
2020-01-28,전남,경남,5976,211,377,287,1031,273,8155,6179,206,383,360,1103,309,8540
2020-01-28,전남,경북,1104,34,79,76,490,32,1815,1128,32,61,83,373,36,1713
2020-01-28,전남,광주,30688,771,954,597,815,1284,35109,33508,766,1116,638,1044,1372,38444
2020-01-28,전남,대구,500,8,33,17,55,17,630,622,13,38,21,30,24,748
2020-01-28,전남,대전,294,6,10,11,19,10,350,339,3,11,28,26,6,413
2020-01-28,전남,부산,1984,52,113,119,495,86,2849,2479,63,110,145,492,118,3407
2020-01-28,전남,서울,1996,6,25,44,38,63,2172,1033,8,21,16,14,37,1129
2020-01-28,전남,세종,220,2,0,2,14,7,245,169,2,1,8,21,5,206
2020-01-28,전남,울산,256,12,13,6,29,7,323,237,7,14,6,19,10,293
2020-01-28,전남,전남,45625,1007,1303,1089,2982,1979,53985,45625,1007,1303,1089,2982,1979,53985
2020-01-28,전남,전북,5115,215,438,474,1054,146,7442,5115,187,416,503,1007,167,7395
2020-01-28,전남,충남,7606,76,447,565,1174,231,10099,4955,72,460,351,783,166,6787
2020-01-28,전남,충북,516,11,30,57,265,14,893,455,8,32,54,212,8,769
2020-01-28,전북,강원,258,2,5,12,10,10,297,181,2,8,10,8,4,213
2020-01-28,전북,경기,2163,23,150,122,167,96,2721,1360,52,147,93,152,55,1859
2020-01-28,전북,경남,1468,32,99,71,75,58,1803,1499,31,107,64,90,40,1831
2020-01-28,전북,경북,1592,62,130,113,181,61,2139,1683,58,145,153,171,56,2266
2020-01-28,전북,광주,7529,370,384,238,262,292,9075,8200,338,438,303,273,293,9845
2020-01-28,전북,대구,345,7,33,12,10,9,416,473,12,38,10,14,20,567
2020-01-28,전북,대전,3103,81,79,48,26,144,3481,3330,65,63,50,36,170,3714
2020-01-28,전북,부산,417,6,33,19,60,14,549,495,3,38,18,64,11,629
2020-01-28,전북,서울,2129,21,43,28,23,55,2299,1345,11,40,14,10,40,1460
2020-01-28,전북,세종,678,14,20,11,64,31,818,652,13,16,10,46,29,766
2020-01-28,전북,울산,66,1,6,0,2,3,78,48,0,6,2,13,0,69
2020-01-28,전북,전남,5115,187,416,503,1007,167,7395,5115,215,438,474,1054,146,7442
2020-01-28,전북,전북,15129,474,781,561,409,620,17974,15129,474,781,561,409,620,17974
2020-01-28,전북,충남,16598,365,1375,853,1133,632,20956,12925,425,1340,690,1058,527,16965
2020-01-28,전북,충북,2247,102,145,224,204,82,3004,1824,105,176,225,187,55,2572
2020-01-28,충남,강원,594,6,31,27,52,17,727,453,11,19,16,28,34,561
2020-01-28,충남,경기,37742,1197,2336,1805,3426,1964,48470,36074,1229,2399,1810,3534,1905,46951
2020-01-28,충남,경남,1783,30,131,174,319,61,2498,1757,29,96,172,202,68,2324
2020-01-28,충남,경북,3317,100,299,347,583,129,4775,3960,100,286,409,446,151,5352
2020-01-28,충남,광주,4050,96,548,340,232,127,5393,6232,85,550,320,198,178,7563
2020-01-28,충남,대구,1056,54,81,98,133,33,1455,2495,58,113,131,181,93,3071
2020-01-28,충남,대전,13798,369,429,200,260,1061,16117,16171,386,451,220,377,1230,18835
2020-01-28,충남,부산,200,5,14,35,152,7,413,343,8,21,54,85,15,526
2020-01-28,충남,서울,28964,459,2254,919,818,1164,34578,27499,427,2254,561,562,1187,32490
2020-01-28,충남,세종,3871,105,135,96,115,210,4532,5730,142,143,86,126,321,6548
2020-01-28,충남,울산,194,5,9,26,89,1,324,241,5,20,22,106,16,410
2020-01-28,충남,전남,4955,72,460,351,783,166,6787,7606,76,447,565,1174,231,10099
2020-01-28,충남,전북,12925,425,1340,690,1058,527,16965,16598,365,1375,853,1133,632,20956
2020-01-28,충남,충남,100376,2855,7165,5221,8209,4965,128791,100376,2855,7165,5221,8209,4965,128791
2020-01-28,충남,충북,12676,516,774,732,1053,747,16498,11654,506,747,662,1205,705,15479
2020-01-28,충북,강원,4688,152,236,134,182,266,5658,4626,172,249,190,227,277,5741
2020-01-28,충북,경기,26607,1791,2392,2225,2564,1365,36944,26680,1839,2480,2380,2479,1404,37262
2020-01-28,충북,경남,1588,57,161,299,433,69,2607,1486,43,124,225,214,57,2149
2020-01-28,충북,경북,4961,180,461,504,631,200,6937,5197,189,461,546,689,241,7323
2020-01-28,충북,광주,646,23,69,114,57,15,924,811,16,57,74,39,21,1018
2020-01-28,충북,대구,1253,55,126,134,97,42,1707,2510,72,193,171,315,89,3350
2020-01-28,충북,대전,9069,362,379,144,135,670,10759,10855,397,432,172,154,777,12787
2020-01-28,충북,부산,117,9,22,53,137,3,341,216,7,14,37,149,12,435
2020-01-28,충북,서울,12669,481,1112,640,580,578,16060,13965,382,1059,542,469,611,17028
2020-01-28,충북,세종,262,12,17,11,6,26,334,315,17,15,6,9,32,394
2020-01-28,충북,울산,15,0,7,6,25,1,54,31,2,2,11,39,0,85
2020-01-28,충북,전남,455,8,32,54,212,8,769,516,11,30,57,265,14,893
2020-01-28,충북,전북,1824,105,176,225,187,55,2572,2247,102,145,224,204,82,3004
2020-01-28,충북,충남,11654,506,747,662,1205,705,15479,12676,516,774,732,1053,747,16498
2020-01-28,충북,충북,33680,1631,2009,1689,2008,2094,43111,33680,1631,2009,1689,2008,2094,43111
2020-01-29,강원,강원,60310,2062,3037,1194,1698,4126,72427,60310,2062,3037,1194,1698,4126,72427
2020-01-29,강원,경기,16742,565,1287,643,638,842,20717,17828,597,1280,685,820,897,22107
2020-01-29,강원,경남,203,2,11,12,25,3,256,119,0,8,22,17,2,168
2020-01-29,강원,경북,455,21,34,32,16,15,573,457,12,30,31,21,15,566
2020-01-29,강원,광주,78,3,21,13,5,4,124,102,3,19,7,7,2,140
2020-01-29,강원,대구,205,2,11,12,10,4,244,349,5,27,21,13,5,420
2020-01-29,강원,대전,166,2,27,7,0,4,206,196,5,26,4,3,8,242
2020-01-29,강원,부산,7,0,0,2,4,1,14,5,0,1,1,6,1,14
2020-01-29,강원,서울,616,13,277,10,14,35,965,700,14,230,10,6,28,988
2020-01-29,강원,세종,5,0,0,0,1,1,7,4,0,0,0,0,1,5
2020-01-29,강원,울산,1,0,0,0,0,0,1,1,0,0,0,0,0,1
2020-01-29,강원,전남,54,0,3,5,15,2,79,55,1,9,4,23,2,94
2020-01-29,강원,전북,148,2,8,6,18,6,188,167,8,21,24,18,11,249
2020-01-29,강원,충남,333,12,20,28,33,14,440,454,8,28,46,57,10,603
2020-01-29,강원,충북,4660,212,264,219,311,259,5925,4699,199,267,222,275,277,5939
2020-01-29,경기,강원,17828,597,1280,685,820,897,22107,16742,565,1287,643,638,842,20717
2020-01-29,경기,경기,409406,23095,25216,19236,24209,31500,532662,409406,23095,25216,19236,24209,31500,532662
2020-01-29,경기,경남,2494,140,349,804,602,56,4445,1789,85,276,618,441,64,3273
2020-01-29,경기,경북,3939,185,487,740,639,136,6126,3805,194,489,937,581,125,6131
2020-01-29,경기,광주,801,40,185,350,205,19,1600,769,33,149,263,126,12,1352
2020-01-29,경기,대구,1832,91,220,466,244,52,2905,2878,114,265,500,577,87,4421
2020-01-29,경기,대전,1891,98,204,113,48,96,2450,1964,104,187,94,61,88,2498
2020-01-29,경기,부산,174,34,49,231,156,3,647,262,29,45,167,330,8,841
2020-01-29,경기,서울,141718,7240,9625,5217,3326,9934,177060,142112,6901,9532,4919,2933,9949,176346
2020-01-29,경기,세종,44,1,4,6,2,1,58,55,4,3,0,4,2,68
2020-01-29,경기,울산,32,2,4,7,14,1,60,37,1,12,37,82,0,169
2020-01-29,경기,전남,761,24,105,177,173,21,1261,823,19,96,150,125,20,1233
2020-01-29,경기,전북,1283,61,166,130,210,31,1881,1287,40,174,175,204,50,1930
2020-01-29,경기,충남,35266,1534,2865,2536,4676,1839,48716,33872,1500,2704,2371,4348,1746,46541
2020-01-29,경기,충북,26853,2118,3014,3158,3250,1337,39730,25349,2021,2827,2854,3140,1248,37439
2020-01-29,경남,강원,119,0,8,22,17,2,168,203,2,11,12,25,3,256
2020-01-29,경남,경기,1789,85,276,618,441,64,3273,2494,140,349,804,602,56,4445
2020-01-29,경남,경남,189401,9761,10146,6822,11829,14412,242371,189401,9761,10146,6822,11829,14412,242371
2020-01-29,경남,경북,9741,593,985,890,1781,446,14436,12222,848,1205,1218,2596,530,18619
2020-01-29,경남,광주,968,52,143,178,148,20,1509,1090,47,150,143,112,31,1573
2020-01-29,경남,대구,13141,764,1018,1057,1788,561,18329,10232,547,755,452,491,435,12912
2020-01-29,경남,대전,636,24,108,87,42,18,915,1020,30,112,129,56,42,1389
2020-01-29,경남,부산,86051,2581,3019,1645,4394,6143,103833,85639,2678,3156,1727,4718,6178,104096
2020-01-29,경남,서울,1607,48,446,298,129,59,2587,2310,62,458,218,126,83,3257
2020-01-29,경남,세종,175,2,10,10,8,6,211,244,3,15,10,15,11,298
2020-01-29,경남,울산,9934,658,715,469,709,609,13094,9310,596,778,435,647,568,12334
2020-01-29,경남,전남,5667,259,453,466,1583,244,8672,5662,270,444,416,1501,231,8524
2020-01-29,경남,전북,1129,43,127,105,138,30,1572,1177,45,133,126,128,29,1638
2020-01-29,경남,충남,1217,53,142,271,254,32,1969,1497,62,199,358,571,54,2741
2020-01-29,경남,충북,1003,61,165,280,276,32,1817,1344,70,206,513,573,35,2741
2020-01-29,경북,강원,457,12,30,31,21,15,566,455,21,34,32,16,15,573
2020-01-29,경북,경기,3805,194,489,937,581,125,6131,3939,185,487,740,639,136,6126
2020-01-29,경북,경남,12222,848,1205,1218,2596,530,18619,9741,593,985,890,1781,446,14436
2020-01-29,경북,경북,69876,3699,4144,2848,4254,4039,88860,69876,3699,4144,2848,4254,4039,88860
2020-01-29,경북,광주,756,55,133,212,123,14,1293,851,48,108,183,78,15,1283
2020-01-29,경북,대구,70569,2878,2819,1467,2324,3911,83968,74130,3040,3309,1852,2794,4028,89153
2020-01-29,경북,대전,1577,57,130,141,99,68,2072,1685,58,125,145,69,77,2159
2020-01-29,경북,부산,4008,130,342,207,623,200,5510,4471,144,341,232,799,217,6204
2020-01-29,경북,서울,2512,100,333,427,139,87,3598,2690,78,299,227,118,91,3503
2020-01-29,경북,세종,262,3,18,23,14,8,328,260,4,20,18,10,17,329
2020-01-29,경북,울산,4903,199,379,394,1026,271,7172,4687,186,329,346,1218,285,7051
2020-01-29,경북,전남,982,44,93,130,466,34,1749,925,45,76,98,537,24,1705
2020-01-29,경북,전북,1623,87,210,192,266,58,2436,1450,86,156,172,266,41,2171
2020-01-29,경북,충남,3013,149,414,574,641,97,4888,3082,137,345,518,848,115,5045
2020-01-29,경북,충북,4929,209,536,698,912,177,7461,4838,218,549,632,936,181,7354
2020-01-29,광주,강원,102,3,19,7,7,2,140,78,3,21,13,5,4,124
2020-01-29,광주,경기,769,33,149,263,126,12,1352,801,40,185,350,205,19,1600
2020-01-29,광주,경남,1090,47,150,143,112,31,1573,968,52,143,178,148,20,1509
2020-01-29,광주,경북,851,48,108,183,78,15,1283,756,55,133,212,123,14,1293
2020-01-29,광주,광주,12479,470,574,367,235,565,14690,12479,470,574,367,235,565,14690
2020-01-29,광주,대구,547,31,98,92,34,8,810,620,26,101,78,21,14,860
2020-01-29,광주,대전,430,10,15,30,16,13,514,503,18,24,32,15,22,614
2020-01-29,광주,부산,431,13,40,33,73,13,603,425,17,52,81,126,17,718
2020-01-29,광주,서울,670,13,27,68,24,21,823,682,23,25,53,22,28,833
2020-01-29,광주,세종,164,2,10,3,1,3,183,160,2,8,6,1,3,180
2020-01-29,광주,울산,59,1,9,1,5,2,77,50,0,9,8,8,1,76
2020-01-29,광주,전남,31429,886,1220,748,1817,1288,37388,30304,861,1002,647,1608,1278,35700
2020-01-29,광주,전북,7268,451,579,368,340,315,9321,7399,484,522,324,344,297,9370
2020-01-29,광주,충남,4027,116,549,461,252,118,5523,3663,130,561,594,385,106,5439
2020-01-29,광주,충북,630,27,78,123,50,10,918,601,29,73,192,101,15,1011
2020-01-29,대구,강원,349,5,27,21,13,5,420,205,2,11,12,10,4,244
2020-01-29,대구,경기,2878,114,265,500,577,87,4421,1832,91,220,466,244,52,2905
2020-01-29,대구,경남,10232,547,755,452,491,435,12912,13141,764,1018,1057,1788,561,18329
2020-01-29,대구,경북,74130,3040,3309,1852,2794,4028,89153,70569,2878,2819,1467,2324,3911,83968
2020-01-29,대구,광주,620,26,101,78,21,14,860,547,31,98,92,34,8,810
2020-01-29,대구,대구,58868,2093,1759,835,949,4020,68524,58868,2093,1759,835,949,4020,68524
2020-01-29,대구,대전,902,39,55,89,41,33,1159,587,29,46,52,20,26,760
2020-01-29,대구,부산,600,55,100,62,151,23,991,2781,111,228,97,243,110,3570
2020-01-29,대구,서울,2561,81,188,260,139,79,3308,1518,58,149,148,55,42,1970
2020-01-29,대구,세종,269,3,18,15,8,5,318,159,2,5,1,2,3,172
2020-01-29,대구,울산,1296,60,161,81,179,65,1842,1206,62,150,75,217,51,1761
2020-01-29,대구,전남,529,16,52,28,68,21,714,462,17,40,44,68,16,647
2020-01-29,대구,전북,365,14,39,22,25,4,469,332,12,49,25,15,6,439
2020-01-29,대구,충남,1584,82,156,231,269,52,2374,996,68,129,169,218,18,1598
2020-01-29,대구,충북,1805,92,231,260,421,55,2864,1218,72,151,244,126,36,1847
2020-01-29,대전,강원,196,5,26,4,3,8,242,166,2,27,7,0,4,206
2020-01-29,대전,경기,1964,104,187,94,61,88,2498,1891,98,204,113,48,96,2450
2020-01-29,대전,경남,1020,30,112,129,56,42,1389,636,24,108,87,42,18,915
2020-01-29,대전,경북,1685,58,125,145,69,77,2159,1577,57,130,141,99,68,2072
2020-01-29,대전,광주,503,18,24,32,15,22,614,430,10,15,30,16,13,514
2020-01-29,대전,대구,587,29,46,52,20,26,760,902,39,55,89,41,33,1159
2020-01-29,대전,대전,13304,409,429,330,204,1043,15719,13304,409,429,330,204,1043,15719
2020-01-29,대전,부산,56,5,6,23,18,2,110,83,3,9,12,20,1,128
2020-01-29,대전,서울,1747,38,209,50,6,80,2130,1648,41,199,50,15,83,2036
2020-01-29,대전,세종,3279,98,73,36,69,299,3854,3284,99,72,30,137,290,3912
2020-01-29,대전,울산,119,5,10,20,31,3,188,86,2,7,17,29,1,142
2020-01-29,대전,전남,254,8,4,42,30,7,345,249,5,8,23,24,10,319
2020-01-29,대전,전북,3072,82,87,88,46,150,3525,3027,81,90,86,50,149,3483
2020-01-29,대전,충남,15956,454,532,250,245,1284,18721,14235,432,448,216,226,1109,16666
2020-01-29,대전,충북,10769,436,461,206,193,804,12869,9674,395,423,173,156,732,11553
2020-01-29,부산,강원,5,0,1,1,6,1,14,7,0,0,2,4,1,14
2020-01-29,부산,경기,262,29,45,167,330,8,841,174,34,49,231,156,3,647
2020-01-29,부산,경남,85639,2678,3156,1727,4718,6178,104096,86051,2581,3019,1645,4394,6143,103833
2020-01-29,부산,경북,4471,144,341,232,799,217,6204,4008,130,342,207,623,200,5510
2020-01-29,부산,광주,425,17,52,81,126,17,718,431,13,40,33,73,13,603
2020-01-29,부산,대구,2781,111,228,97,243,110,3570,600,55,100,62,151,23,991
2020-01-29,부산,대전,83,3,9,12,20,1,128,56,5,6,23,18,2,110
2020-01-29,부산,부산,39162,659,663,619,2010,2944,46057,39162,659,663,619,2010,2944,46057
2020-01-29,부산,서울,197,17,29,83,85,7,418,154,15,14,63,24,3,273
2020-01-29,부산,세종,16,1,0,4,6,2,29,18,1,0,5,1,0,25
2020-01-29,부산,울산,16157,393,534,655,2493,1133,21365,15828,403,432,425,2424,1126,20638
2020-01-29,부산,전남,2022,79,146,206,604,65,3122,1654,72,149,149,575,63,2662
2020-01-29,부산,전북,333,12,37,41,119,17,559,304,7,26,51,75,6,469
2020-01-29,부산,충남,141,17,34,88,176,3,459,110,19,24,90,263,5,511
2020-01-29,부산,충북,127,15,24,101,248,5,520,88,15,23,128,200,1,455
2020-01-29,서울,강원,700,14,230,10,6,28,988,616,13,277,10,14,35,965
2020-01-29,서울,경기,142112,6901,9532,4919,2933,9949,176346,141718,7240,9625,5217,3326,9934,177060
2020-01-29,서울,경남,2310,62,458,218,126,83,3257,1607,48,446,298,129,59,2587
2020-01-29,서울,경북,2690,78,299,227,118,91,3503,2512,100,333,427,139,87,3598
2020-01-29,서울,광주,682,23,25,53,22,28,833,670,13,27,68,24,21,823
2020-01-29,서울,대구,1518,58,149,148,55,42,1970,2561,81,188,260,139,79,3308
2020-01-29,서울,대전,1648,41,199,50,15,83,2036,1747,38,209,50,6,80,2130
2020-01-29,서울,부산,154,15,14,63,24,3,273,197,17,29,83,85,7,418
2020-01-29,서울,서울,186,6,13,3,0,11,219,186,6,13,3,0,11,219
2020-01-29,서울,세종,28,0,3,0,0,0,31,26,0,0,2,0,1,29
2020-01-29,서울,울산,24,0,1,2,2,2,31,24,1,2,19,24,0,70
2020-01-29,서울,전남,793,11,24,44,26,28,926,882,11,24,85,45,30,1077
2020-01-29,서울,전북,1259,33,43,32,28,41,1436,1201,21,49,39,27,38,1375
2020-01-29,서울,충남,24080,554,2273,876,792,953,29528,23873,626,2271,1287,1200,957,30214
2020-01-29,서울,충북,13699,546,1188,699,693,588,17413,12489,637,1219,889,800,518,16552
2020-01-29,세종,강원,4,0,0,0,0,1,5,5,0,0,0,1,1,7
2020-01-29,세종,경기,55,4,3,0,4,2,68,44,1,4,6,2,1,58
2020-01-29,세종,경남,244,3,15,10,15,11,298,175,2,10,10,8,6,211
2020-01-29,세종,경북,260,4,20,18,10,17,329,262,3,18,23,14,8,328
2020-01-29,세종,광주,160,2,8,6,1,3,180,164,2,10,3,1,3,183
2020-01-29,세종,대구,159,2,5,1,2,3,172,269,3,18,15,8,5,318
2020-01-29,세종,대전,3284,99,72,30,137,290,3912,3279,98,73,36,69,299,3854
2020-01-29,세종,부산,18,1,0,5,1,0,25,16,1,0,4,6,2,29
2020-01-29,세종,서울,26,0,0,2,0,1,29,28,0,3,0,0,0,31
2020-01-29,세종,세종,235,22,2,0,0,29,288,235,22,2,0,0,29,288
2020-01-29,세종,울산,13,0,0,2,6,0,21,11,0,1,1,4,1,18
2020-01-29,세종,전남,168,6,4,9,21,4,212,185,3,1,4,33,10,236
2020-01-29,세종,전북,672,23,19,5,55,20,794,639,19,17,16,51,30,772
2020-01-29,세종,충남,5653,179,142,106,134,311,6525,4205,145,143,95,127,221,4936
2020-01-29,세종,충북,352,12,22,12,6,23,427,287,18,19,12,15,20,371
2020-01-29,울산,강원,1,0,0,0,0,0,1,1,0,0,0,0,0,1
2020-01-29,울산,경기,37,1,12,37,82,0,169,32,2,4,7,14,1,60
2020-01-29,울산,경남,9310,596,778,435,647,568,12334,9934,658,715,469,709,609,13094
2020-01-29,울산,경북,4687,186,329,346,1218,285,7051,4903,199,379,394,1026,271,7172
2020-01-29,울산,광주,50,0,9,8,8,1,76,59,1,9,1,5,2,77
2020-01-29,울산,대구,1206,62,150,75,217,51,1761,1296,60,161,81,179,65,1842
2020-01-29,울산,대전,86,2,7,17,29,1,142,119,5,10,20,31,3,188
2020-01-29,울산,부산,15828,403,432,425,2424,1126,20638,16157,393,534,655,2493,1133,21365
2020-01-29,울산,서울,24,1,2,19,24,0,70,24,0,1,2,2,2,31
2020-01-29,울산,세종,11,0,1,1,4,1,18,13,0,0,2,6,0,21
2020-01-29,울산,울산,8091,284,527,288,538,750,10478,8091,284,527,288,538,750,10478
2020-01-29,울산,전남,164,12,23,14,28,6,247,183,16,21,11,50,8,289
2020-01-29,울산,전북,41,0,9,4,11,0,65,42,2,9,2,12,0,67
2020-01-29,울산,충남,129,4,14,63,122,2,334,103,8,11,40,102,6,270
2020-01-29,울산,충북,21,1,4,17,52,0,95,19,0,4,14,31,1,69
2020-01-29,전남,강원,55,1,9,4,23,2,94,54,0,3,5,15,2,79
2020-01-29,전남,경기,823,19,96,150,125,20,1233,761,24,105,177,173,21,1261
2020-01-29,전남,경남,5662,270,444,416,1501,231,8524,5667,259,453,466,1583,244,8672
2020-01-29,전남,경북,925,45,76,98,537,24,1705,982,44,93,130,466,34,1749
2020-01-29,전남,광주,30304,861,1002,647,1608,1278,35700,31429,886,1220,748,1817,1288,37388
2020-01-29,전남,대구,462,17,40,44,68,16,647,529,16,52,28,68,21,714
2020-01-29,전남,대전,249,5,8,23,24,10,319,254,8,4,42,30,7,345
2020-01-29,전남,부산,1654,72,149,149,575,63,2662,2022,79,146,206,604,65,3122
2020-01-29,전남,서울,882,11,24,85,45,30,1077,793,11,24,44,26,28,926
2020-01-29,전남,세종,185,3,1,4,33,10,236,168,6,4,9,21,4,212
2020-01-29,전남,울산,183,16,21,11,50,8,289,164,12,23,14,28,6,247
2020-01-29,전남,전남,42015,1204,1547,1384,4271,1754,52175,42015,1204,1547,1384,4271,1754,52175
2020-01-29,전남,전북,4722,276,497,584,1265,152,7496,4496,212,419,600,1142,144,7013
2020-01-29,전남,충남,4144,112,431,686,1371,128,6872,4112,93,452,549,1058,126,6390
2020-01-29,전남,충북,359,16,32,83,332,9,831,395,16,35,100,276,17,839
2020-01-29,전북,강원,167,8,21,24,18,11,249,148,2,8,6,18,6,188
2020-01-29,전북,경기,1287,40,174,175,204,50,1930,1283,61,166,130,210,31,1881
2020-01-29,전북,경남,1177,45,133,126,128,29,1638,1129,43,127,105,138,30,1572
2020-01-29,전북,경북,1450,86,156,172,266,41,2171,1623,87,210,192,266,58,2436
2020-01-29,전북,광주,7399,484,522,324,344,297,9370,7268,451,579,368,340,315,9321
2020-01-29,전북,대구,332,12,49,25,15,6,439,365,14,39,22,25,4,469
2020-01-29,전북,대전,3027,81,90,86,50,149,3483,3072,82,87,88,46,150,3525
2020-01-29,전북,부산,304,7,26,51,75,6,469,333,12,37,41,119,17,559
2020-01-29,전북,서울,1201,21,49,39,27,38,1375,1259,33,43,32,28,41,1436
2020-01-29,전북,세종,639,19,17,16,51,30,772,672,23,19,5,55,20,794
2020-01-29,전북,울산,42,2,9,2,12,0,67,41,0,9,4,11,0,65
2020-01-29,전북,전남,4496,212,419,600,1142,144,7013,4722,276,497,584,1265,152,7496
2020-01-29,전북,전북,15091,608,911,855,744,636,18845,15091,608,911,855,744,636,18845
2020-01-29,전북,충남,12687,500,1584,1107,1397,437,17712,12525,497,1510,942,1360,433,17267
2020-01-29,전북,충북,1791,126,181,285,239,55,2677,1719,115,210,286,259,54,2643
2020-01-29,충남,강원,454,8,28,46,57,10,603,333,12,20,28,33,14,440
2020-01-29,충남,경기,33872,1500,2704,2371,4348,1746,46541,35266,1534,2865,2536,4676,1839,48716
2020-01-29,충남,경남,1497,62,199,358,571,54,2741,1217,53,142,271,254,32,1969
2020-01-29,충남,경북,3082,137,345,518,848,115,5045,3013,149,414,574,641,97,4888
2020-01-29,충남,광주,3663,130,561,594,385,106,5439,4027,116,549,461,252,118,5523
2020-01-29,충남,대구,996,68,129,169,218,18,1598,1584,82,156,231,269,52,2374
2020-01-29,충남,대전,14235,432,448,216,226,1109,16666,15956,454,532,250,245,1284,18721
2020-01-29,충남,부산,110,19,24,90,263,5,511,141,17,34,88,176,3,459
2020-01-29,충남,서울,23873,626,2271,1287,1200,957,30214,24080,554,2273,876,792,953,29528
2020-01-29,충남,세종,4205,145,143,95,127,221,4936,5653,179,142,106,134,311,6525
2020-01-29,충남,울산,103,8,11,40,102,6,270,129,4,14,63,122,2,334
2020-01-29,충남,전남,4112,93,452,549,1058,126,6390,4144,112,431,686,1371,128,6872
2020-01-29,충남,전북,12525,497,1510,942,1360,433,17267,12687,500,1584,1107,1397,437,17712
2020-01-29,충남,충남,92142,3483,8021,7024,10743,4482,125895,92142,3483,8021,7024,10743,4482,125895
2020-01-29,충남,충북,13256,644,959,953,1315,812,17939,11964,647,850,832,1370,694,16357
2020-01-29,충북,강원,4699,199,267,222,275,277,5939,4660,212,264,219,311,259,5925
2020-01-29,충북,경기,25349,2021,2827,2854,3140,1248,37439,26853,2118,3014,3158,3250,1337,39730
2020-01-29,충북,경남,1344,70,206,513,573,35,2741,1003,61,165,280,276,32,1817
2020-01-29,충북,경북,4838,218,549,632,936,181,7354,4929,209,536,698,912,177,7461
2020-01-29,충북,광주,601,29,73,192,101,15,1011,630,27,78,123,50,10,918
2020-01-29,충북,대구,1218,72,151,244,126,36,1847,1805,92,231,260,421,55,2864
2020-01-29,충북,대전,9674,395,423,173,156,732,11553,10769,436,461,206,193,804,12869
2020-01-29,충북,부산,88,15,23,128,200,1,455,127,15,24,101,248,5,520
2020-01-29,충북,서울,12489,637,1219,889,800,518,16552,13699,546,1188,699,693,588,17413
2020-01-29,충북,세종,287,18,19,12,15,20,371,352,12,22,12,6,23,427
2020-01-29,충북,울산,19,0,4,14,31,1,69,21,1,4,17,52,0,95
2020-01-29,충북,전남,395,16,35,100,276,17,839,359,16,32,83,332,9,831
2020-01-29,충북,전북,1719,115,210,286,259,54,2643,1791,126,181,285,239,55,2677
2020-01-29,충북,충남,11964,647,850,832,1370,694,16357,13256,644,959,953,1315,812,17939
2020-01-29,충북,충북,35524,1915,2338,2144,2391,2169,46481,35524,1915,2338,2144,2391,2169,46481
2020-01-30,강원,강원,58822,2057,3060,1292,1834,4193,71258,58822,2057,3060,1292,1834,4193,71258
2020-01-30,강원,경기,16366,538,1291,626,706,843,20370,17299,564,1289,663,823,908,21546
2020-01-30,강원,경남,180,1,14,21,17,4,237,117,1,6,20,7,4,155
2020-01-30,강원,경북,433,20,32,18,25,12,540,406,13,24,26,25,12,506
2020-01-30,강원,광주,64,5,17,9,5,4,104,71,0,8,11,5,3,98
2020-01-30,강원,대구,198,3,13,15,15,4,248,283,4,25,22,14,10,358
2020-01-30,강원,대전,140,2,29,2,0,4,177,181,4,32,6,2,6,231
2020-01-30,강원,부산,6,0,1,0,4,2,13,5,0,0,2,2,0,9
2020-01-30,강원,서울,684,16,270,17,11,22,1020,803,14,231,11,6,24,1089
2020-01-30,강원,세종,7,0,1,0,1,0,9,7,0,0,0,2,0,9
2020-01-30,강원,울산,4,0,0,0,0,0,4,3,0,0,0,1,0,4
2020-01-30,강원,전남,52,0,2,4,17,0,75,54,2,1,6,25,1,89
2020-01-30,강원,전북,127,3,13,12,20,7,182,152,6,15,20,17,4,214
2020-01-30,강원,충남,349,9,29,27,43,14,471,413,11,27,37,87,6,581
2020-01-30,강원,충북,4578,213,283,241,327,270,5912,4664,189,251,210,256,267,5837
2020-01-30,경기,강원,17299,564,1289,663,823,908,21546,16366,538,1291,626,706,843,20370
2020-01-30,경기,경기,415073,23284,25294,19291,24830,31495,539267,415073,23284,25294,19291,24830,31495,539267
2020-01-30,경기,경남,2296,98,349,830,653,85,4311,1783,67,250,566,423,54,3143
2020-01-30,경기,경북,3842,172,486,734,557,125,5916,3871,201,485,924,587,127,6195
2020-01-30,경기,광주,747,41,166,327,188,16,1485,695,23,163,281,123,18,1303
2020-01-30,경기,대구,1890,100,225,423,261,36,2935,2662,119,239,477,540,84,4121
2020-01-30,경기,대전,1879,96,212,139,61,63,2450,1971,95,200,111,51,80,2508
2020-01-30,경기,부산,170,22,69,233,165,6,665,218,24,31,184,344,9,810
2020-01-30,경기,서울,143276,7459,9316,5303,3445,9787,178586,143891,7029,9522,4947,3165,9614,178168
2020-01-30,경기,세종,39,3,5,8,0,3,58,58,3,3,4,1,3,72
2020-01-30,경기,울산,26,0,2,9,10,0,47,47,2,11,38,78,1,177
2020-01-30,경기,전남,684,26,109,183,164,23,1189,708,24,89,160,143,28,1152
2020-01-30,경기,전북,1332,68,182,120,226,43,1971,1248,48,164,157,219,32,1868
2020-01-30,경기,충남,35191,1500,2881,2668,4592,1876,48708,34904,1447,2736,2486,4380,1756,47709
2020-01-30,경기,충북,26476,2163,3082,3143,3353,1342,39559,25764,2079,2893,2799,3428,1273,38236
2020-01-30,경남,강원,117,1,6,20,7,4,155,180,1,14,21,17,4,237
2020-01-30,경남,경기,1783,67,250,566,423,54,3143,2296,98,349,830,653,85,4311
2020-01-30,경남,경남,190679,10158,10283,7353,12939,14665,246077,190679,10158,10283,7353,12939,14665,246077
2020-01-30,경남,경북,9462,601,1019,936,1936,451,14405,12004,837,1253,1326,2718,549,18687
2020-01-30,경남,광주,1004,51,129,164,134,21,1503,996,35,154,182,106,30,1503
2020-01-30,경남,대구,13144,716,1069,993,1911,567,18400,10333,524,789,418,484,481,13029
2020-01-30,경남,대전,715,27,93,77,47,27,986,951,30,97,121,52,33,1284
2020-01-30,경남,부산,86756,2607,3042,1963,4828,6220,105416,85671,2756,3161,1963,5278,6105,104934
2020-01-30,경남,서울,1609,36,421,283,122,46,2517,2250,64,453,211,126,64,3168
2020-01-30,경남,세종,177,1,9,7,7,4,205,214,3,19,7,10,10,263
2020-01-30,경남,울산,9831,628,736,498,690,591,12974,9303,559,759,429,655,549,12254
2020-01-30,경남,전남,5609,262,475,521,1543,238,8648,5719,271,474,438,1470,231,8603
2020-01-30,경남,전북,1218,40,135,88,189,37,1707,1194,39,115,113,173,38,1672
2020-01-30,경남,충남,1123,45,132,236,259,38,1833,1515,53,155,346,652,57,2778
2020-01-30,경남,충북,1096,61,155,274,292,27,1905,1317,85,211,471,631,44,2759
2020-01-30,경북,강원,406,13,24,26,25,12,506,433,20,32,18,25,12,540
2020-01-30,경북,경기,3871,201,485,924,587,127,6195,3842,172,486,734,557,125,5916
2020-01-30,경북,경남,12004,837,1253,1326,2718,549,18687,9462,601,1019,936,1936,451,14405
2020-01-30,경북,경북,71001,3719,4355,3043,4634,3961,90713,71001,3719,4355,3043,4634,3961,90713
2020-01-30,경북,광주,756,51,145,211,118,15,1296,734,48,105,190,88,21,1186
2020-01-30,경북,대구,71968,2823,2892,1709,2669,3959,86020,74573,2997,3314,2064,3148,4084,90180
2020-01-30,경북,대전,1637,49,126,127,80,70,2089,1663,50,121,133,73,71,2111
2020-01-30,경북,부산,4147,136,368,166,756,188,5761,4333,137,347,205,849,198,6069
2020-01-30,경북,서울,2481,91,344,411,129,78,3534,2652,78,311,236,127,75,3479
2020-01-30,경북,세종,210,9,23,21,17,10,290,249,5,19,21,11,10,315
2020-01-30,경북,울산,4691,173,350,416,1100,234,6964,4682,164,341,329,1285,269,7070
2020-01-30,경북,전남,1000,41,79,114,475,30,1739,992,48,79,101,538,45,1803
2020-01-30,경북,전북,1687,96,189,182,226,57,2437,1478,82,154,151,223,42,2130
2020-01-30,경북,충남,3000,144,387,568,707,97,4903,3130,133,352,527,848,96,5086
2020-01-30,경북,충북,4840,213,515,712,902,187,7369,4572,232,550,681,929,186,7150
2020-01-30,광주,강원,71,0,8,11,5,3,98,64,5,17,9,5,4,104
2020-01-30,광주,경기,695,23,163,281,123,18,1303,747,41,166,327,188,16,1485
2020-01-30,광주,경남,996,35,154,182,106,30,1503,1004,51,129,164,134,21,1503
2020-01-30,광주,경북,734,48,105,190,88,21,1186,756,51,145,211,118,15,1296
2020-01-30,광주,광주,12909,515,626,354,243,506,15153,12909,515,626,354,243,506,15153
2020-01-30,광주,대구,567,23,102,103,34,12,841,631,26,112,80,37,17,903
2020-01-30,광주,대전,459,20,11,24,12,13,539,514,24,19,34,12,14,617
2020-01-30,광주,부산,385,13,48,34,75,12,567,440,18,61,82,122,6,729
2020-01-30,광주,서울,627,23,20,66,20,19,775,716,17,27,44,17,17,838
2020-01-30,광주,세종,122,3,7,2,1,3,138,171,5,7,9,4,1,197
2020-01-30,광주,울산,36,2,13,3,1,2,57,34,1,12,6,6,4,63
2020-01-30,광주,전남,32281,935,1169,712,1836,1319,38252,31007,932,1048,669,1660,1267,36583
2020-01-30,광주,전북,7706,425,587,361,341,308,9728,7729,422,514,324,355,339,9683
2020-01-30,광주,충남,3728,121,571,470,322,111,5323,3728,128,578,590,426,117,5567
2020-01-30,광주,충북,544,29,81,111,43,12,820,610,41,95,165,103,11,1025
2020-01-30,대구,강원,283,4,25,22,14,10,358,198,3,13,15,15,4,248
2020-01-30,대구,경기,2662,119,239,477,540,84,4121,1890,100,225,423,261,36,2935
2020-01-30,대구,경남,10333,524,789,418,484,481,13029,13144,716,1069,993,1911,567,18400
2020-01-30,대구,경북,74573,2997,3314,2064,3148,4084,90180,71968,2823,2892,1709,2669,3959,86020
2020-01-30,대구,광주,631,26,112,80,37,17,903,567,23,102,103,34,12,841
2020-01-30,대구,대구,59685,2156,1830,937,920,3986,69514,59685,2156,1830,937,920,3986,69514
2020-01-30,대구,대전,922,41,54,66,50,30,1163,672,20,38,48,19,18,815
2020-01-30,대구,부산,598,55,114,66,130,23,986,2715,117,243,101,238,121,3535
2020-01-30,대구,서울,2455,76,188,209,119,75,3122,1598,56,150,115,52,40,2011
2020-01-30,대구,세종,245,4,16,8,7,5,285,152,5,6,2,3,2,170
2020-01-30,대구,울산,1239,48,161,93,186,54,1781,1213,54,151,80,246,53,1797
2020-01-30,대구,전남,479,15,45,33,49,15,636,475,14,49,37,57,19,651
2020-01-30,대구,전북,352,13,35,14,19,7,440,354,6,38,30,22,8,458
2020-01-30,대구,충남,1490,74,147,204,286,38,2239,1131,57,115,181,195,23,1702
2020-01-30,대구,충북,1762,89,227,261,461,55,2855,1274,82,171,227,117,40,1911
2020-01-30,대전,강원,181,4,32,6,2,6,231,140,2,29,2,0,4,177
2020-01-30,대전,경기,1971,95,200,111,51,80,2508,1879,96,212,139,61,63,2450
2020-01-30,대전,경남,951,30,97,121,52,33,1284,715,27,93,77,47,27,986
2020-01-30,대전,경북,1663,50,121,133,73,71,2111,1637,49,126,127,80,70,2089
2020-01-30,대전,광주,514,24,19,34,12,14,617,459,20,11,24,12,13,539
2020-01-30,대전,대구,672,20,38,48,19,18,815,922,41,54,66,50,30,1163
2020-01-30,대전,대전,13448,404,461,195,299,1020,15827,13448,404,461,195,299,1020,15827
2020-01-30,대전,부산,68,5,8,14,23,1,119,84,3,8,11,21,1,128
2020-01-30,대전,서울,1614,43,199,45,12,75,1988,1531,48,197,39,11,80,1906
2020-01-30,대전,세종,3377,114,75,27,40,280,3913,3415,113,82,34,100,298,4042
2020-01-30,대전,울산,69,1,8,19,33,3,133,78,3,11,15,26,3,136
2020-01-30,대전,전남,304,4,9,26,25,9,377,255,3,16,29,19,9,331
2020-01-30,대전,전북,3062,71,100,88,51,119,3491,3030,79,85,79,45,130,3448
2020-01-30,대전,충남,15962,475,510,253,205,1211,18616,14461,416,497,208,238,1101,16921
2020-01-30,대전,충북,10714,484,474,199,166,827,12864,9670,402,436,176,136,721,11541
2020-01-30,부산,강원,5,0,0,2,2,0,9,6,0,1,0,4,2,13
2020-01-30,부산,경기,218,24,31,184,344,9,810,170,22,69,233,165,6,665
2020-01-30,부산,경남,85671,2756,3161,1963,5278,6105,104934,86756,2607,3042,1963,4828,6220,105416
2020-01-30,부산,경북,4333,137,347,205,849,198,6069,4147,136,368,166,756,188,5761
2020-01-30,부산,광주,440,18,61,82,122,6,729,385,13,48,34,75,12,567
2020-01-30,부산,대구,2715,117,243,101,238,121,3535,598,55,114,66,130,23,986
2020-01-30,부산,대전,84,3,8,11,21,1,128,68,5,8,14,23,1,119
2020-01-30,부산,부산,40591,699,678,927,2220,3048,48163,40591,699,678,927,2220,3048,48163
2020-01-30,부산,서울,200,13,21,100,71,7,412,171,14,28,62,37,4,316
2020-01-30,부산,세종,12,0,0,1,6,0,19,14,2,0,1,2,1,20
2020-01-30,부산,울산,16047,391,519,674,2668,1118,21417,16191,427,439,430,2634,1131,21252
2020-01-30,부산,전남,1979,78,129,195,622,77,3080,1819,70,132,154,632,64,2871
2020-01-30,부산,전북,310,8,41,33,95,13,500,291,11,30,45,79,10,466
2020-01-30,부산,충남,150,14,29,64,159,1,417,152,10,30,91,267,1,551
2020-01-30,부산,충북,129,12,20,86,234,4,485,104,13,25,119,186,7,454
2020-01-30,서울,강원,803,14,231,11,6,24,1089,684,16,270,17,11,22,1020
2020-01-30,서울,경기,143891,7029,9522,4947,3165,9614,178168,143276,7459,9316,5303,3445,9787,178586
2020-01-30,서울,경남,2250,64,453,211,126,64,3168,1609,36,421,283,122,46,2517
2020-01-30,서울,경북,2652,78,311,236,127,75,3479,2481,91,344,411,129,78,3534
2020-01-30,서울,광주,716,17,27,44,17,17,838,627,23,20,66,20,19,775
2020-01-30,서울,대구,1598,56,150,115,52,40,2011,2455,76,188,209,119,75,3122
2020-01-30,서울,대전,1531,48,197,39,11,80,1906,1614,43,199,45,12,75,1988
2020-01-30,서울,부산,171,14,28,62,37,4,316,200,13,21,100,71,7,412
2020-01-30,서울,서울,171,6,10,2,2,10,201,171,6,10,2,2,10,201
2020-01-30,서울,세종,37,1,1,0,0,0,39,39,1,1,1,1,2,45
2020-01-30,서울,울산,25,1,4,0,1,2,33,22,1,4,9,20,0,56
2020-01-30,서울,전남,774,9,20,36,24,18,881,764,10,23,75,46,16,934
2020-01-30,서울,전북,1285,30,35,24,23,32,1429,1195,28,47,34,29,48,1381
2020-01-30,서울,충남,23814,571,2322,852,768,907,29234,24647,637,2310,1273,1177,984,31028
2020-01-30,서울,충북,13392,512,1186,807,650,548,17095,12842,599,1157,836,807,557,16798
2020-01-30,세종,강원,7,0,0,0,2,0,9,7,0,1,0,1,0,9
2020-01-30,세종,경기,58,3,3,4,1,3,72,39,3,5,8,0,3,58
2020-01-30,세종,경남,214,3,19,7,10,10,263,177,1,9,7,7,4,205
2020-01-30,세종,경북,249,5,19,21,11,10,315,210,9,23,21,17,10,290
2020-01-30,세종,광주,171,5,7,9,4,1,197,122,3,7,2,1,3,138
2020-01-30,세종,대구,152,5,6,2,3,2,170,245,4,16,8,7,5,285
2020-01-30,세종,대전,3415,113,82,34,100,298,4042,3377,114,75,27,40,280,3913
2020-01-30,세종,부산,14,2,0,1,2,1,20,12,0,0,1,6,0,19
2020-01-30,세종,서울,39,1,1,1,1,2,45,37,1,1,0,0,0,39
2020-01-30,세종,세종,281,18,5,5,1,18,328,281,18,5,5,1,18,328
2020-01-30,세종,울산,7,1,0,2,3,0,13,8,0,1,2,6,1,18
2020-01-30,세종,전남,149,1,1,17,27,2,197,156,3,2,4,25,4,194
2020-01-30,세종,전북,663,12,26,11,36,24,772,640,10,18,12,41,20,741
2020-01-30,세종,충남,5717,150,170,118,175,312,6642,4485,140,145,114,140,211,5235
2020-01-30,세종,충북,369,8,23,11,16,22,449,314,9,19,10,20,22,394
2020-01-30,울산,강원,3,0,0,0,1,0,4,4,0,0,0,0,0,4
2020-01-30,울산,경기,47,2,11,38,78,1,177,26,0,2,9,10,0,47
2020-01-30,울산,경남,9303,559,759,429,655,549,12254,9831,628,736,498,690,591,12974
2020-01-30,울산,경북,4682,164,341,329,1285,269,7070,4691,173,350,416,1100,234,6964
2020-01-30,울산,광주,34,1,12,6,6,4,63,36,2,13,3,1,2,57
2020-01-30,울산,대구,1213,54,151,80,246,53,1797,1239,48,161,93,186,54,1781
2020-01-30,울산,대전,78,3,11,15,26,3,136,69,1,8,19,33,3,133
2020-01-30,울산,부산,16191,427,439,430,2634,1131,21252,16047,391,519,674,2668,1118,21417
2020-01-30,울산,서울,22,1,4,9,20,0,56,25,1,4,0,1,2,33
2020-01-30,울산,세종,8,0,1,2,6,1,18,7,1,0,2,3,0,13
2020-01-30,울산,울산,8092,292,584,301,605,763,10637,8092,292,584,301,605,763,10637
2020-01-30,울산,전남,160,7,24,13,36,3,243,167,9,25,13,46,8,268
2020-01-30,울산,전북,32,0,8,2,14,1,57,52,0,9,4,5,0,70
2020-01-30,울산,충남,124,6,22,43,111,1,307,120,2,10,36,126,2,296
2020-01-30,울산,충북,21,3,7,20,39,1,91,17,0,2,11,27,1,58
2020-01-30,전남,강원,54,2,1,6,25,1,89,52,0,2,4,17,0,75
2020-01-30,전남,경기,708,24,89,160,143,28,1152,684,26,109,183,164,23,1189
2020-01-30,전남,경남,5719,271,474,438,1470,231,8603,5609,262,475,521,1543,238,8648
2020-01-30,전남,경북,992,48,79,101,538,45,1803,1000,41,79,114,475,30,1739
2020-01-30,전남,광주,31007,932,1048,669,1660,1267,36583,32281,935,1169,712,1836,1319,38252
2020-01-30,전남,대구,475,14,49,37,57,19,651,479,15,45,33,49,15,636
2020-01-30,전남,대전,255,3,16,29,19,9,331,304,4,9,26,25,9,377
2020-01-30,전남,부산,1819,70,132,154,632,64,2871,1979,78,129,195,622,77,3080
2020-01-30,전남,서울,764,10,23,75,46,16,934,774,9,20,36,24,18,881
2020-01-30,전남,세종,156,3,2,4,25,4,194,149,1,1,17,27,2,197
2020-01-30,전남,울산,167,9,25,13,46,8,268,160,7,24,13,36,3,243
2020-01-30,전남,전남,42523,1200,1546,1639,4220,1776,52904,42523,1200,1546,1639,4220,1776,52904
2020-01-30,전남,전북,4644,226,527,535,1256,155,7343,4594,224,458,567,1158,143,7144
2020-01-30,전남,충남,3879,102,462,693,1262,119,6517,3847,95,427,559,996,116,6040
2020-01-30,전남,충북,365,19,41,84,356,7,872,425,14,41,113,286,9,888
2020-01-30,전북,강원,152,6,15,20,17,4,214,127,3,13,12,20,7,182
2020-01-30,전북,경기,1248,48,164,157,219,32,1868,1332,68,182,120,226,43,1971
2020-01-30,전북,경남,1194,39,115,113,173,38,1672,1218,40,135,88,189,37,1707
2020-01-30,전북,경북,1478,82,154,151,223,42,2130,1687,96,189,182,226,57,2437
2020-01-30,전북,광주,7729,422,514,324,355,339,9683,7706,425,587,361,341,308,9728
2020-01-30,전북,대구,354,6,38,30,22,8,458,352,13,35,14,19,7,440
2020-01-30,전북,대전,3030,79,85,79,45,130,3448,3062,71,100,88,51,119,3491
2020-01-30,전북,부산,291,11,30,45,79,10,466,310,8,41,33,95,13,500
2020-01-30,전북,서울,1195,28,47,34,29,48,1381,1285,30,35,24,23,32,1429
2020-01-30,전북,세종,640,10,18,12,41,20,741,663,12,26,11,36,24,772
2020-01-30,전북,울산,52,0,9,4,5,0,70,32,0,8,2,14,1,57
2020-01-30,전북,전남,4594,224,458,567,1158,143,7144,4644,226,527,535,1256,155,7343
2020-01-30,전북,전북,15793,595,945,679,761,610,19383,15793,595,945,679,761,610,19383
2020-01-30,전북,충남,12805,495,1545,1151,1376,486,17858,12563,504,1535,947,1430,453,17432
2020-01-30,전북,충북,1744,120,156,303,271,61,2655,1827,117,201,255,254,54,2708
2020-01-30,충남,강원,413,11,27,37,87,6,581,349,9,29,27,43,14,471
2020-01-30,충남,경기,34904,1447,2736,2486,4380,1756,47709,35191,1500,2881,2668,4592,1876,48708
2020-01-30,충남,경남,1515,53,155,346,652,57,2778,1123,45,132,236,259,38,1833
2020-01-30,충남,경북,3130,133,352,527,848,96,5086,3000,144,387,568,707,97,4903
2020-01-30,충남,광주,3728,128,578,590,426,117,5567,3728,121,571,470,322,111,5323
2020-01-30,충남,대구,1131,57,115,181,195,23,1702,1490,74,147,204,286,38,2239
2020-01-30,충남,대전,14461,416,497,208,238,1101,16921,15962,475,510,253,205,1211,18616
2020-01-30,충남,부산,152,10,30,91,267,1,551,150,14,29,64,159,1,417
2020-01-30,충남,서울,24647,637,2310,1273,1177,984,31028,23814,571,2322,852,768,907,29234
2020-01-30,충남,세종,4485,140,145,114,140,211,5235,5717,150,170,118,175,312,6642
2020-01-30,충남,울산,120,2,10,36,126,2,296,124,6,22,43,111,1,307
2020-01-30,충남,전남,3847,95,427,559,996,116,6040,3879,102,462,693,1262,119,6517
2020-01-30,충남,전북,12563,504,1535,947,1430,453,17432,12805,495,1545,1151,1376,486,17858
2020-01-30,충남,충남,94756,3690,8118,6930,10475,4615,128584,94756,3690,8118,6930,10475,4615,128584
2020-01-30,충남,충북,13517,629,919,924,1409,823,18221,12344,618,865,848,1411,726,16812
2020-01-30,충북,강원,4664,189,251,210,256,267,5837,4578,213,283,241,327,270,5912
2020-01-30,충북,경기,25764,2079,2893,2799,3428,1273,38236,26476,2163,3082,3143,3353,1342,39559
2020-01-30,충북,경남,1317,85,211,471,631,44,2759,1096,61,155,274,292,27,1905
2020-01-30,충북,경북,4572,232,550,681,929,186,7150,4840,213,515,712,902,187,7369
2020-01-30,충북,광주,610,41,95,165,103,11,1025,544,29,81,111,43,12,820
2020-01-30,충북,대구,1274,82,171,227,117,40,1911,1762,89,227,261,461,55,2855
2020-01-30,충북,대전,9670,402,436,176,136,721,11541,10714,484,474,199,166,827,12864
2020-01-30,충북,부산,104,13,25,119,186,7,454,129,12,20,86,234,4,485
2020-01-30,충북,서울,12842,599,1157,836,807,557,16798,13392,512,1186,807,650,548,17095
2020-01-30,충북,세종,314,9,19,10,20,22,394,369,8,23,11,16,22,449
2020-01-30,충북,울산,17,0,2,11,27,1,58,21,3,7,20,39,1,91
2020-01-30,충북,전남,425,14,41,113,286,9,888,365,19,41,84,356,7,872
2020-01-30,충북,전북,1827,117,201,255,254,54,2708,1744,120,156,303,271,61,2655
2020-01-30,충북,충남,12344,618,865,848,1411,726,16812,13517,629,919,924,1409,823,18221
2020-01-30,충북,충북,36209,1912,2312,2156,2690,2172,47451,36209,1912,2312,2156,2690,2172,47451
2020-01-31,강원,강원,69616,1999,3085,1225,1590,4441,81956,69616,1999,3085,1225,1590,4441,81956
2020-01-31,강원,경기,19520,551,1280,614,698,975,23638,25420,552,1240,633,834,1145,29824
2020-01-31,강원,경남,212,3,12,13,16,7,263,162,2,10,20,9,3,206
2020-01-31,강원,경북,574,21,45,17,22,20,699,596,18,49,16,28,20,727
2020-01-31,강원,광주,112,1,18,11,5,5,152,127,0,15,10,0,1,153
2020-01-31,강원,대구,216,3,19,13,9,4,264,427,6,15,19,12,7,486
2020-01-31,강원,대전,218,1,23,4,0,9,255,231,3,25,7,3,11,280
2020-01-31,강원,부산,1,1,0,4,0,0,6,4,0,0,0,1,0,5
2020-01-31,강원,서울,447,4,244,7,18,19,739,944,17,256,7,8,29,1261
2020-01-31,강원,세종,7,0,0,0,0,1,8,17,0,0,0,1,0,18
2020-01-31,강원,울산,2,0,2,0,0,0,4,4,0,0,1,0,0,5
2020-01-31,강원,전남,48,1,4,9,6,3,71,73,2,2,2,21,1,101
2020-01-31,강원,전북,171,6,21,17,18,6,239,217,8,19,29,18,8,299
2020-01-31,강원,충남,386,4,17,18,37,14,476,621,8,28,46,42,31,776
2020-01-31,강원,충북,5105,204,287,235,334,287,6452,5675,186,276,211,267,311,6926
2020-01-31,경기,강원,25420,552,1240,633,834,1145,29824,19520,551,1280,614,698,975,23638
2020-01-31,경기,경기,428263,22608,25110,18771,23974,32200,550926,428263,22608,25110,18771,23974,32200,550926
2020-01-31,경기,경남,2881,97,316,690,575,110,4669,2246,80,287,574,424,71,3682
2020-01-31,경기,경북,4840,201,518,778,623,134,7094,4825,222,498,868,624,160,7197
2020-01-31,경기,광주,1062,36,186,334,191,32,1841,800,39,156,235,122,21,1373
2020-01-31,경기,대구,2060,82,189,303,212,70,2916,3131,132,250,460,498,99,4570
2020-01-31,경기,대전,2646,105,222,99,62,133,3267,2159,110,198,83,57,108,2715
2020-01-31,경기,부산,230,24,52,203,190,6,705,286,23,37,170,289,16,821
2020-01-31,경기,서울,124107,5155,7883,3765,2865,8259,152034,143607,6860,9523,4941,3123,9964,178018
2020-01-31,경기,세종,59,2,4,5,4,5,79,67,3,5,3,6,4,88
2020-01-31,경기,울산,32,2,5,14,17,1,71,36,1,13,33,81,0,164
2020-01-31,경기,전남,879,19,110,196,145,36,1385,847,20,83,124,155,31,1260
2020-01-31,경기,전북,1690,70,191,114,225,63,2353,1517,47,161,165,196,50,2136
2020-01-31,경기,충남,37855,1454,2834,2436,4453,2002,51034,40763,1406,2746,2359,4010,2088,53372
2020-01-31,경기,충북,29487,2109,2961,3092,3308,1492,42449,29619,2076,2823,2682,3344,1502,42046
2020-01-31,경남,강원,162,2,10,20,9,3,206,212,3,12,13,16,7,263
2020-01-31,경남,경기,2246,80,287,574,424,71,3682,2881,97,316,690,575,110,4669
2020-01-31,경남,경남,188679,9585,9688,6439,12059,14255,240705,188679,9585,9688,6439,12059,14255,240705
2020-01-31,경남,경북,9260,511,874,772,1723,436,13576,12573,722,1029,1096,2567,593,18580
2020-01-31,경남,광주,1394,57,161,160,146,44,1962,1309,53,177,174,116,44,1873
2020-01-31,경남,대구,5590,348,640,481,439,294,7792,9473,468,731,388,399,406,11865
2020-01-31,경남,대전,959,25,106,65,56,45,1256,1196,26,109,125,62,47,1565
2020-01-31,경남,부산,92197,2756,3110,1995,4938,6462,111458,86773,2731,3148,1931,5265,6323,106171
2020-01-31,경남,서울,1012,22,440,132,69,32,1707,2460,62,474,198,109,70,3373
2020-01-31,경남,세종,268,2,13,12,5,8,308,289,2,20,12,13,11,347
2020-01-31,경남,울산,10713,651,731,476,650,644,13865,10348,602,763,413,645,655,13426
2020-01-31,경남,전남,6143,260,476,495,1518,286,9178,6798,282,471,433,1451,309,9744
2020-01-31,경남,전북,1514,45,132,107,185,49,2032,1462,54,166,107,205,38,2032
2020-01-31,경남,충남,1303,50,149,277,230,44,2053,2003,56,150,303,537,66,3115
2020-01-31,경남,충북,1253,56,137,257,274,46,2023,1783,70,212,483,536,52,3136
2020-01-31,경북,강원,596,18,49,16,28,20,727,574,21,45,17,22,20,699
2020-01-31,경북,경기,4825,222,498,868,624,160,7197,4840,201,518,778,623,134,7094
2020-01-31,경북,경남,12573,722,1029,1096,2567,593,18580,9260,511,874,772,1723,436,13576
2020-01-31,경북,경북,76083,3679,4190,2813,4489,4119,95373,76083,3679,4190,2813,4489,4119,95373
2020-01-31,경북,광주,1055,48,154,216,114,39,1626,902,48,118,188,70,27,1353
2020-01-31,경북,대구,59498,2444,2453,1308,2029,3275,71007,75481,3013,3238,1972,3003,4150,90857
2020-01-31,경북,대전,2068,70,116,103,85,95,2537,1903,53,125,128,77,85,2371
2020-01-31,경북,부산,5173,114,352,227,678,214,6758,4732,119,349,218,824,221,6463
2020-01-31,경북,서울,1393,40,199,146,58,46,1882,3146,76,375,228,112,107,4044
2020-01-31,경북,세종,349,3,23,14,10,12,411,339,13,25,18,12,21,428
2020-01-31,경북,울산,5262,173,362,410,1062,299,7568,5222,151,344,342,1272,296,7627
2020-01-31,경북,전남,1123,47,85,112,454,29,1850,1207,53,77,116,561,43,2057
2020-01-31,경북,전북,1952,83,175,171,230,55,2666,1724,83,145,137,247,56,2392
2020-01-31,경북,충남,3219,126,382,527,577,121,4952,4010,139,373,536,667,149,5874
2020-01-31,경북,충북,5681,206,530,672,837,236,8162,5568,209,538,626,880,238,8059
2020-01-31,광주,강원,127,0,15,10,0,1,153,112,1,18,11,5,5,152
2020-01-31,광주,경기,800,39,156,235,122,21,1373,1062,36,186,334,191,32,1841
2020-01-31,광주,경남,1309,53,177,174,116,44,1873,1394,57,161,160,146,44,1962
2020-01-31,광주,경북,902,48,118,188,70,27,1353,1055,48,154,216,114,39,1626
2020-01-31,광주,광주,13302,496,640,356,272,586,15652,13302,496,640,356,272,586,15652
2020-01-31,광주,대구,668,33,93,77,29,28,928,688,36,105,69,31,15,944
2020-01-31,광주,대전,514,18,11,20,17,15,595,576,16,26,24,22,16,680
2020-01-31,광주,부산,505,12,44,26,77,10,674,538,17,59,64,124,11,813
2020-01-31,광주,서울,583,15,15,74,25,14,726,889,17,40,42,22,23,1033
2020-01-31,광주,세종,168,3,7,1,3,2,184,256,2,9,5,3,5,280
2020-01-31,광주,울산,50,1,8,2,3,1,65,64,0,11,5,6,2,88
2020-01-31,광주,전남,33698,915,1206,760,1617,1402,39598,34656,899,1109,635,1586,1405,40290
2020-01-31,광주,전북,8205,414,572,367,356,331,10245,8805,448,497,328,337,345,10760
2020-01-31,광주,충남,4322,130,620,438,246,130,5886,5037,138,611,608,365,152,6911
2020-01-31,광주,충북,620,22,65,116,63,11,897,775,30,106,183,115,24,1233
2020-01-31,대구,강원,427,6,15,19,12,7,486,216,3,19,13,9,4,264
2020-01-31,대구,경기,3131,132,250,460,498,99,4570,2060,82,189,303,212,70,2916
2020-01-31,대구,경남,9473,468,731,388,399,406,11865,5590,348,640,481,439,294,7792
2020-01-31,대구,경북,75481,3013,3238,1972,3003,4150,90857,59498,2444,2453,1308,2029,3275,71007
2020-01-31,대구,광주,688,36,105,69,31,15,944,668,33,93,77,29,28,928
2020-01-31,대구,대구,45238,1630,1450,607,742,3170,52837,45238,1630,1450,607,742,3170,52837
2020-01-31,대구,대전,1068,45,57,78,46,50,1344,648,37,38,43,18,32,816
2020-01-31,대구,부산,719,49,107,65,174,22,1136,813,63,109,65,214,31,1295
2020-01-31,대구,서울,1144,22,125,100,43,29,1463,1584,62,152,97,40,44,1979
2020-01-31,대구,세종,296,7,11,7,10,8,339,186,0,3,9,2,9,209
2020-01-31,대구,울산,1357,51,152,94,211,55,1920,921,47,84,69,204,44,1369
2020-01-31,대구,전남,510,18,46,26,46,19,665,555,14,44,28,72,10,723
2020-01-31,대구,전북,398,12,42,15,28,10,505,399,9,41,15,14,14,492
2020-01-31,대구,충남,1404,63,164,238,244,51,2164,1308,47,112,130,157,56,1810
2020-01-31,대구,충북,1905,92,214,270,422,67,2970,1463,80,151,173,108,38,2013
2020-01-31,대전,강원,231,3,25,7,3,11,280,218,1,23,4,0,9,255
2020-01-31,대전,경기,2159,110,198,83,57,108,2715,2646,105,222,99,62,133,3267
2020-01-31,대전,경남,1196,26,109,125,62,47,1565,959,25,106,65,56,45,1256
2020-01-31,대전,경북,1903,53,125,128,77,85,2371,2068,70,116,103,85,95,2537
2020-01-31,대전,광주,576,16,26,24,22,16,680,514,18,11,20,17,15,595
2020-01-31,대전,대구,648,37,38,43,18,32,816,1068,45,57,78,46,50,1344
2020-01-31,대전,대전,14071,417,435,376,299,1076,16674,14071,417,435,376,299,1076,16674
2020-01-31,대전,부산,84,2,6,14,29,0,135,94,4,7,15,23,1,144
2020-01-31,대전,서울,911,22,145,15,11,47,1151,1974,54,214,37,14,94,2387
2020-01-31,대전,세종,3519,115,82,26,50,326,4118,3532,117,79,23,65,304,4120
2020-01-31,대전,울산,87,4,12,16,25,6,150,109,3,13,9,29,2,165
2020-01-31,대전,전남,288,9,10,33,33,6,379,395,6,11,25,27,10,474
2020-01-31,대전,전북,3382,79,97,93,34,161,3846,3606,84,100,75,47,146,4058
2020-01-31,대전,충남,15941,458,529,297,208,1265,18698,15456,442,510,292,215,1182,18097
2020-01-31,대전,충북,10930,478,441,179,144,809,12981,10325,397,425,152,138,772,12209
2020-01-31,부산,강원,4,0,0,0,1,0,5,1,1,0,4,0,0,6
2020-01-31,부산,경기,286,23,37,170,289,16,821,230,24,52,203,190,6,705
2020-01-31,부산,경남,86773,2731,3148,1931,5265,6323,106171,92197,2756,3110,1995,4938,6462,111458
2020-01-31,부산,경북,4732,119,349,218,824,221,6463,5173,114,352,227,678,214,6758
2020-01-31,부산,광주,538,17,59,64,124,11,813,505,12,44,26,77,10,674
2020-01-31,부산,대구,813,63,109,65,214,31,1295,719,49,107,65,174,22,1136
2020-01-31,부산,대전,94,4,7,15,23,1,144,84,2,6,14,29,0,135
2020-01-31,부산,부산,42745,734,687,607,1957,3088,49818,42745,734,687,607,1957,3088,49818
2020-01-31,부산,서울,111,5,14,37,22,2,191,216,6,15,78,32,6,353
2020-01-31,부산,세종,17,0,1,2,3,0,23,18,1,2,1,3,0,25
2020-01-31,부산,울산,16676,408,523,667,2672,1139,22085,18245,418,459,431,2532,1261,23346
2020-01-31,부산,전남,2232,77,135,176,619,78,3317,2084,71,136,119,577,79,3066
2020-01-31,부산,전북,392,20,44,31,119,10,616,295,9,33,33,68,8,446
2020-01-31,부산,충남,162,10,23,78,155,5,433,180,14,27,78,224,8,531
2020-01-31,부산,충북,130,11,16,79,193,2,431,132,9,24,105,180,2,452
2020-01-31,서울,강원,944,17,256,7,8,29,1261,447,4,244,7,18,19,739
2020-01-31,서울,경기,143607,6860,9523,4941,3123,9964,178018,124107,5155,7883,3765,2865,8259,152034
2020-01-31,서울,경남,2460,62,474,198,109,70,3373,1012,22,440,132,69,32,1707
2020-01-31,서울,경북,3146,76,375,228,112,107,4044,1393,40,199,146,58,46,1882
2020-01-31,서울,광주,889,17,40,42,22,23,1033,583,15,15,74,25,14,726
2020-01-31,서울,대구,1584,62,152,97,40,44,1979,1144,22,125,100,43,29,1463
2020-01-31,서울,대전,1974,54,214,37,14,94,2387,911,22,145,15,11,47,1151
2020-01-31,서울,부산,216,6,15,78,32,6,353,111,5,14,37,22,2,191
2020-01-31,서울,서울,147,6,7,2,2,6,170,147,6,7,2,2,6,170
2020-01-31,서울,세종,46,0,1,0,0,1,48,23,0,0,0,0,0,23
2020-01-31,서울,울산,30,0,5,3,2,2,42,17,1,6,8,8,0,40
2020-01-31,서울,전남,955,10,18,30,33,34,1080,784,7,30,57,26,28,932
2020-01-31,서울,전북,1497,15,43,19,32,59,1665,875,10,33,17,26,32,993
2020-01-31,서울,충남,25468,459,2426,784,756,1063,30956,26905,587,2458,1085,1182,1090,33307
2020-01-31,서울,충북,13420,520,1181,745,706,649,17221,6206,216,672,380,413,225,8112
2020-01-31,세종,강원,17,0,0,0,1,0,18,7,0,0,0,0,1,8
2020-01-31,세종,경기,67,3,5,3,6,4,88,59,2,4,5,4,5,79
2020-01-31,세종,경남,289,2,20,12,13,11,347,268,2,13,12,5,8,308
2020-01-31,세종,경북,339,13,25,18,12,21,428,349,3,23,14,10,12,411
2020-01-31,세종,광주,256,2,9,5,3,5,280,168,3,7,1,3,2,184
2020-01-31,세종,대구,186,0,3,9,2,9,209,296,7,11,7,10,8,339
2020-01-31,세종,대전,3532,117,79,23,65,304,4120,3519,115,82,26,50,326,4118
2020-01-31,세종,부산,18,1,2,1,3,0,25,17,0,1,2,3,0,23
2020-01-31,세종,서울,23,0,0,0,0,0,23,46,0,1,0,0,1,48
2020-01-31,세종,세종,270,18,8,0,1,23,320,270,18,8,0,1,23,320
2020-01-31,세종,울산,6,1,0,1,5,0,13,8,2,0,1,4,0,15
2020-01-31,세종,전남,216,5,2,14,16,3,256,221,2,5,5,18,6,257
2020-01-31,세종,전북,783,24,27,13,40,31,918,816,14,27,14,33,25,929
2020-01-31,세종,충남,6012,165,144,101,160,324,6906,5150,150,168,111,164,273,6016
2020-01-31,세종,충북,366,12,20,15,11,22,446,314,11,21,8,17,21,392
2020-01-31,울산,강원,4,0,0,1,0,0,5,2,0,2,0,0,0,4
2020-01-31,울산,경기,36,1,13,33,81,0,164,32,2,5,14,17,1,71
2020-01-31,울산,경남,10348,602,763,413,645,655,13426,10713,651,731,476,650,644,13865
2020-01-31,울산,경북,5222,151,344,342,1272,296,7627,5262,173,362,410,1062,299,7568
2020-01-31,울산,광주,64,0,11,5,6,2,88,50,1,8,2,3,1,65
2020-01-31,울산,대구,921,47,84,69,204,44,1369,1357,51,152,94,211,55,1920
2020-01-31,울산,대전,109,3,13,9,29,2,165,87,4,12,16,25,6,150
2020-01-31,울산,부산,18245,418,459,431,2532,1261,23346,16676,408,523,667,2672,1139,22085
2020-01-31,울산,서울,17,1,6,8,8,0,40,30,0,5,3,2,2,42
2020-01-31,울산,세종,8,2,0,1,4,0,15,6,1,0,1,5,0,13
2020-01-31,울산,울산,8380,268,552,331,530,780,10841,8380,268,552,331,530,780,10841
2020-01-31,울산,전남,207,11,20,12,35,8,293,208,14,25,14,30,11,302
2020-01-31,울산,전북,48,0,9,2,10,1,70,57,2,8,3,9,0,79
2020-01-31,울산,충남,108,3,21,47,117,3,299,130,6,13,28,98,4,279
2020-01-31,울산,충북,29,2,3,15,46,2,97,17,0,1,6,35,2,61
2020-01-31,전남,강원,73,2,2,2,21,1,101,48,1,4,9,6,3,71
2020-01-31,전남,경기,847,20,83,124,155,31,1260,879,19,110,196,145,36,1385
2020-01-31,전남,경남,6798,282,471,433,1451,309,9744,6143,260,476,495,1518,286,9178
2020-01-31,전남,경북,1207,53,77,116,561,43,2057,1123,47,85,112,454,29,1850
2020-01-31,전남,광주,34656,899,1109,635,1586,1405,40290,33698,915,1206,760,1617,1402,39598
2020-01-31,전남,대구,555,14,44,28,72,10,723,510,18,46,26,46,19,665
2020-01-31,전남,대전,395,6,11,25,27,10,474,288,9,10,33,33,6,379
2020-01-31,전남,부산,2084,71,136,119,577,79,3066,2232,77,135,176,619,78,3317
2020-01-31,전남,서울,784,7,30,57,26,28,932,955,10,18,30,33,34,1080
2020-01-31,전남,세종,221,2,5,5,18,6,257,216,5,2,14,16,3,256
2020-01-31,전남,울산,208,14,25,14,30,11,302,207,11,20,12,35,8,293
2020-01-31,전남,전남,46570,1283,1555,1765,4419,1912,57504,46570,1283,1555,1765,4419,1912,57504
2020-01-31,전남,전북,5383,258,516,613,1270,166,8206,5128,220,431,577,1237,164,7757
2020-01-31,전남,충남,4978,103,452,583,1059,137,7312,5049,100,467,485,977,159,7237
2020-01-31,전남,충북,483,16,50,76,303,19,947,449,16,40,98,274,14,891
2020-01-31,전북,강원,217,8,19,29,18,8,299,171,6,21,17,18,6,239
2020-01-31,전북,경기,1517,47,161,165,196,50,2136,1690,70,191,114,225,63,2353
2020-01-31,전북,경남,1462,54,166,107,205,38,2032,1514,45,132,107,185,49,2032
2020-01-31,전북,경북,1724,83,145,137,247,56,2392,1952,83,175,171,230,55,2666
2020-01-31,전북,광주,8805,448,497,328,337,345,10760,8205,414,572,367,356,331,10245
2020-01-31,전북,대구,399,9,41,15,14,14,492,398,12,42,15,28,10,505
2020-01-31,전북,대전,3606,84,100,75,47,146,4058,3382,79,97,93,34,161,3846
2020-01-31,전북,부산,295,9,33,33,68,8,446,392,20,44,31,119,10,616
2020-01-31,전북,서울,875,10,33,17,26,32,993,1497,15,43,19,32,59,1665
2020-01-31,전북,세종,816,14,27,14,33,25,929,783,24,27,13,40,31,918
2020-01-31,전북,울산,57,2,8,3,9,0,79,48,0,9,2,10,1,70
2020-01-31,전북,전남,5128,220,431,577,1237,164,7757,5383,258,516,613,1270,166,8206
2020-01-31,전북,전북,16562,612,929,660,802,684,20249,16562,612,929,660,802,684,20249
2020-01-31,전북,충남,14819,536,1588,1097,1353,531,19924,15306,496,1566,943,1397,569,20277
2020-01-31,전북,충북,2036,111,186,302,244,63,2942,2180,120,234,291,239,71,3135
2020-01-31,충남,강원,621,8,28,46,42,31,776,386,4,17,18,37,14,476
2020-01-31,충남,경기,40763,1406,2746,2359,4010,2088,53372,37855,1454,2834,2436,4453,2002,51034
2020-01-31,충남,경남,2003,56,150,303,537,66,3115,1303,50,149,277,230,44,2053
2020-01-31,충남,경북,4010,139,373,536,667,149,5874,3219,126,382,527,577,121,4952
2020-01-31,충남,광주,5037,138,611,608,365,152,6911,4322,130,620,438,246,130,5886
2020-01-31,충남,대구,1308,47,112,130,157,56,1810,1404,63,164,238,244,51,2164
2020-01-31,충남,대전,15456,442,510,292,215,1182,18097,15941,458,529,297,208,1265,18698
2020-01-31,충남,부산,180,14,27,78,224,8,531,162,10,23,78,155,5,433
2020-01-31,충남,서울,26905,587,2458,1085,1182,1090,33307,25468,459,2426,784,756,1063,30956
2020-01-31,충남,세종,5150,150,168,111,164,273,6016,6012,165,144,101,160,324,6906
2020-01-31,충남,울산,130,6,13,28,98,4,279,108,3,21,47,117,3,299
2020-01-31,충남,전남,5049,100,467,485,977,159,7237,4978,103,452,583,1059,137,7312
2020-01-31,충남,전북,15306,496,1566,943,1397,569,20277,14819,536,1588,1097,1353,531,19924
2020-01-31,충남,충남,101318,3439,8092,6649,9790,4833,134121,101318,3439,8092,6649,9790,4833,134121
2020-01-31,충남,충북,14443,642,853,931,1349,861,19079,12606,608,799,798,1295,717,16823
2020-01-31,충북,강원,5675,186,276,211,267,311,6926,5105,204,287,235,334,287,6452
2020-01-31,충북,경기,29619,2076,2823,2682,3344,1502,42046,29487,2109,2961,3092,3308,1492,42449
2020-01-31,충북,경남,1783,70,212,483,536,52,3136,1253,56,137,257,274,46,2023
2020-01-31,충북,경북,5568,209,538,626,880,238,8059,5681,206,530,672,837,236,8162
2020-01-31,충북,광주,775,30,106,183,115,24,1233,620,22,65,116,63,11,897
2020-01-31,충북,대구,1463,80,151,173,108,38,2013,1905,92,214,270,422,67,2970
2020-01-31,충북,대전,10325,397,425,152,138,772,12209,10930,478,441,179,144,809,12981
2020-01-31,충북,부산,132,9,24,105,180,2,452,130,11,16,79,193,2,431
2020-01-31,충북,서울,6206,216,672,380,413,225,8112,13420,520,1181,745,706,649,17221
2020-01-31,충북,세종,314,11,21,8,17,21,392,366,12,20,15,11,22,446
2020-01-31,충북,울산,17,0,1,6,35,2,61,29,2,3,15,46,2,97
2020-01-31,충북,전남,449,16,40,98,274,14,891,483,16,50,76,303,19,947
2020-01-31,충북,전북,2180,120,234,291,239,71,3135,2036,111,186,302,244,63,2942
2020-01-31,충북,충남,12606,608,799,798,1295,717,16823,14443,642,853,931,1349,861,19079
2020-01-31,충북,충북,37122,1871,2320,1907,2389,2194,47803,37122,1871,2320,1907,2389,2194,47803
2020-02-01,강원,강원,89935,1423,2764,690,1375,4695,100882,89935,1423,2764,690,1375,4695,100882
2020-02-01,강원,경기,28357,304,1133,339,320,1216,31669,39193,355,1102,354,432,1598,43034
2020-02-01,강원,경남,178,1,23,4,7,7,220,174,1,13,13,2,11,214
2020-02-01,강원,경북,653,15,45,3,12,23,751,714,10,30,10,1,19,784
2020-02-01,강원,광주,111,2,24,4,1,0,142,117,3,14,6,1,1,142
2020-02-01,강원,대구,281,3,16,7,3,9,319,545,5,26,6,2,9,593
2020-02-01,강원,대전,248,5,35,1,1,8,298,291,6,39,2,2,13,353
2020-02-01,강원,부산,6,1,0,0,0,0,7,10,0,0,1,0,0,11
2020-02-01,강원,서울,916,12,380,6,7,25,1346,1454,12,325,8,2,44,1845
2020-02-01,강원,세종,4,0,0,0,0,1,5,12,0,0,0,0,0,12
2020-02-01,강원,울산,2,0,0,0,0,0,2,3,0,1,0,4,0,8
2020-02-01,강원,전남,70,0,1,2,8,0,81,63,1,2,2,4,2,74
2020-02-01,강원,전북,179,1,18,7,2,8,215,224,4,17,16,6,5,272
2020-02-01,강원,충남,396,5,17,12,14,18,462,672,6,23,30,35,22,788
2020-02-01,강원,충북,5023,139,213,126,199,260,5960,6012,122,192,128,182,281,6917
2020-02-01,경기,강원,39193,355,1102,354,432,1598,43034,28357,304,1133,339,320,1216,31669
2020-02-01,경기,경기,336558,10344,12330,8387,12502,22075,402196,336558,10344,12330,8387,12502,22075,402196
2020-02-01,경기,경남,3158,58,283,477,346,128,4450,1974,32,206,274,200,69,2755
2020-02-01,경기,경북,5783,77,296,373,326,180,7035,4570,68,284,410,281,149,5762
2020-02-01,경기,광주,1000,13,140,175,102,31,1461,840,9,106,108,43,26,1132
2020-02-01,경기,대구,2513,38,167,233,129,74,3154,2852,50,172,217,163,93,3547
2020-02-01,경기,대전,2980,53,176,80,29,135,3453,2592,54,176,51,18,115,3006
2020-02-01,경기,부산,287,8,41,151,70,6,563,240,8,26,92,115,8,489
2020-02-01,경기,서울,124841,4212,5666,2596,2099,7383,146797,118482,3612,5498,2104,1876,7151,138723
2020-02-01,경기,세종,36,2,2,2,2,0,44,48,3,2,0,0,6,59
2020-02-01,경기,울산,26,0,4,6,12,0,48,40,0,5,13,47,3,108
2020-02-01,경기,전남,1178,11,93,84,101,38,1505,884,9,80,78,60,34,1145
2020-02-01,경기,전북,2187,32,130,60,90,82,2581,1717,29,119,71,81,53,2070
2020-02-01,경기,충남,39936,701,1737,1094,1787,1894,47149,37780,640,1731,1028,1734,1820,44733
2020-02-01,경기,충북,29312,894,1497,1333,1630,1457,36123,27000,874,1415,1304,1595,1292,33480
2020-02-01,경남,강원,174,1,13,13,2,11,214,178,1,23,4,7,7,220
2020-02-01,경남,경기,1974,32,206,274,200,69,2755,3158,58,283,477,346,128,4450
2020-02-01,경남,경남,178972,5721,6068,3978,7843,12329,214911,178972,5721,6068,3978,7843,12329,214911
2020-02-01,경남,경북,14230,300,656,445,880,652,17163,16662,446,802,666,1226,752,20554
2020-02-01,경남,광주,1400,29,106,121,54,49,1759,1541,24,107,71,29,51,1823
2020-02-01,경남,대구,16347,353,771,465,683,686,19305,14320,260,597,246,218,590,16231
2020-02-01,경남,대전,984,12,82,21,21,52,1172,1457,16,111,72,41,76,1773
2020-02-01,경남,부산,89068,1554,2220,1123,2245,5712,101922,85463,1515,2197,981,2337,5545,98038
2020-02-01,경남,서울,2031,22,464,131,73,56,2777,2893,31,545,136,84,99,3788
2020-02-01,경남,세종,168,3,5,1,6,8,191,336,2,14,4,6,9,371
2020-02-01,경남,울산,11041,343,391,199,275,642,12891,11055,318,398,187,245,626,12829
2020-02-01,경남,전남,7207,152,303,223,822,309,9016,7019,149,325,178,805,294,8770
2020-02-01,경남,전북,2084,23,103,49,74,74,2407,1755,24,105,52,72,72,2080
2020-02-01,경남,충남,1154,18,70,95,92,25,1454,1987,22,106,188,252,58,2613
2020-02-01,경남,충북,1219,10,98,119,147,40,1633,1808,26,142,281,321,60,2638
2020-02-01,경북,강원,714,10,30,10,1,19,784,653,15,45,3,12,23,751
2020-02-01,경북,경기,4570,68,284,410,281,149,5762,5783,77,296,373,326,180,7035
2020-02-01,경북,경남,16662,446,802,666,1226,752,20554,14230,300,656,445,880,652,17163
2020-02-01,경북,경북,76928,2100,2717,1465,2778,3955,89943,76928,2100,2717,1465,2778,3955,89943
2020-02-01,경북,광주,951,15,82,87,69,23,1227,874,16,60,94,48,30,1122
2020-02-01,경북,대구,70737,1748,1957,847,2210,3562,81061,75488,1779,2152,1019,2157,3774,86369
2020-02-01,경북,대전,2316,31,99,38,36,109,2629,2451,23,77,83,30,120,2784
2020-02-01,경북,부산,6682,71,308,98,258,310,7727,7616,65,330,99,313,332,8755
2020-02-01,경북,서울,3146,40,314,167,75,112,3854,4182,39,330,130,67,155,4903
2020-02-01,경북,세종,333,1,16,9,7,15,381,376,2,9,5,6,15,413
2020-02-01,경북,울산,6047,71,209,209,591,347,7474,6522,67,185,164,764,368,8070
2020-02-01,경북,전남,1289,24,58,48,232,39,1690,1274,18,47,46,275,34,1694
2020-02-01,경북,전북,1866,39,126,92,151,56,2330,1653,38,100,78,144,35,2048
2020-02-01,경북,충남,3334,45,171,203,308,120,4181,4014,47,206,255,370,136,5028
2020-02-01,경북,충북,6223,119,311,302,454,220,7629,6511,121,343,326,553,257,8111
2020-02-01,광주,강원,117,3,14,6,1,1,142,111,2,24,4,1,0,142
2020-02-01,광주,경기,840,9,106,108,43,26,1132,1000,13,140,175,102,31,1461
2020-02-01,광주,경남,1541,24,107,71,29,51,1823,1400,29,106,121,54,49,1759
2020-02-01,광주,경북,874,16,60,94,48,30,1122,951,15,82,87,69,23,1227
2020-02-01,광주,광주,11946,288,494,211,186,445,13570,11946,288,494,211,186,445,13570
2020-02-01,광주,대구,679,15,78,45,12,15,844,667,17,92,45,9,19,849
2020-02-01,광주,대전,551,12,11,12,7,24,617,622,9,10,20,14,18,693
2020-02-01,광주,부산,657,4,69,17,28,17,792,503,0,69,21,36,14,643
2020-02-01,광주,서울,687,9,16,48,9,19,788,977,14,16,35,8,31,1081
2020-02-01,광주,세종,147,2,3,2,2,3,159,215,0,6,1,4,4,230
2020-02-01,광주,울산,64,0,9,0,2,1,76,46,0,9,4,2,2,63
2020-02-01,광주,전남,35665,601,967,497,1050,1290,40070,33581,612,887,403,1169,1219,37871
2020-02-01,광주,전북,8758,248,331,171,181,292,9981,8540,286,326,175,243,281,9851
2020-02-01,광주,충남,4610,63,581,214,127,119,5714,4938,81,570,373,209,140,6311
2020-02-01,광주,충북,578,16,46,49,27,10,726,738,17,56,81,57,20,969
2020-02-01,대구,강원,545,5,26,6,2,9,593,281,3,16,7,3,9,319
2020-02-01,대구,경기,2852,50,172,217,163,93,3547,2513,38,167,233,129,74,3154
2020-02-01,대구,경남,14320,260,597,246,218,590,16231,16347,353,771,465,683,686,19305
2020-02-01,대구,경북,75488,1779,2152,1019,2157,3774,86369,70737,1748,1957,847,2210,3562,81061
2020-02-01,대구,광주,667,17,92,45,9,19,849,679,15,78,45,12,15,844
2020-02-01,대구,대구,50419,1183,1233,606,830,2942,57213,50419,1183,1233,606,830,2942,57213
2020-02-01,대구,대전,1265,13,49,42,27,48,1444,938,13,32,39,12,27,1061
2020-02-01,대구,부산,826,19,71,33,36,36,1021,3615,55,208,38,65,172,4153
2020-02-01,대구,서울,2700,44,219,104,58,75,3200,2022,22,177,83,34,55,2393
2020-02-01,대구,세종,293,2,12,1,5,9,322,253,3,2,3,4,6,271
2020-02-01,대구,울산,1651,31,110,42,88,78,2000,1854,24,113,39,120,82,2232
2020-02-01,대구,전남,712,6,42,16,28,33,837,659,14,38,17,26,26,780
2020-02-01,대구,전북,477,6,31,4,11,19,548,401,8,30,9,10,15,473
2020-02-01,대구,충남,1474,26,72,66,100,51,1789,1335,20,60,77,92,51,1635
2020-02-01,대구,충북,2129,31,156,111,153,85,2665,1697,31,113,148,95,52,2136
2020-02-01,대전,강원,291,6,39,2,2,13,353,248,5,35,1,1,8,298
2020-02-01,대전,경기,2592,54,176,51,18,115,3006,2980,53,176,80,29,135,3453
2020-02-01,대전,경남,1457,16,111,72,41,76,1773,984,12,82,21,21,52,1172
2020-02-01,대전,경북,2451,23,77,83,30,120,2784,2316,31,99,38,36,109,2629
2020-02-01,대전,광주,622,9,10,20,14,18,693,551,12,11,12,7,24,617
2020-02-01,대전,대구,938,13,32,39,12,27,1061,1265,13,49,42,27,48,1444
2020-02-01,대전,대전,11234,234,265,94,155,757,12739,11234,234,265,94,155,757,12739
2020-02-01,대전,부산,110,2,2,12,7,4,137,88,1,10,10,22,5,136
2020-02-01,대전,서울,2180,24,244,20,6,83,2557,2336,22,249,31,7,82,2727
2020-02-01,대전,세종,2782,74,46,13,106,205,3226,2865,75,49,18,132,175,3314
2020-02-01,대전,울산,108,1,10,8,16,5,148,110,0,10,5,9,3,137
2020-02-01,대전,전남,456,5,6,29,16,11,523,405,4,14,7,18,14,462
2020-02-01,대전,전북,4462,48,76,62,32,181,4861,4169,65,71,31,35,175,4546
2020-02-01,대전,충남,13730,255,323,133,137,818,15396,13260,250,352,114,153,793,14922
2020-02-01,대전,충북,9425,292,312,128,83,584,10824,8874,231,319,93,78,568,10163
2020-02-01,부산,강원,10,0,0,1,0,0,11,6,1,0,0,0,0,7
2020-02-01,부산,경기,240,8,26,92,115,8,489,287,8,41,151,70,6,563
2020-02-01,부산,경남,85463,1515,2197,981,2337,5545,98038,89068,1554,2220,1123,2245,5712,101922
2020-02-01,부산,경북,7616,65,330,99,313,332,8755,6682,71,308,98,258,310,7727
2020-02-01,부산,광주,503,0,69,21,36,14,643,657,4,69,17,28,17,792
2020-02-01,부산,대구,3615,55,208,38,65,172,4153,826,19,71,33,36,36,1021
2020-02-01,부산,대전,88,1,10,10,22,5,136,110,2,2,12,7,4,137
2020-02-01,부산,부산,47601,425,389,317,966,3000,52698,47601,425,389,317,966,3000,52698
2020-02-01,부산,서울,236,7,12,29,21,4,309,272,9,25,36,26,8,376
2020-02-01,부산,세종,27,0,1,2,2,0,32,26,1,0,0,1,0,28
2020-02-01,부산,울산,18148,216,247,235,989,1098,20933,19898,211,212,168,1073,1237,22799
2020-02-01,부산,전남,2380,38,119,92,251,65,2945,2252,41,100,77,246,83,2799
2020-02-01,부산,전북,468,6,43,22,48,10,597,374,1,39,13,27,12,466
2020-02-01,부산,충남,150,3,9,24,58,9,253,158,4,13,37,103,4,319
2020-02-01,부산,충북,125,3,12,28,94,5,267,147,4,20,68,76,5,320
2020-02-01,서울,강원,1454,12,325,8,2,44,1845,916,12,380,6,7,25,1346
2020-02-01,서울,경기,118482,3612,5498,2104,1876,7151,138723,124841,4212,5666,2596,2099,7383,146797
2020-02-01,서울,경남,2893,31,545,136,84,99,3788,2031,22,464,131,73,56,2777
2020-02-01,서울,경북,4182,39,330,130,67,155,4903,3146,40,314,167,75,112,3854
2020-02-01,서울,광주,977,14,16,35,8,31,1081,687,9,16,48,9,19,788
2020-02-01,서울,대구,2022,22,177,83,34,55,2393,2700,44,219,104,58,75,3200
2020-02-01,서울,대전,2336,22,249,31,7,82,2727,2180,24,244,20,6,83,2557
2020-02-01,서울,부산,272,9,25,36,26,8,376,236,7,12,29,21,4,309
2020-02-01,서울,서울,157,3,7,1,5,8,181,157,3,7,1,5,8,181
2020-02-01,서울,세종,33,0,0,0,0,1,34,35,0,0,0,0,2,37
2020-02-01,서울,울산,24,1,6,2,1,2,36,31,0,5,4,14,0,54
2020-02-01,서울,전남,1214,3,27,22,19,26,1311,798,3,22,27,22,32,904
2020-02-01,서울,전북,1910,8,55,11,16,64,2064,1369,19,45,16,11,40,1500
2020-02-01,서울,충남,31420,270,2301,456,447,1190,36084,31011,314,2300,530,601,1247,36003
2020-02-01,서울,충북,15318,204,991,371,323,637,17844,14932,252,969,457,388,610,17608
2020-02-01,세종,강원,12,0,0,0,0,0,12,4,0,0,0,0,1,5
2020-02-01,세종,경기,48,3,2,0,0,6,59,36,2,2,2,2,0,44
2020-02-01,세종,경남,336,2,14,4,6,9,371,168,3,5,1,6,8,191
2020-02-01,세종,경북,376,2,9,5,6,15,413,333,1,16,9,7,15,381
2020-02-01,세종,광주,215,0,6,1,4,4,230,147,2,3,2,2,3,159
2020-02-01,세종,대구,253,3,2,3,4,6,271,293,2,12,1,5,9,322
2020-02-01,세종,대전,2865,75,49,18,132,175,3314,2782,74,46,13,106,205,3226
2020-02-01,세종,부산,26,1,0,0,1,0,28,27,0,1,2,2,0,32
2020-02-01,세종,서울,35,0,0,0,0,2,37,33,0,0,0,0,1,34
2020-02-01,세종,세종,237,17,6,2,1,16,279,237,17,6,2,1,16,279
2020-02-01,세종,울산,16,0,1,1,1,0,19,10,0,0,0,1,0,11
2020-02-01,세종,전남,240,1,1,4,18,7,271,180,1,3,2,9,4,199
2020-02-01,세종,전북,1019,8,12,6,19,42,1106,818,8,10,2,25,36,899
2020-02-01,세종,충남,5643,112,94,55,100,279,6283,4287,103,93,57,117,201,4858
2020-02-01,세종,충북,303,5,10,10,8,21,357,264,15,10,9,2,20,320
2020-02-01,울산,강원,3,0,1,0,4,0,8,2,0,0,0,0,0,2
2020-02-01,울산,경기,40,0,5,13,47,3,108,26,0,4,6,12,0,48
2020-02-01,울산,경남,11055,318,398,187,245,626,12829,11041,343,391,199,275,642,12891
2020-02-01,울산,경북,6522,67,185,164,764,368,8070,6047,71,209,209,591,347,7474
2020-02-01,울산,광주,46,0,9,4,2,2,63,64,0,9,0,2,1,76
2020-02-01,울산,대구,1854,24,113,39,120,82,2232,1651,31,110,42,88,78,2000
2020-02-01,울산,대전,110,0,10,5,9,3,137,108,1,10,8,16,5,148
2020-02-01,울산,부산,19898,211,212,168,1073,1237,22799,18148,216,247,235,989,1098,20933
2020-02-01,울산,서울,31,0,5,4,14,0,54,24,1,6,2,1,2,36
2020-02-01,울산,세종,10,0,0,0,1,0,11,16,0,1,1,1,0,19
2020-02-01,울산,울산,6008,109,186,104,274,479,7160,6008,109,186,104,274,479,7160
2020-02-01,울산,전남,213,4,10,4,7,8,246,236,8,8,7,8,9,276
2020-02-01,울산,전북,86,0,8,1,2,2,99,55,0,6,1,1,1,64
2020-02-01,울산,충남,117,2,6,11,37,7,180,117,3,8,18,47,5,198
2020-02-01,울산,충북,24,1,2,8,25,0,60,24,0,4,7,22,1,58
2020-02-01,전남,강원,63,1,2,2,4,2,74,70,0,1,2,8,0,81
2020-02-01,전남,경기,884,9,80,78,60,34,1145,1178,11,93,84,101,38,1505
2020-02-01,전남,경남,7019,149,325,178,805,294,8770,7207,152,303,223,822,309,9016
2020-02-01,전남,경북,1274,18,47,46,275,34,1694,1289,24,58,48,232,39,1690
2020-02-01,전남,광주,33581,612,887,403,1169,1219,37871,35665,601,967,497,1050,1290,40070
2020-02-01,전남,대구,659,14,38,17,26,26,780,712,6,42,16,28,33,837
2020-02-01,전남,대전,405,4,14,7,18,14,462,456,5,6,29,16,11,523
2020-02-01,전남,부산,2252,41,100,77,246,83,2799,2380,38,119,92,251,65,2945
2020-02-01,전남,서울,798,3,22,27,22,32,904,1214,3,27,22,19,26,1311
2020-02-01,전남,세종,180,1,3,2,9,4,199,240,1,1,4,18,7,271
2020-02-01,전남,울산,236,8,8,7,8,9,276,213,4,10,4,7,8,246
2020-02-01,전남,전남,45297,794,1254,906,2666,1704,52621,45297,794,1254,906,2666,1704,52621
2020-02-01,전남,전북,6033,180,353,370,791,185,7912,6006,132,310,409,817,175,7849
2020-02-01,전남,충남,4694,46,382,227,391,131,5871,5821,48,455,315,475,177,7291
2020-02-01,전남,충북,442,4,21,31,133,13,644,638,10,24,50,160,15,897
2020-02-01,전북,강원,224,4,17,16,6,5,272,179,1,18,7,2,8,215
2020-02-01,전북,경기,1717,29,119,71,81,53,2070,2187,32,130,60,90,82,2581
2020-02-01,전북,경남,1755,24,105,52,72,72,2080,2084,23,103,49,74,74,2407
2020-02-01,전북,경북,1653,38,100,78,144,35,2048,1866,39,126,92,151,56,2330
2020-02-01,전북,광주,8540,286,326,175,243,281,9851,8758,248,331,171,181,292,9981
2020-02-01,전북,대구,401,8,30,9,10,15,473,477,6,31,4,11,19,548
2020-02-01,전북,대전,4169,65,71,31,35,175,4546,4462,48,76,62,32,181,4861
2020-02-01,전북,부산,374,1,39,13,27,12,466,468,6,43,22,48,10,597
2020-02-01,전북,서울,1369,19,45,16,11,40,1500,1910,8,55,11,16,64,2064
2020-02-01,전북,세종,818,8,10,2,25,36,899,1019,8,12,6,19,42,1106
2020-02-01,전북,울산,55,0,6,1,1,1,64,86,0,8,1,2,2,99
2020-02-01,전북,전남,6006,132,310,409,817,175,7849,6033,180,353,370,791,185,7912
2020-02-01,전북,전북,14181,371,646,442,426,527,16593,14181,371,646,442,426,527,16593
2020-02-01,전북,충남,15460,220,1204,441,649,524,18498,17117,245,1234,525,755,628,20504
2020-02-01,전북,충북,2003,46,96,158,120,74,2497,2361,58,114,141,144,86,2904
2020-02-01,충남,강원,672,6,23,30,35,22,788,396,5,17,12,14,18,462
2020-02-01,충남,경기,37780,640,1731,1028,1734,1820,44733,39936,701,1737,1094,1787,1894,47149
2020-02-01,충남,경남,1987,22,106,188,252,58,2613,1154,18,70,95,92,25,1454
2020-02-01,충남,경북,4014,47,206,255,370,136,5028,3334,45,171,203,308,120,4181
2020-02-01,충남,광주,4938,81,570,373,209,140,6311,4610,63,581,214,127,119,5714
2020-02-01,충남,대구,1335,20,60,77,92,51,1635,1474,26,72,66,100,51,1789
2020-02-01,충남,대전,13260,250,352,114,153,793,14922,13730,255,323,133,137,818,15396
2020-02-01,충남,부산,158,4,13,37,103,4,319,150,3,9,24,58,9,253
2020-02-01,충남,서울,31011,314,2300,530,601,1247,36003,31420,270,2301,456,447,1190,36084
2020-02-01,충남,세종,4287,103,93,57,117,201,4858,5643,112,94,55,100,279,6283
2020-02-01,충남,울산,117,3,8,18,47,5,198,117,2,6,11,37,7,180
2020-02-01,충남,전남,5821,48,455,315,475,177,7291,4694,46,382,227,391,131,5871
2020-02-01,충남,전북,17117,245,1234,525,755,628,20504,15460,220,1204,441,649,524,18498
2020-02-01,충남,충남,98321,1811,5844,2899,4614,4075,117564,98321,1811,5844,2899,4614,4075,117564
2020-02-01,충남,충북,10980,298,458,438,793,576,13543,10291,322,422,352,699,535,12621
2020-02-01,충북,강원,6012,122,192,128,182,281,6917,5023,139,213,126,199,260,5960
2020-02-01,충북,경기,27000,874,1415,1304,1595,1292,33480,29312,894,1497,1333,1630,1457,36123
2020-02-01,충북,경남,1808,26,142,281,321,60,2638,1219,10,98,119,147,40,1633
2020-02-01,충북,경북,6511,121,343,326,553,257,8111,6223,119,311,302,454,220,7629
2020-02-01,충북,광주,738,17,56,81,57,20,969,578,16,46,49,27,10,726
2020-02-01,충북,대구,1697,31,113,148,95,52,2136,2129,31,156,111,153,85,2665
2020-02-01,충북,대전,8874,231,319,93,78,568,10163,9425,292,312,128,83,584,10824
2020-02-01,충북,부산,147,4,20,68,76,5,320,125,3,12,28,94,5,267
2020-02-01,충북,서울,14932,252,969,457,388,610,17608,15318,204,991,371,323,637,17844
2020-02-01,충북,세종,264,15,10,9,2,20,320,303,5,10,10,8,21,357
2020-02-01,충북,울산,24,0,4,7,22,1,58,24,1,2,8,25,0,60
2020-02-01,충북,전남,638,10,24,50,160,15,897,442,4,21,31,133,13,644
2020-02-01,충북,전북,2361,58,114,141,144,86,2904,2003,46,96,158,120,74,2497
2020-02-01,충북,충남,10291,322,422,352,699,535,12621,10980,298,458,438,793,576,13543
2020-02-01,충북,충북,31527,974,1179,1011,1474,1806,37971,31527,974,1179,1011,1474,1806,37971
2020-02-02,강원,강원,69369,586,2259,246,426,3713,76599,69369,586,2259,246,426,3713,76599
2020-02-02,강원,경기,38622,222,1014,186,127,1530,41701,22985,151,919,131,170,1073,25429
2020-02-02,강원,경남,314,0,22,4,6,4,350,131,0,11,6,4,3,155
2020-02-02,강원,경북,779,11,38,2,2,27,859,573,6,30,5,3,23,640
2020-02-02,강원,광주,128,0,16,5,0,6,155,104,0,16,1,2,1,124
2020-02-02,강원,대구,437,3,11,3,0,7,461,400,4,24,1,1,17,447
2020-02-02,강원,대전,276,1,33,0,3,10,323,227,0,36,0,0,6,269
2020-02-02,강원,부산,2,0,1,0,0,0,3,3,0,0,0,0,0,3
2020-02-02,강원,서울,1298,7,412,4,1,48,1770,849,7,327,0,2,39,1224
2020-02-02,강원,세종,10,0,1,0,0,0,11,6,0,1,0,0,0,7
2020-02-02,강원,울산,6,0,0,0,0,0,6,4,0,0,0,0,0,4
2020-02-02,강원,전남,78,0,2,1,4,3,88,71,0,2,2,11,4,90
2020-02-02,강원,전북,194,1,10,5,2,3,215,175,0,6,13,1,6,201
2020-02-02,강원,충남,654,1,15,5,4,29,708,511,2,17,7,12,20,569
2020-02-02,강원,충북,5246,68,137,46,51,239,5787,4542,54,150,40,49,240,5075
2020-02-02,경기,강원,22985,151,919,131,170,1073,25429,38622,222,1014,186,127,1530,41701
2020-02-02,경기,경기,255578,4823,7045,3088,3777,16721,291032,255578,4823,7045,3088,3777,16721,291032
2020-02-02,경기,경남,2465,25,214,128,72,79,2983,2435,17,180,98,65,104,2899
2020-02-02,경기,경북,4194,30,201,149,60,156,4790,5516,47,203,164,69,212,6211
2020-02-02,경기,광주,708,8,111,37,8,21,893,901,4,87,37,19,28,1076
2020-02-02,경기,대구,1898,10,131,50,17,61,2167,3095,19,143,78,58,109,3502
2020-02-02,경기,대전,1986,17,163,23,6,107,2302,2638,32,158,19,8,134,2989
2020-02-02,경기,부산,236,3,6,36,18,7,306,425,5,9,24,21,22,506
2020-02-02,경기,서울,99367,1808,4293,1205,409,5875,112957,103822,1818,4184,1044,405,6342,117615
2020-02-02,경기,세종,30,1,3,4,0,2,40,61,1,2,0,1,5,70
2020-02-02,경기,울산,24,0,0,2,9,1,36,29,1,1,7,15,1,54
2020-02-02,경기,전남,782,6,84,29,42,23,966,1154,5,73,49,48,28,1357
2020-02-02,경기,전북,1286,15,124,25,20,41,1511,2155,14,106,44,20,91,2430
2020-02-02,경기,충남,31503,303,1277,467,567,1640,35757,33925,316,1303,382,525,1638,38089
2020-02-02,경기,충북,22684,427,831,473,486,1178,26079,25810,457,845,391,447,1264,29214
2020-02-02,경남,강원,131,0,11,6,4,3,155,314,0,22,4,6,4,350
2020-02-02,경남,경기,2435,17,180,98,65,104,2899,2465,25,214,128,72,79,2983
2020-02-02,경남,경남,147999,2225,3712,867,1334,9385,165522,147999,2225,3712,867,1334,9385,165522
2020-02-02,경남,경북,12957,145,488,140,164,616,14510,17295,207,599,230,209,820,19360
2020-02-02,경남,광주,1434,20,83,35,17,55,1644,1437,16,105,35,13,42,1648
2020-02-02,경남,대구,15256,160,679,242,342,676,17355,12351,113,601,82,49,549,13745
2020-02-02,경남,대전,1068,7,97,30,7,45,1254,1273,9,98,12,4,51,1447
2020-02-02,경남,부산,72836,609,1795,248,553,4573,80614,71331,638,1667,234,542,4621,79033
2020-02-02,경남,서울,2212,19,488,139,67,68,2993,2345,17,514,26,16,78,2996
2020-02-02,경남,세종,253,4,7,0,0,9,273,253,3,16,1,0,10,283
2020-02-02,경남,울산,10222,127,287,46,37,600,11319,9684,106,319,40,50,554,10753
2020-02-02,경남,전남,6583,71,285,88,123,287,7437,6528,80,288,112,167,279,7454
2020-02-02,경남,전북,1728,16,89,21,8,57,1919,2040,22,94,30,16,84,2286
2020-02-02,경남,충남,1578,11,52,41,31,69,1782,1507,13,56,51,49,58,1734
2020-02-02,경남,충북,1514,16,61,57,51,60,1759,1529,20,117,89,61,60,1876
2020-02-02,경북,강원,573,6,30,5,3,23,640,779,11,38,2,2,27,859
2020-02-02,경북,경기,5516,47,203,164,69,212,6211,4194,30,201,149,60,156,4790
2020-02-02,경북,경남,17295,207,599,230,209,820,19360,12957,145,488,140,164,616,14510
2020-02-02,경북,경북,69730,826,1604,483,420,3319,76382,69730,826,1604,483,420,3319,76382
2020-02-02,경북,광주,861,14,66,58,15,31,1045,947,10,41,65,13,31,1107
2020-02-02,경북,대구,59978,617,1272,257,275,2875,65274,62899,638,1486,296,318,2999,68636
2020-02-02,경북,대전,2091,11,70,25,22,102,2321,2155,7,68,9,12,112,2363
2020-02-02,경북,부산,7075,38,315,23,57,306,7814,7369,36,350,26,78,307,8166
2020-02-02,경북,서울,4109,24,332,130,27,109,4731,2927,18,316,43,21,105,3430
2020-02-02,경북,세종,348,1,7,3,2,14,375,301,1,7,6,2,13,330
2020-02-02,경북,울산,6677,23,148,65,208,363,7484,5780,25,131,37,213,296,6482
2020-02-02,경북,전남,1253,15,53,33,65,39,1458,1309,11,46,26,112,33,1537
2020-02-02,경북,전북,1634,27,80,22,40,44,1847,1732,31,56,22,31,46,1918
2020-02-02,경북,충남,3611,22,71,51,85,153,3993,3157,21,73,60,96,126,3533
2020-02-02,경북,충북,6432,63,188,135,119,248,7185,5760,60,205,122,90,196,6433
2020-02-02,광주,강원,104,0,16,1,2,1,124,128,0,16,5,0,6,155
2020-02-02,광주,경기,901,4,87,37,19,28,1076,708,8,111,37,8,21,893
2020-02-02,광주,경남,1437,16,105,35,13,42,1648,1434,20,83,35,17,55,1644
2020-02-02,광주,경북,947,10,41,65,13,31,1107,861,14,66,58,15,31,1045
2020-02-02,광주,광주,9925,125,444,75,37,365,10971,9925,125,444,75,37,365,10971
2020-02-02,광주,대구,599,12,79,45,14,22,771,712,10,84,28,7,19,860
2020-02-02,광주,대전,467,3,5,1,6,12,494,503,4,10,1,2,11,531
2020-02-02,광주,부산,483,8,52,6,5,17,571,677,4,70,4,7,23,785
2020-02-02,광주,서울,897,8,17,8,7,24,961,692,14,10,8,2,17,743
2020-02-02,광주,세종,189,1,2,0,1,7,200,159,1,1,1,3,5,170
2020-02-02,광주,울산,71,0,11,0,0,3,85,48,0,9,1,2,3,63
2020-02-02,광주,전남,30299,270,807,166,129,1045,32716,29789,248,701,275,137,1082,32232
2020-02-02,광주,전북,7144,76,205,61,58,237,7781,7722,92,222,61,45,286,8428
2020-02-02,광주,충남,4975,45,522,127,70,146,5885,4148,34,519,101,39,101,4942
2020-02-02,광주,충북,640,10,32,25,15,22,744,624,7,42,38,7,19,737
2020-02-02,대구,강원,400,4,24,1,1,17,447,437,3,11,3,0,7,461
2020-02-02,대구,경기,3095,19,143,78,58,109,3502,1898,10,131,50,17,61,2167
2020-02-02,대구,경남,12351,113,601,82,49,549,13745,15256,160,679,242,342,676,17355
2020-02-02,대구,경북,62899,638,1486,296,318,2999,68636,59978,617,1272,257,275,2875,65274
2020-02-02,대구,광주,712,10,84,28,7,19,860,599,12,79,45,14,22,771
2020-02-02,대구,대구,36671,378,655,150,132,2088,40074,36671,378,655,150,132,2088,40074
2020-02-02,대구,대전,1132,5,33,5,9,47,1231,737,4,21,11,1,31,805
2020-02-02,대구,부산,765,10,48,23,30,43,919,4209,37,168,27,33,177,4651
2020-02-02,대구,서울,2719,21,181,45,22,85,3073,1766,11,135,18,13,45,1988
2020-02-02,대구,세종,340,1,10,0,1,14,366,206,0,2,0,1,7,216
2020-02-02,대구,울산,1677,14,104,10,36,87,1928,1420,6,97,7,40,72,1642
2020-02-02,대구,전남,658,8,49,9,17,13,754,796,4,48,18,21,30,917
2020-02-02,대구,전북,434,0,47,1,4,11,497,471,4,41,7,4,21,548
2020-02-02,대구,충남,1685,10,36,25,28,73,1857,1000,13,21,20,19,47,1120
2020-02-02,대구,충북,2188,21,146,50,49,97,2551,1537,11,86,47,22,77,1780
2020-02-02,대전,강원,227,0,36,0,0,6,269,276,1,33,0,3,10,323
2020-02-02,대전,경기,2638,32,158,19,8,134,2989,1986,17,163,23,6,107,2302
2020-02-02,대전,경남,1273,9,98,12,4,51,1447,1068,7,97,30,7,45,1254
2020-02-02,대전,경북,2155,7,68,9,12,112,2363,2091,11,70,25,22,102,2321
2020-02-02,대전,광주,503,4,10,1,2,11,531,467,3,5,1,6,12,494
2020-02-02,대전,대구,737,4,21,11,1,31,805,1132,5,33,5,9,47,1231
2020-02-02,대전,대전,8382,77,113,30,22,587,9211,8382,77,113,30,22,587,9211
2020-02-02,대전,부산,95,0,2,2,1,6,106,139,1,1,1,2,3,147
2020-02-02,대전,서울,2211,8,249,11,1,116,2596,1734,9,234,3,0,82,2062
2020-02-02,대전,세종,2072,32,30,1,8,150,2293,1832,29,28,8,6,125,2028
2020-02-02,대전,울산,136,0,12,1,9,2,160,108,2,14,0,7,3,134
2020-02-02,대전,전남,376,1,12,4,1,11,405,453,1,17,5,2,18,496
2020-02-02,대전,전북,3398,25,52,8,8,158,3649,3858,21,50,22,9,165,4125
2020-02-02,대전,충남,10785,67,253,36,27,696,11864,9902,98,234,42,28,586,10890
2020-02-02,대전,충북,7495,117,240,18,13,461,8344,6866,93,227,23,20,481,7710
2020-02-02,부산,강원,3,0,0,0,0,0,3,2,0,1,0,0,0,3
2020-02-02,부산,경기,425,5,9,24,21,22,506,236,3,6,36,18,7,306
2020-02-02,부산,경남,71331,638,1667,234,542,4621,79033,72836,609,1795,248,553,4573,80614
2020-02-02,부산,경북,7369,36,350,26,78,307,8166,7075,38,315,23,57,306,7814
2020-02-02,부산,광주,677,4,70,4,7,23,785,483,8,52,6,5,17,571
2020-02-02,부산,대구,4209,37,168,27,33,177,4651,765,10,48,23,30,43,919
2020-02-02,부산,대전,139,1,1,1,2,3,147,95,0,2,2,1,6,106
2020-02-02,부산,부산,43069,137,228,80,212,2443,46169,43069,137,228,80,212,2443,46169
2020-02-02,부산,서울,381,5,17,15,9,19,446,259,7,9,8,13,4,300
2020-02-02,부산,세종,40,0,0,0,0,2,42,25,0,0,0,0,1,26
2020-02-02,부산,울산,17580,67,165,80,420,1099,19411,16201,64,106,55,400,1055,17881
2020-02-02,부산,전남,2343,17,140,27,96,77,2700,2160,19,125,81,89,60,2534
2020-02-02,부산,전북,425,3,55,5,17,12,517,500,4,44,5,18,11,582
2020-02-02,부산,충남,257,2,6,8,25,7,305,157,1,7,6,17,5,193
2020-02-02,부산,충북,212,3,6,6,25,7,259,140,2,3,21,15,6,187
2020-02-02,서울,강원,849,7,327,0,2,39,1224,1298,7,412,4,1,48,1770
2020-02-02,서울,경기,103822,1818,4184,1044,405,6342,117615,99367,1808,4293,1205,409,5875,112957
2020-02-02,서울,경남,2345,17,514,26,16,78,2996,2212,19,488,139,67,68,2993
2020-02-02,서울,경북,2927,18,316,43,21,105,3430,4109,24,332,130,27,109,4731
2020-02-02,서울,광주,692,14,10,8,2,17,743,897,8,17,8,7,24,961
2020-02-02,서울,대구,1766,11,135,18,13,45,1988,2719,21,181,45,22,85,3073
2020-02-02,서울,대전,1734,9,234,3,0,82,2062,2211,8,249,11,1,116,2596
2020-02-02,서울,부산,259,7,9,8,13,4,300,381,5,17,15,9,19,446
2020-02-02,서울,서울,168,1,6,3,0,9,187,168,1,6,3,0,9,187
2020-02-02,서울,세종,25,0,0,0,0,2,27,24,0,0,0,0,0,24
2020-02-02,서울,울산,25,0,3,0,1,0,29,21,0,3,0,3,0,27
2020-02-02,서울,전남,867,4,14,4,8,37,934,1220,4,30,43,28,33,1358
2020-02-02,서울,전북,1211,9,39,5,2,30,1296,1877,7,42,14,6,52,1998
2020-02-02,서울,충남,28144,145,2083,214,188,1148,31922,32839,183,2185,561,316,1261,37345
2020-02-02,서울,충북,13522,104,900,215,130,599,15470,13762,103,921,193,107,600,15686
2020-02-02,세종,강원,6,0,1,0,0,0,7,10,0,1,0,0,0,11
2020-02-02,세종,경기,61,1,2,0,1,5,70,30,1,3,4,0,2,40
2020-02-02,세종,경남,253,3,16,1,0,10,283,253,4,7,0,0,9,273
2020-02-02,세종,경북,301,1,7,6,2,13,330,348,1,7,3,2,14,375
2020-02-02,세종,광주,159,1,1,1,3,5,170,189,1,2,0,1,7,200
2020-02-02,세종,대구,206,0,2,0,1,7,216,340,1,10,0,1,14,366
2020-02-02,세종,대전,1832,29,28,8,6,125,2028,2072,32,30,1,8,150,2293
2020-02-02,세종,부산,25,0,0,0,0,1,26,40,0,0,0,0,2,42
2020-02-02,세종,서울,24,0,0,0,0,0,24,25,0,0,0,0,2,27
2020-02-02,세종,세종,182,3,0,0,0,14,199,182,3,0,0,0,14,199
2020-02-02,세종,울산,6,0,0,1,0,0,7,7,0,0,0,1,1,9
2020-02-02,세종,전남,170,3,0,0,2,9,184,262,0,2,2,1,7,274
2020-02-02,세종,전북,687,0,12,5,14,29,747,826,3,9,1,10,39,888
2020-02-02,세종,충남,4497,50,80,19,20,190,4856,3787,34,87,12,33,148,4101
2020-02-02,세종,충북,274,3,2,0,2,13,294,279,6,1,0,2,13,301
2020-02-02,울산,강원,4,0,0,0,0,0,4,6,0,0,0,0,0,6
2020-02-02,울산,경기,29,1,1,7,15,1,54,24,0,0,2,9,1,36
2020-02-02,울산,경남,9684,106,319,40,50,554,10753,10222,127,287,46,37,600,11319
2020-02-02,울산,경북,5780,25,131,37,213,296,6482,6677,23,148,65,208,363,7484
2020-02-02,울산,광주,48,0,9,1,2,3,63,71,0,11,0,0,3,85
2020-02-02,울산,대구,1420,6,97,7,40,72,1642,1677,14,104,10,36,87,1928
2020-02-02,울산,대전,108,2,14,0,7,3,134,136,0,12,1,9,2,160
2020-02-02,울산,부산,16201,64,106,55,400,1055,17881,17580,67,165,80,420,1099,19411
2020-02-02,울산,서울,21,0,3,0,3,0,27,25,0,3,0,1,0,29
2020-02-02,울산,세종,7,0,0,0,1,1,9,6,0,0,1,0,0,7
2020-02-02,울산,울산,5267,38,130,24,40,394,5893,5267,38,130,24,40,394,5893
2020-02-02,울산,전남,223,2,8,3,4,12,252,237,4,12,5,5,6,269
2020-02-02,울산,전북,63,0,7,0,0,0,70,67,0,7,0,1,1,76
2020-02-02,울산,충남,120,0,5,6,32,1,164,100,0,5,7,15,1,128
2020-02-02,울산,충북,21,1,2,1,4,0,29,20,0,2,3,8,1,34
2020-02-02,전남,강원,71,0,2,2,11,4,90,78,0,2,1,4,3,88
2020-02-02,전남,경기,1154,5,73,49,48,28,1357,782,6,84,29,42,23,966
2020-02-02,전남,경남,6528,80,288,112,167,279,7454,6583,71,285,88,123,287,7437
2020-02-02,전남,경북,1309,11,46,26,112,33,1537,1253,15,53,33,65,39,1458
2020-02-02,전남,광주,29789,248,701,275,137,1082,32232,30299,270,807,166,129,1045,32716
2020-02-02,전남,대구,796,4,48,18,21,30,917,658,8,49,9,17,13,754
2020-02-02,전남,대전,453,1,17,5,2,18,496,376,1,12,4,1,11,405
2020-02-02,전남,부산,2160,19,125,81,89,60,2534,2343,17,140,27,96,77,2700
2020-02-02,전남,서울,1220,4,30,43,28,33,1358,867,4,14,4,8,37,934
2020-02-02,전남,세종,262,0,2,2,1,7,274,170,3,0,0,2,9,184
2020-02-02,전남,울산,237,4,12,5,5,6,269,223,2,8,3,4,12,252
2020-02-02,전남,전남,41215,372,1038,736,705,1435,45501,41215,372,1038,736,705,1435,45501
2020-02-02,전남,전북,5946,111,174,243,248,189,6911,5439,77,199,180,260,182,6337
2020-02-02,전남,충남,6145,49,392,423,407,188,7604,4579,26,371,124,147,136,5383
2020-02-02,전남,충북,579,3,19,25,41,20,687,430,1,34,20,42,12,539
2020-02-02,전북,강원,175,0,6,13,1,6,201,194,1,10,5,2,3,215
2020-02-02,전북,경기,2155,14,106,44,20,91,2430,1286,15,124,25,20,41,1511
2020-02-02,전북,경남,2040,22,94,30,16,84,2286,1728,16,89,21,8,57,1919
2020-02-02,전북,경북,1732,31,56,22,31,46,1918,1634,27,80,22,40,44,1847
2020-02-02,전북,광주,7722,92,222,61,45,286,8428,7144,76,205,61,58,237,7781
2020-02-02,전북,대구,471,4,41,7,4,21,548,434,0,47,1,4,11,497
2020-02-02,전북,대전,3858,21,50,22,9,165,4125,3398,25,52,8,8,158,3649
2020-02-02,전북,부산,500,4,44,5,18,11,582,425,3,55,5,17,12,517
2020-02-02,전북,서울,1877,7,42,14,6,52,1998,1211,9,39,5,2,30,1296
2020-02-02,전북,세종,826,3,9,1,10,39,888,687,0,12,5,14,29,747
2020-02-02,전북,울산,67,0,7,0,1,1,76,63,0,7,0,0,0,70
2020-02-02,전북,전남,5439,77,199,180,260,182,6337,5946,111,174,243,248,189,6911
2020-02-02,전북,전북,12332,175,410,124,104,427,13572,12332,175,410,124,104,427,13572
2020-02-02,전북,충남,16109,138,987,235,290,559,18318,13264,119,956,156,211,474,15180
2020-02-02,전북,충북,2330,34,74,119,48,85,2690,1754,37,96,68,42,56,2053
2020-02-02,충남,강원,511,2,17,7,12,20,569,654,1,15,5,4,29,708
2020-02-02,충남,경기,33925,316,1303,382,525,1638,38089,31503,303,1277,467,567,1640,35757
2020-02-02,충남,경남,1507,13,56,51,49,58,1734,1578,11,52,41,31,69,1782
2020-02-02,충남,경북,3157,21,73,60,96,126,3533,3611,22,71,51,85,153,3993
2020-02-02,충남,광주,4148,34,519,101,39,101,4942,4975,45,522,127,70,146,5885
2020-02-02,충남,대구,1000,13,21,20,19,47,1120,1685,10,36,25,28,73,1857
2020-02-02,충남,대전,9902,98,234,42,28,586,10890,10785,67,253,36,27,696,11864
2020-02-02,충남,부산,157,1,7,6,17,5,193,257,2,6,8,25,7,305
2020-02-02,충남,서울,32839,183,2185,561,316,1261,37345,28144,145,2083,214,188,1148,31922
2020-02-02,충남,세종,3787,34,87,12,33,148,4101,4497,50,80,19,20,190,4856
2020-02-02,충남,울산,100,0,5,7,15,1,128,120,0,5,6,32,1,164
2020-02-02,충남,전남,4579,26,371,124,147,136,5383,6145,49,392,423,407,188,7604
2020-02-02,충남,전북,13264,119,956,156,211,474,15180,16109,138,987,235,290,559,18318
2020-02-02,충남,충남,86114,886,4589,1388,1680,3607,98264,86114,886,4589,1388,1680,3607,98264
2020-02-02,충남,충북,9015,153,314,188,202,483,10355,8518,143,301,182,241,480,9865
2020-02-02,충북,강원,4542,54,150,40,49,240,5075,5246,68,137,46,51,239,5787
2020-02-02,충북,경기,25810,457,845,391,447,1264,29214,22684,427,831,473,486,1178,26079
2020-02-02,충북,경남,1529,20,117,89,61,60,1876,1514,16,61,57,51,60,1759
2020-02-02,충북,경북,5760,60,205,122,90,196,6433,6432,63,188,135,119,248,7185
2020-02-02,충북,광주,624,7,42,38,7,19,737,640,10,32,25,15,22,744
2020-02-02,충북,대구,1537,11,86,47,22,77,1780,2188,21,146,50,49,97,2551
2020-02-02,충북,대전,6866,93,227,23,20,481,7710,7495,117,240,18,13,461,8344
2020-02-02,충북,부산,140,2,3,21,15,6,187,212,3,6,6,25,7,259
2020-02-02,충북,서울,13762,103,921,193,107,600,15686,13522,104,900,215,130,599,15470
2020-02-02,충북,세종,279,6,1,0,2,13,301,274,3,2,0,2,13,294
2020-02-02,충북,울산,20,0,2,3,8,1,34,21,1,2,1,4,0,29
2020-02-02,충북,전남,430,1,34,20,42,12,539,579,3,19,25,41,20,687
2020-02-02,충북,전북,1754,37,96,68,42,56,2053,2330,34,74,119,48,85,2690
2020-02-02,충북,충남,8518,143,301,182,241,480,9865,9015,153,314,188,202,483,10355
2020-02-02,충북,충북,26208,424,639,393,429,1315,29408,26208,424,639,393,429,1315,29408
2020-02-03,강원,강원,61688,2039,2924,1140,2079,4371,74241,61688,2039,2924,1140,2079,4371,74241
2020-02-03,강원,경기,18396,542,1190,559,700,920,22307,18218,573,1209,578,795,940,22313
2020-02-03,강원,경남,161,1,16,20,21,10,229,114,1,9,22,22,1,169
2020-02-03,강원,경북,426,19,33,14,34,17,543,370,16,34,30,23,19,492
2020-02-03,강원,광주,95,2,23,10,9,2,141,77,0,13,6,6,4,106
2020-02-03,강원,대구,247,3,10,16,11,11,298,293,6,24,19,13,17,372
2020-02-03,강원,대전,152,4,29,3,2,9,199,205,3,28,4,2,5,247
2020-02-03,강원,부산,2,0,0,1,0,1,4,1,0,1,0,0,0,2
2020-02-03,강원,서울,611,11,268,13,15,15,933,633,14,232,16,10,22,927
2020-02-03,강원,세종,3,0,0,0,0,0,3,9,0,0,2,1,0,12
2020-02-03,강원,울산,1,0,0,0,0,0,1,3,0,0,0,0,0,3
2020-02-03,강원,전남,73,0,2,8,9,1,93,48,1,2,10,18,1,80
2020-02-03,강원,전북,144,4,15,6,19,3,191,118,5,19,22,21,2,187
2020-02-03,강원,충남,349,6,21,14,38,13,441,424,10,27,31,60,20,572
2020-02-03,강원,충북,4719,199,291,228,347,284,6068,4726,196,280,183,287,276,5948
2020-02-03,경기,강원,18218,573,1209,578,795,940,22313,18396,542,1190,559,700,920,22307
2020-02-03,경기,경기,405740,22801,24258,18520,23082,31018,525419,405740,22801,24258,18520,23082,31018,525419
2020-02-03,경기,경남,2600,68,302,412,382,90,3854,1631,60,209,404,373,70,2747
2020-02-03,경기,경북,4138,161,537,589,479,150,6054,3628,167,455,840,533,128,5751
2020-02-03,경기,광주,767,31,161,230,118,26,1333,684,18,129,223,90,17,1161
2020-02-03,경기,대구,1847,67,225,253,176,64,2632,2690,78,246,329,446,97,3886
2020-02-03,경기,대전,1924,87,203,66,39,101,2420,2274,96,192,79,53,113,2807
2020-02-03,경기,부산,172,12,23,70,97,9,383,241,15,35,98,194,7,590
2020-02-03,경기,서울,137932,7194,9086,4564,3298,9718,171792,146669,6840,9202,4816,2961,10175,180663
2020-02-03,경기,세종,38,1,2,4,0,2,47,46,1,2,2,1,4,56
2020-02-03,경기,울산,36,0,0,3,13,1,53,37,1,5,17,40,2,102
2020-02-03,경기,전남,752,16,106,147,132,24,1177,599,20,80,115,118,17,949
2020-02-03,경기,전북,1255,45,159,110,160,37,1766,1182,43,152,143,178,51,1749
2020-02-03,경기,충남,36913,1548,2872,2350,4226,1960,49869,32901,1439,2673,2209,3840,1786,44848
2020-02-03,경기,충북,27563,2215,2914,2831,3132,1335,39990,25170,2150,2818,2738,3430,1276,37582
2020-02-03,경남,강원,114,1,9,22,22,1,169,161,1,16,20,21,10,229
2020-02-03,경남,경기,1631,60,209,404,373,70,2747,2600,68,302,412,382,90,3854
2020-02-03,경남,경남,188862,10116,10117,6535,12285,14617,242532,188862,10116,10117,6535,12285,14617,242532
2020-02-03,경남,경북,10010,581,1024,846,1849,459,14769,12023,871,1253,1146,2364,554,18211
2020-02-03,경남,광주,995,57,145,144,129,34,1504,1081,42,134,156,99,33,1545
2020-02-03,경남,대구,12760,756,933,901,1635,539,17524,10668,515,729,384,476,490,13262
2020-02-03,경남,대전,598,15,91,59,35,31,829,950,32,100,60,50,42,1234
2020-02-03,경남,부산,83898,2728,2960,1742,4138,6036,101502,86232,2824,3123,1920,4590,6169,104858
2020-02-03,경남,서울,1577,31,449,216,103,56,2432,2471,39,445,85,65,70,3175
2020-02-03,경남,세종,157,1,13,9,7,3,190,272,3,20,9,15,5,324
2020-02-03,경남,울산,9795,634,723,470,596,650,12868,8994,581,732,414,619,573,11913
2020-02-03,경남,전남,5922,286,514,483,1269,277,8751,5442,287,499,407,1329,251,8215
2020-02-03,경남,전북,1191,39,100,83,160,33,1606,1213,40,107,89,156,43,1648
2020-02-03,경남,충남,1108,37,108,245,218,44,1760,1368,45,144,237,361,50,2205
2020-02-03,경남,충북,1066,35,134,238,279,46,1798,1194,60,183,303,507,42,2289
2020-02-03,경북,강원,370,16,34,30,23,19,492,426,19,33,14,34,17,543
2020-02-03,경북,경기,3628,167,455,840,533,128,5751,4138,161,537,589,479,150,6054
2020-02-03,경북,경남,12023,871,1253,1146,2364,554,18211,10010,581,1024,846,1849,459,14769
2020-02-03,경북,경북,71169,3785,4200,2699,4565,3907,90325,71169,3785,4200,2699,4565,3907,90325
2020-02-03,경북,광주,738,60,139,191,121,18,1267,760,39,96,199,89,25,1208
2020-02-03,경북,대구,69778,2839,2854,1414,2865,3971,83721,76329,3031,3271,1776,3413,4129,91949
2020-02-03,경북,대전,1584,48,115,81,72,78,1978,1868,49,111,107,54,80,2269
2020-02-03,경북,부산,3832,107,306,173,609,196,5223,4749,126,313,204,668,219,6279
2020-02-03,경북,서울,2271,88,341,330,126,84,3240,2782,83,349,160,69,111,3554
2020-02-03,경북,세종,236,6,20,17,6,13,298,328,11,22,19,13,14,407
2020-02-03,경북,울산,4893,168,362,392,1047,288,7150,4858,166,318,353,1215,265,7175
2020-02-03,경북,전남,1003,49,80,115,424,30,1701,892,43,66,98,510,26,1635
2020-02-03,경북,전북,1650,82,203,175,210,56,2376,1435,77,189,135,221,58,2115
2020-02-03,경북,충남,3113,137,394,528,559,108,4839,3128,125,368,447,646,117,4831
2020-02-03,경북,충북,4937,215,494,696,858,182,7382,4887,235,581,522,926,183,7334
2020-02-03,광주,강원,77,0,13,6,6,4,106,95,2,23,10,9,2,141
2020-02-03,광주,경기,684,18,129,223,90,17,1161,767,31,161,230,118,26,1333
2020-02-03,광주,경남,1081,42,134,156,99,33,1545,995,57,145,144,129,34,1504
2020-02-03,광주,경북,760,39,96,199,89,25,1208,738,60,139,191,121,18,1267
2020-02-03,광주,광주,12231,423,634,346,328,551,14513,12231,423,634,346,328,551,14513
2020-02-03,광주,대구,530,25,73,78,25,9,740,623,21,85,67,33,14,843
2020-02-03,광주,대전,419,14,13,15,15,7,483,520,13,16,16,13,15,593
2020-02-03,광주,부산,373,10,41,25,77,10,536,417,19,53,73,102,8,672
2020-02-03,광주,서울,545,14,20,53,18,11,661,671,23,17,33,21,22,787
2020-02-03,광주,세종,168,2,8,3,1,3,185,152,4,4,4,1,2,167
2020-02-03,광주,울산,47,3,7,3,5,0,65,34,1,7,6,7,1,56
2020-02-03,광주,전남,33041,926,1247,808,1977,1311,39310,29747,893,1040,657,1773,1188,35298
2020-02-03,광주,전북,7879,417,543,346,352,290,9827,7504,419,469,317,362,265,9336
2020-02-03,광주,충남,3967,109,571,410,310,123,5490,3746,120,564,464,340,110,5344
2020-02-03,광주,충북,567,23,57,115,67,14,843,553,26,81,148,77,14,899
2020-02-03,대구,강원,293,6,24,19,13,17,372,247,3,10,16,11,11,298
2020-02-03,대구,경기,2690,78,246,329,446,97,3886,1847,67,225,253,176,64,2632
2020-02-03,대구,경남,10668,515,729,384,476,490,13262,12760,756,933,901,1635,539,17524
2020-02-03,대구,경북,76329,3031,3271,1776,3413,4129,91949,69778,2839,2854,1414,2865,3971,83721
2020-02-03,대구,광주,623,21,85,67,33,14,843,530,25,73,78,25,9,740
2020-02-03,대구,대구,60394,2193,1807,830,1377,4038,70639,60394,2193,1807,830,1377,4038,70639
2020-02-03,대구,대전,905,43,54,65,23,30,1120,627,17,35,26,30,22,757
2020-02-03,대구,부산,595,58,86,55,155,25,974,2864,123,192,89,232,127,3627
2020-02-03,대구,서울,2300,57,168,160,85,71,2841,1655,43,135,65,28,41,1967
2020-02-03,대구,세종,281,1,14,5,8,5,314,184,2,1,5,2,3,197
2020-02-03,대구,울산,1355,50,133,67,169,54,1828,1172,60,139,78,185,45,1679
2020-02-03,대구,전남,544,14,42,29,54,20,703,445,17,34,34,80,14,624
2020-02-03,대구,전북,398,6,38,16,19,14,491,295,7,39,23,19,7,390
2020-02-03,대구,충남,1628,82,165,202,253,52,2382,1047,58,128,129,173,28,1563
2020-02-03,대구,충북,1961,77,181,251,401,53,2924,1193,92,130,142,117,41,1715
2020-02-03,대전,강원,205,3,28,4,2,5,247,152,4,29,3,2,9,199
2020-02-03,대전,경기,2274,96,192,79,53,113,2807,1924,87,203,66,39,101,2420
2020-02-03,대전,경남,950,32,100,60,50,42,1234,598,15,91,59,35,31,829
2020-02-03,대전,경북,1868,49,111,107,54,80,2269,1584,48,115,81,72,78,1978
2020-02-03,대전,광주,520,13,16,16,13,15,593,419,14,13,15,15,7,483
2020-02-03,대전,대구,627,17,35,26,30,22,757,905,43,54,65,23,30,1120
2020-02-03,대전,대전,13410,431,419,207,228,1079,15774,13410,431,419,207,228,1079,15774
2020-02-03,대전,부산,63,1,9,7,17,2,99,62,3,4,7,10,1,87
2020-02-03,대전,서울,1731,34,202,26,13,75,2081,1678,36,195,34,7,72,2022
2020-02-03,대전,세종,3409,94,98,40,33,308,3982,3489,98,92,57,48,277,4061
2020-02-03,대전,울산,109,0,9,13,20,4,155,75,2,8,7,18,0,110
2020-02-03,대전,전남,317,3,6,20,19,7,372,256,5,7,20,14,9,311
2020-02-03,대전,전북,3137,76,85,48,36,156,3538,2771,90,82,65,40,128,3176
2020-02-03,대전,충남,16395,454,522,235,215,1223,19044,13889,441,488,220,204,1059,16301
2020-02-03,대전,충북,10850,436,457,177,165,836,12921,9334,388,404,167,152,706,11151
2020-02-03,부산,강원,1,0,1,0,0,0,2,2,0,0,1,0,1,4
2020-02-03,부산,경기,241,15,35,98,194,7,590,172,12,23,70,97,9,383
2020-02-03,부산,경남,86232,2824,3123,1920,4590,6169,104858,83898,2728,2960,1742,4138,6036,101502
2020-02-03,부산,경북,4749,126,313,204,668,219,6279,3832,107,306,173,609,196,5223
2020-02-03,부산,광주,417,19,53,73,102,8,672,373,10,41,25,77,10,536
2020-02-03,부산,대구,2864,123,192,89,232,127,3627,595,58,86,55,155,25,974
2020-02-03,부산,대전,62,3,4,7,10,1,87,63,1,9,7,17,2,99
2020-02-03,부산,부산,40483,723,678,544,1920,2863,47211,40483,723,678,544,1920,2863,47211
2020-02-03,부산,서울,177,11,14,48,52,8,310,172,7,7,20,26,8,240
2020-02-03,부산,세종,8,0,3,0,1,0,12,16,1,1,0,0,0,18
2020-02-03,부산,울산,16576,414,496,661,2571,1208,21926,15192,432,426,469,2423,1118,20060
2020-02-03,부산,전남,2042,77,150,194,571,77,3111,1614,75,132,136,572,45,2574
2020-02-03,부산,전북,314,5,34,35,77,12,477,255,9,32,30,46,9,381
2020-02-03,부산,충남,162,7,17,53,112,7,358,131,7,22,36,132,6,334
2020-02-03,부산,충북,140,8,22,64,198,5,437,89,8,17,73,157,2,346
2020-02-03,서울,강원,633,14,232,16,10,22,927,611,11,268,13,15,15,933
2020-02-03,서울,경기,146669,6840,9202,4816,2961,10175,180663,137932,7194,9086,4564,3298,9718,171792
2020-02-03,서울,경남,2471,39,445,85,65,70,3175,1577,31,449,216,103,56,2432
2020-02-03,서울,경북,2782,83,349,160,69,111,3554,2271,88,341,330,126,84,3240
2020-02-03,서울,광주,671,23,17,33,21,22,787,545,14,20,53,18,11,661
2020-02-03,서울,대구,1655,43,135,65,28,41,1967,2300,57,168,160,85,71,2841
2020-02-03,서울,대전,1678,36,195,34,7,72,2022,1731,34,202,26,13,75,2081
2020-02-03,서울,부산,172,7,7,20,26,8,240,177,11,14,48,52,8,310
2020-02-03,서울,서울,172,6,9,2,2,13,204,172,6,9,2,2,13,204
2020-02-03,서울,세종,30,0,2,1,0,2,35,22,0,2,0,0,1,25
2020-02-03,서울,울산,23,0,0,1,1,0,25,22,0,8,2,5,1,38
2020-02-03,서울,전남,826,12,24,24,18,16,920,644,8,22,60,37,20,791
2020-02-03,서울,전북,1194,20,49,15,16,32,1326,1051,20,40,29,24,28,1192
2020-02-03,서울,충남,26025,474,2325,724,723,1039,31310,22964,628,2313,1152,1124,893,29074
2020-02-03,서울,충북,14309,523,1159,737,562,595,17885,11533,600,1150,743,699,501,15226
2020-02-03,세종,강원,9,0,0,2,1,0,12,3,0,0,0,0,0,3
2020-02-03,세종,경기,46,1,2,2,1,4,56,38,1,2,4,0,2,47
2020-02-03,세종,경남,272,3,20,9,15,5,324,157,1,13,9,7,3,190
2020-02-03,세종,경북,328,11,22,19,13,14,407,236,6,20,17,6,13,298
2020-02-03,세종,광주,152,4,4,4,1,2,167,168,2,8,3,1,3,185
2020-02-03,세종,대구,184,2,1,5,2,3,197,281,1,14,5,8,5,314
2020-02-03,세종,대전,3489,98,92,57,48,277,4061,3409,94,98,40,33,308,3982
2020-02-03,세종,부산,16,1,1,0,0,0,18,8,0,3,0,1,0,12
2020-02-03,세종,서울,22,0,2,0,0,1,25,30,0,2,1,0,2,35
2020-02-03,세종,세종,247,21,1,5,0,25,299,247,21,1,5,0,25,299
2020-02-03,세종,울산,9,0,0,0,1,0,10,8,0,0,0,2,0,10
2020-02-03,세종,전남,175,3,4,7,20,6,215,132,2,0,7,17,5,163
2020-02-03,세종,전북,726,21,23,12,15,31,828,570,19,19,12,30,22,672
2020-02-03,세종,충남,6044,159,169,118,160,338,6988,3831,112,148,101,124,199,4515
2020-02-03,세종,충북,345,15,21,19,13,26,439,287,20,19,11,14,21,372
2020-02-03,울산,강원,3,0,0,0,0,0,3,1,0,0,0,0,0,1
2020-02-03,울산,경기,37,1,5,17,40,2,102,36,0,0,3,13,1,53
2020-02-03,울산,경남,8994,581,732,414,619,573,11913,9795,634,723,470,596,650,12868
2020-02-03,울산,경북,4858,166,318,353,1215,265,7175,4893,168,362,392,1047,288,7150
2020-02-03,울산,광주,34,1,7,6,7,1,56,47,3,7,3,5,0,65
2020-02-03,울산,대구,1172,60,139,78,185,45,1679,1355,50,133,67,169,54,1828
2020-02-03,울산,대전,75,2,8,7,18,0,110,109,0,9,13,20,4,155
2020-02-03,울산,부산,15192,432,426,469,2423,1118,20060,16576,414,496,661,2571,1208,21926
2020-02-03,울산,서울,22,0,8,2,5,1,38,23,0,0,1,1,0,25
2020-02-03,울산,세종,8,0,0,0,2,0,10,9,0,0,0,1,0,10
2020-02-03,울산,울산,7846,323,534,324,613,753,10393,7846,323,534,324,613,753,10393
2020-02-03,울산,전남,208,8,22,18,24,9,289,177,10,25,21,26,6,265
2020-02-03,울산,전북,48,0,7,2,18,0,75,37,0,7,4,2,2,52
2020-02-03,울산,충남,145,4,13,45,123,9,339,131,3,16,29,96,4,279
2020-02-03,울산,충북,29,1,3,14,50,0,97,9,1,2,13,26,3,54
2020-02-03,전남,강원,48,1,2,10,18,1,80,73,0,2,8,9,1,93
2020-02-03,전남,경기,599,20,80,115,118,17,949,752,16,106,147,132,24,1177
2020-02-03,전남,경남,5442,287,499,407,1329,251,8215,5922,286,514,483,1269,277,8751
2020-02-03,전남,경북,892,43,66,98,510,26,1635,1003,49,80,115,424,30,1701
2020-02-03,전남,광주,29747,893,1040,657,1773,1188,35298,33041,926,1247,808,1977,1311,39310
2020-02-03,전남,대구,445,17,34,34,80,14,624,544,14,42,29,54,20,703
2020-02-03,전남,대전,256,5,7,20,14,9,311,317,3,6,20,19,7,372
2020-02-03,전남,부산,1614,75,132,136,572,45,2574,2042,77,150,194,571,77,3111
2020-02-03,전남,서울,644,8,22,60,37,20,791,826,12,24,24,18,16,920
2020-02-03,전남,세종,132,2,0,7,17,5,163,175,3,4,7,20,6,215
2020-02-03,전남,울산,177,10,25,21,26,6,265,208,8,22,18,24,9,289
2020-02-03,전남,전남,41954,1251,1577,1500,4324,1721,52327,41954,1251,1577,1500,4324,1721,52327
2020-02-03,전남,전북,4265,268,473,541,1202,153,6902,4560,218,445,562,1237,156,7178
2020-02-03,전남,충남,3660,92,414,646,1180,116,6108,4222,75,432,429,872,115,6145
2020-02-03,전남,충북,392,14,32,97,252,8,795,400,15,53,104,253,9,834
2020-02-03,전북,강원,118,5,19,22,21,2,187,144,4,15,6,19,3,191
2020-02-03,전북,경기,1182,43,152,143,178,51,1749,1255,45,159,110,160,37,1766
2020-02-03,전북,경남,1213,40,107,89,156,43,1648,1191,39,100,83,160,33,1606
2020-02-03,전북,경북,1435,77,189,135,221,58,2115,1650,82,203,175,210,56,2376
2020-02-03,전북,광주,7504,419,469,317,362,265,9336,7879,417,543,346,352,290,9827
2020-02-03,전북,대구,295,7,39,23,19,7,390,398,6,38,16,19,14,491
2020-02-03,전북,대전,2771,90,82,65,40,128,3176,3137,76,85,48,36,156,3538
2020-02-03,전북,부산,255,9,32,30,46,9,381,314,5,34,35,77,12,477
2020-02-03,전북,서울,1051,20,40,29,24,28,1192,1194,20,49,15,16,32,1326
2020-02-03,전북,세종,570,19,19,12,30,22,672,726,21,23,12,15,31,828
2020-02-03,전북,울산,37,0,7,4,2,2,52,48,0,7,2,18,0,75
2020-02-03,전북,전남,4560,218,445,562,1237,156,7178,4265,268,473,541,1202,153,6902
2020-02-03,전북,전북,15208,581,861,725,784,570,18729,15208,581,861,725,784,570,18729
2020-02-03,전북,충남,12260,454,1506,1033,1306,447,17006,12421,461,1501,813,1235,471,16902
2020-02-03,전북,충북,1722,132,221,334,252,69,2730,1735,117,239,284,262,57,2694
2020-02-03,충남,강원,424,10,27,31,60,20,572,349,6,21,14,38,13,441
2020-02-03,충남,경기,32901,1439,2673,2209,3840,1786,44848,36913,1548,2872,2350,4226,1960,49869
2020-02-03,충남,경남,1368,45,144,237,361,50,2205,1108,37,108,245,218,44,1760
2020-02-03,충남,경북,3128,125,368,447,646,117,4831,3113,137,394,528,559,108,4839
2020-02-03,충남,광주,3746,120,564,464,340,110,5344,3967,109,571,410,310,123,5490
2020-02-03,충남,대구,1047,58,128,129,173,28,1563,1628,82,165,202,253,52,2382
2020-02-03,충남,대전,13889,441,488,220,204,1059,16301,16395,454,522,235,215,1223,19044
2020-02-03,충남,부산,131,7,22,36,132,6,334,162,7,17,53,112,7,358
2020-02-03,충남,서울,22964,628,2313,1152,1124,893,29074,26025,474,2325,724,723,1039,31310
2020-02-03,충남,세종,3831,112,148,101,124,199,4515,6044,159,169,118,160,338,6988
2020-02-03,충남,울산,131,3,16,29,96,4,279,145,4,13,45,123,9,339
2020-02-03,충남,전남,4222,75,432,429,872,115,6145,3660,92,414,646,1180,116,6108
2020-02-03,충남,전북,12421,461,1501,813,1235,471,16902,12260,454,1506,1033,1306,447,17006
2020-02-03,충남,충남,91394,3472,7982,6791,9742,4519,123900,91394,3472,7982,6791,9742,4519,123900
2020-02-03,충남,충북,13230,687,867,912,1410,723,17829,12098,629,832,782,1258,701,16300
2020-02-03,충북,강원,4726,196,280,183,287,276,5948,4719,199,291,228,347,284,6068
2020-02-03,충북,경기,25170,2150,2818,2738,3430,1276,37582,27563,2215,2914,2831,3132,1335,39990
2020-02-03,충북,경남,1194,60,183,303,507,42,2289,1066,35,134,238,279,46,1798
2020-02-03,충북,경북,4887,235,581,522,926,183,7334,4937,215,494,696,858,182,7382
2020-02-03,충북,광주,553,26,81,148,77,14,899,567,23,57,115,67,14,843
2020-02-03,충북,대구,1193,92,130,142,117,41,1715,1961,77,181,251,401,53,2924
2020-02-03,충북,대전,9334,388,404,167,152,706,11151,10850,436,457,177,165,836,12921
2020-02-03,충북,부산,89,8,17,73,157,2,346,140,8,22,64,198,5,437
2020-02-03,충북,서울,11533,600,1150,743,699,501,15226,14309,523,1159,737,562,595,17885
2020-02-03,충북,세종,287,20,19,11,14,21,372,345,15,21,19,13,26,439
2020-02-03,충북,울산,9,1,2,13,26,3,54,29,1,3,14,50,0,97
2020-02-03,충북,전남,400,15,53,104,253,9,834,392,14,32,97,252,8,795
2020-02-03,충북,전북,1735,117,239,284,262,57,2694,1722,132,221,334,252,69,2730
2020-02-03,충북,충남,12098,629,832,782,1258,701,16300,13230,687,867,912,1410,723,17829
2020-02-03,충북,충북,34207,1842,2299,2016,2637,2104,45105,34207,1842,2299,2016,2637,2104,45105
2020-02-04,강원,강원,57889,2214,3102,1532,2500,4015,71252,57889,2214,3102,1532,2500,4015,71252
2020-02-04,강원,경기,15792,585,1325,641,695,801,19839,15779,632,1271,677,841,843,20043
2020-02-04,강원,경남,145,2,7,18,22,3,197,76,0,7,30,16,3,132
2020-02-04,강원,경북,380,23,30,29,27,9,498,353,17,34,36,30,10,480
2020-02-04,강원,광주,78,0,22,6,9,2,117,66,4,15,15,9,4,113
2020-02-04,강원,대구,189,3,10,15,9,5,231,209,9,20,27,10,9,284
2020-02-04,강원,대전,140,4,30,3,1,5,183,141,3,29,5,1,5,184
2020-02-04,강원,부산,2,1,0,1,0,0,4,0,0,0,0,3,0,3
2020-02-04,강원,서울,549,12,251,10,25,16,863,615,20,233,8,9,16,901
2020-02-04,강원,세종,4,0,0,0,0,0,4,4,0,0,0,0,0,4
2020-02-04,강원,울산,0,0,0,0,0,0,0,2,0,0,1,0,0,3
2020-02-04,강원,전남,41,1,3,4,12,1,62,35,2,5,7,24,0,73
2020-02-04,강원,전북,127,1,14,10,19,4,175,126,0,15,29,21,4,195
2020-02-04,강원,충남,270,9,20,17,36,6,358,332,11,25,47,84,9,508
2020-02-04,강원,충북,4318,229,296,252,341,269,5705,4359,198,258,242,348,242,5647
2020-02-04,경기,강원,15779,632,1271,677,841,843,20043,15792,585,1325,641,695,801,19839
2020-02-04,경기,경기,400528,23200,25366,20521,23944,30440,523999,400528,23200,25366,20521,23944,30440,523999
2020-02-04,경기,경남,2299,118,359,824,621,68,4289,1459,77,285,601,440,34,2896
2020-02-04,경기,경북,3821,220,520,798,651,102,6112,3517,221,500,993,659,105,5995
2020-02-04,경기,광주,738,37,182,359,178,19,1513,632,19,143,275,118,16,1203
2020-02-04,경기,대구,1837,124,255,444,271,40,2971,2408,123,270,507,522,63,3893
2020-02-04,경기,대전,1784,109,208,124,60,70,2355,1796,118,200,115,45,85,2359
2020-02-04,경기,부산,185,26,41,245,160,4,661,229,21,45,197,323,8,823
2020-02-04,경기,서울,137946,7487,9207,5172,3685,9510,173007,139419,7154,9464,4950,3254,9489,173730
2020-02-04,경기,세종,38,2,3,4,2,1,50,37,5,3,3,4,1,53
2020-02-04,경기,울산,22,2,0,10,12,1,47,38,5,9,51,104,1,208
2020-02-04,경기,전남,696,28,122,179,166,15,1206,586,20,96,130,169,15,1016
2020-02-04,경기,전북,1115,48,168,140,192,36,1699,1109,48,166,199,207,32,1761
2020-02-04,경기,충남,33214,1586,2941,2664,4818,1769,46992,32309,1501,2731,2465,4349,1712,45067
2020-02-04,경기,충북,24930,2203,3114,3218,3227,1236,37928,23941,2173,2941,2914,3403,1149,36521
2020-02-04,경남,강원,76,0,7,30,16,3,132,145,2,7,18,22,3,197
2020-02-04,경남,경기,1459,77,285,601,440,34,2896,2299,118,359,824,621,68,4289
2020-02-04,경남,경남,187763,10482,10349,7175,13381,14815,243965,187763,10482,10349,7175,13381,14815,243965
2020-02-04,경남,경북,9090,637,996,936,1933,425,14017,11412,894,1304,1319,2689,508,18126
2020-02-04,경남,광주,1009,63,156,176,143,26,1573,987,58,155,160,108,22,1490
2020-02-04,경남,대구,12017,758,1056,1074,1791,509,17205,9841,546,766,478,479,461,12571
2020-02-04,경남,대전,601,22,99,78,54,21,875,837,25,112,132,74,35,1215
2020-02-04,경남,부산,85044,2718,2990,1698,4435,6102,102987,84245,2838,3126,1695,4821,6027,102752
2020-02-04,경남,서울,1342,37,448,297,146,47,2317,2068,62,451,221,123,73,2998
2020-02-04,경남,세종,168,2,7,9,6,9,201,246,7,21,18,10,10,312
2020-02-04,경남,울산,9383,635,737,497,644,600,12496,8786,587,784,480,629,586,11852
2020-02-04,경남,전남,5379,304,505,512,1582,240,8522,5429,306,488,444,1554,224,8445
2020-02-04,경남,전북,1112,40,123,110,156,36,1577,1099,51,120,106,183,24,1583
2020-02-04,경남,충남,1033,49,139,279,297,24,1821,1359,58,182,363,569,37,2568
2020-02-04,경남,충북,888,72,158,298,304,42,1762,1162,84,225,490,670,44,2675
2020-02-04,경북,강원,353,17,34,36,30,10,480,380,23,30,29,27,9,498
2020-02-04,경북,경기,3517,221,500,993,659,105,5995,3821,220,520,798,651,102,6112
2020-02-04,경북,경남,11412,894,1304,1319,2689,508,18126,9090,637,996,936,1933,425,14017
2020-02-04,경북,경북,70385,3978,4469,2964,4853,3961,90610,70385,3978,4469,2964,4853,3961,90610
2020-02-04,경북,광주,742,71,151,207,162,22,1355,693,62,112,199,95,14,1175
2020-02-04,경북,대구,70326,2968,3028,1591,2705,3989,84607,72998,3170,3471,2011,3341,3982,88973
2020-02-04,경북,대전,1678,72,115,117,93,75,2150,1637,74,125,148,65,73,2122
2020-02-04,경북,부산,3727,128,345,218,668,173,5259,3856,128,362,221,766,208,5541
2020-02-04,경북,서울,2232,105,328,444,163,61,3333,2542,88,331,263,111,63,3398
2020-02-04,경북,세종,230,6,21,16,13,10,296,263,7,21,18,12,6,327
2020-02-04,경북,울산,4814,174,383,453,1016,258,7098,4683,169,376,375,1188,262,7053
2020-02-04,경북,전남,873,70,68,113,454,28,1606,919,38,77,123,573,28,1758
2020-02-04,경북,전북,1600,86,177,170,243,44,2320,1421,98,168,165,259,38,2149
2020-02-04,경북,충남,2750,147,395,604,637,73,4606,2913,156,401,519,815,105,4909
2020-02-04,경북,충북,4466,248,590,715,864,162,7045,4402,215,604,687,990,171,7069
2020-02-04,광주,강원,66,4,15,15,9,4,113,78,0,22,6,9,2,117
2020-02-04,광주,경기,632,19,143,275,118,16,1203,738,37,182,359,178,19,1513
2020-02-04,광주,경남,987,58,155,160,108,22,1490,1009,63,156,176,143,26,1573
2020-02-04,광주,경북,693,62,112,199,95,14,1175,742,71,151,207,162,22,1355
2020-02-04,광주,광주,12395,509,625,371,389,557,14846,12395,509,625,371,389,557,14846
2020-02-04,광주,대구,595,26,97,92,33,12,855,587,37,105,88,33,14,864
2020-02-04,광주,대전,418,20,24,36,16,8,522,459,19,18,38,18,14,566
2020-02-04,광주,부산,404,10,50,43,68,13,588,424,18,43,83,111,8,687
2020-02-04,광주,서울,516,17,28,73,25,16,675,671,23,31,69,24,18,836
2020-02-04,광주,세종,119,2,7,3,2,5,138,143,3,9,6,1,7,169
2020-02-04,광주,울산,59,1,9,4,6,1,80,51,4,6,7,10,3,81
2020-02-04,광주,전남,31319,1006,1223,876,1938,1209,37571,30074,979,1093,778,1766,1176,35866
2020-02-04,광주,전북,7333,442,604,370,352,262,9363,7383,473,527,329,383,253,9348
2020-02-04,광주,충남,3434,112,577,496,331,82,5032,3554,157,585,707,464,91,5558
2020-02-04,광주,충북,494,22,66,97,75,16,770,539,31,97,202,115,17,1001
2020-02-04,대구,강원,209,9,20,27,10,9,284,189,3,10,15,9,5,231
2020-02-04,대구,경기,2408,123,270,507,522,63,3893,1837,124,255,444,271,40,2971
2020-02-04,대구,경남,9841,546,766,478,479,461,12571,12017,758,1056,1074,1791,509,17205
2020-02-04,대구,경북,72998,3170,3471,2011,3341,3982,88973,70326,2968,3028,1591,2705,3989,84607
2020-02-04,대구,광주,587,37,105,88,33,14,864,595,26,97,92,33,12,855
2020-02-04,대구,대구,58917,2248,1878,925,1492,4119,69579,58917,2248,1878,925,1492,4119,69579
2020-02-04,대구,대전,829,47,53,91,40,27,1087,613,41,38,56,19,24,791
2020-02-04,대구,부산,552,52,107,53,160,18,942,2575,138,221,110,255,108,3407
2020-02-04,대구,서울,1969,88,203,267,136,60,2723,1675,58,141,171,65,42,2152
2020-02-04,대구,세종,216,3,14,10,8,5,256,137,4,7,8,4,2,162
2020-02-04,대구,울산,1184,62,146,84,169,47,1692,1155,49,140,89,196,53,1682
2020-02-04,대구,전남,467,17,49,29,44,20,626,494,15,53,34,90,16,702
2020-02-04,대구,전북,326,14,42,15,31,12,440,327,24,52,14,21,7,445
2020-02-04,대구,충남,1293,71,137,241,262,32,2036,966,61,120,170,199,27,1543
2020-02-04,대구,충북,1465,120,229,293,407,57,2571,1175,90,162,263,154,48,1892
2020-02-04,대전,강원,141,3,29,5,1,5,184,140,4,30,3,1,5,183
2020-02-04,대전,경기,1796,118,200,115,45,85,2359,1784,109,208,124,60,70,2355
2020-02-04,대전,경남,837,25,112,132,74,35,1215,601,22,99,78,54,21,875
2020-02-04,대전,경북,1637,74,125,148,65,73,2122,1678,72,115,117,93,75,2150
2020-02-04,대전,광주,459,19,18,38,18,14,566,418,20,24,36,16,8,522
2020-02-04,대전,대구,613,41,38,56,19,24,791,829,47,53,91,40,27,1087
2020-02-04,대전,대전,14182,432,469,351,156,1047,16637,14182,432,469,351,156,1047,16637
2020-02-04,대전,부산,56,5,4,17,23,1,106,77,2,12,24,20,3,138
2020-02-04,대전,서울,1523,47,189,48,4,67,1878,1535,57,186,49,10,59,1896
2020-02-04,대전,세종,3408,95,90,34,51,291,3969,3352,103,80,40,93,303,3971
2020-02-04,대전,울산,72,4,10,16,26,1,129,79,4,12,10,25,0,130
2020-02-04,대전,전남,213,6,10,33,34,7,303,232,7,13,29,25,6,312
2020-02-04,대전,전북,2850,77,83,92,47,119,3268,2815,92,79,79,39,127,3231
2020-02-04,대전,충남,15505,455,551,250,200,1188,18149,14238,435,511,263,208,1107,16762
2020-02-04,대전,충북,10621,469,480,205,153,787,12715,9525,433,452,194,147,755,11506
2020-02-04,부산,강원,0,0,0,0,3,0,3,2,1,0,1,0,0,4
2020-02-04,부산,경기,229,21,45,197,323,8,823,185,26,41,245,160,4,661
2020-02-04,부산,경남,84245,2838,3126,1695,4821,6027,102752,85044,2718,2990,1698,4435,6102,102987
2020-02-04,부산,경북,3856,128,362,221,766,208,5541,3727,128,345,218,668,173,5259
2020-02-04,부산,광주,424,18,43,83,111,8,687,404,10,50,43,68,13,588
2020-02-04,부산,대구,2575,138,221,110,255,108,3407,552,52,107,53,160,18,942
2020-02-04,부산,대전,77,2,12,24,20,3,138,56,5,4,17,23,1,106
2020-02-04,부산,부산,40099,786,714,724,2151,2918,47392,40099,786,714,724,2151,2918,47392
2020-02-04,부산,서울,169,15,26,99,89,6,404,141,19,27,58,39,1,285
2020-02-04,부산,세종,12,0,0,4,6,0,22,16,1,0,5,0,0,22
2020-02-04,부산,울산,15303,399,515,641,2457,1107,20422,15353,401,442,416,2424,1136,20172
2020-02-04,부산,전남,1828,88,151,189,582,72,2910,1677,92,149,149,618,64,2749
2020-02-04,부산,전북,272,18,42,38,106,5,481,254,8,42,48,67,4,423
2020-02-04,부산,충남,108,14,28,63,171,6,390,122,11,25,83,195,2,438
2020-02-04,부산,충북,99,13,25,98,251,2,488,87,22,31,122,214,3,479
2020-02-04,서울,강원,615,20,233,8,9,16,901,549,12,251,10,25,16,863
2020-02-04,서울,경기,139419,7154,9464,4950,3254,9489,173730,137946,7487,9207,5172,3685,9510,173007
2020-02-04,서울,경남,2068,62,451,221,123,73,2998,1342,37,448,297,146,47,2317
2020-02-04,서울,경북,2542,88,331,263,111,63,3398,2232,105,328,444,163,61,3333
2020-02-04,서울,광주,671,23,31,69,24,18,836,516,17,28,73,25,16,675
2020-02-04,서울,대구,1675,58,141,171,65,42,2152,1969,88,203,267,136,60,2723
2020-02-04,서울,대전,1535,57,186,49,10,59,1896,1523,47,189,48,4,67,1878
2020-02-04,서울,부산,141,19,27,58,39,1,285,169,15,26,99,89,6,404
2020-02-04,서울,서울,205,10,14,3,3,12,247,205,10,14,3,3,12,247
2020-02-04,서울,세종,39,1,1,1,4,2,48,33,0,0,0,0,2,35
2020-02-04,서울,울산,29,0,1,1,1,0,32,26,2,10,17,18,1,74
2020-02-04,서울,전남,714,10,27,45,35,25,856,604,11,27,77,57,21,797
2020-02-04,서울,전북,1047,20,48,24,16,22,1177,998,25,41,42,30,25,1161
2020-02-04,서울,충남,22166,553,2271,880,845,876,27591,21694,604,2268,1402,1295,817,28080
2020-02-04,서울,충북,12202,574,1123,817,674,538,15928,11713,662,1172,856,724,518,15645
2020-02-04,세종,강원,4,0,0,0,0,0,4,4,0,0,0,0,0,4
2020-02-04,세종,경기,37,5,3,3,4,1,53,38,2,3,4,2,1,50
2020-02-04,세종,경남,246,7,21,18,10,10,312,168,2,7,9,6,9,201
2020-02-04,세종,경북,263,7,21,18,12,6,327,230,6,21,16,13,10,296
2020-02-04,세종,광주,143,3,9,6,1,7,169,119,2,7,3,2,5,138
2020-02-04,세종,대구,137,4,7,8,4,2,162,216,3,14,10,8,5,256
2020-02-04,세종,대전,3352,103,80,40,93,303,3971,3408,95,90,34,51,291,3969
2020-02-04,세종,부산,16,1,0,5,0,0,22,12,0,0,4,6,0,22
2020-02-04,세종,서울,33,0,0,0,0,2,35,39,1,1,1,4,2,48
2020-02-04,세종,세종,237,21,4,9,1,25,297,237,21,4,9,1,25,297
2020-02-04,세종,울산,8,0,0,1,3,1,13,7,1,0,2,8,1,19
2020-02-04,세종,전남,134,4,4,15,14,4,175,142,4,2,9,14,7,178
2020-02-04,세종,전북,546,20,22,13,28,22,651,518,14,15,19,30,19,615
2020-02-04,세종,충남,5519,159,164,113,147,295,6397,3987,129,152,100,138,201,4707
2020-02-04,세종,충북,334,13,26,13,10,30,426,280,18,24,11,15,22,370
2020-02-04,울산,강원,2,0,0,1,0,0,3,0,0,0,0,0,0,0
2020-02-04,울산,경기,38,5,9,51,104,1,208,22,2,0,10,12,1,47
2020-02-04,울산,경남,8786,587,784,480,629,586,11852,9383,635,737,497,644,600,12496
2020-02-04,울산,경북,4683,169,376,375,1188,262,7053,4814,174,383,453,1016,258,7098
2020-02-04,울산,광주,51,4,6,7,10,3,81,59,1,9,4,6,1,80
2020-02-04,울산,대구,1155,49,140,89,196,53,1682,1184,62,146,84,169,47,1692
2020-02-04,울산,대전,79,4,12,10,25,0,130,72,4,10,16,26,1,129
2020-02-04,울산,부산,15353,401,442,416,2424,1136,20172,15303,399,515,641,2457,1107,20422
2020-02-04,울산,서울,26,2,10,17,18,1,74,29,0,1,1,1,0,32
2020-02-04,울산,세종,7,1,0,2,8,1,19,8,0,0,1,3,1,13
2020-02-04,울산,울산,7984,305,550,292,570,762,10463,7984,305,550,292,570,762,10463
2020-02-04,울산,전남,140,15,22,13,26,3,219,189,20,22,22,55,3,311
2020-02-04,울산,전북,44,1,7,4,16,0,72,45,1,6,2,4,0,58
2020-02-04,울산,충남,93,4,20,49,157,3,326,96,4,23,41,123,3,290
2020-02-04,울산,충북,18,3,3,23,46,2,95,15,1,3,14,49,0,82
2020-02-04,전남,강원,35,2,5,7,24,0,73,41,1,3,4,12,1,62
2020-02-04,전남,경기,586,20,96,130,169,15,1016,696,28,122,179,166,15,1206
2020-02-04,전남,경남,5429,306,488,444,1554,224,8445,5379,304,505,512,1582,240,8522
2020-02-04,전남,경북,919,38,77,123,573,28,1758,873,70,68,113,454,28,1606
2020-02-04,전남,광주,30074,979,1093,778,1766,1176,35866,31319,1006,1223,876,1938,1209,37571
2020-02-04,전남,대구,494,15,53,34,90,16,702,467,17,49,29,44,20,626
2020-02-04,전남,대전,232,7,13,29,25,6,312,213,6,10,33,34,7,303
2020-02-04,전남,부산,1677,92,149,149,618,64,2749,1828,88,151,189,582,72,2910
2020-02-04,전남,서울,604,11,27,77,57,21,797,714,10,27,45,35,25,856
2020-02-04,전남,세종,142,4,2,9,14,7,178,134,4,4,15,14,4,175
2020-02-04,전남,울산,189,20,22,22,55,3,311,140,15,22,13,26,3,219
2020-02-04,전남,전남,41410,1407,1727,1745,4725,1688,52702,41410,1407,1727,1745,4725,1688,52702
2020-02-04,전남,전북,4354,285,542,655,1297,136,7269,4233,253,447,662,1246,122,6963
2020-02-04,전남,충남,3573,96,463,743,1266,107,6248,3718,103,462,541,1142,117,6083
2020-02-04,전남,충북,336,24,32,101,291,6,790,353,17,65,130,266,5,836
2020-02-04,전북,강원,126,0,15,29,21,4,195,127,1,14,10,19,4,175
2020-02-04,전북,경기,1109,48,166,199,207,32,1761,1115,48,168,140,192,36,1699
2020-02-04,전북,경남,1099,51,120,106,183,24,1583,1112,40,123,110,156,36,1577
2020-02-04,전북,경북,1421,98,168,165,259,38,2149,1600,86,177,170,243,44,2320
2020-02-04,전북,광주,7383,473,527,329,383,253,9348,7333,442,604,370,352,262,9363
2020-02-04,전북,대구,327,24,52,14,21,7,445,326,14,42,15,31,12,440
2020-02-04,전북,대전,2815,92,79,79,39,127,3231,2850,77,83,92,47,119,3268
2020-02-04,전북,부산,254,8,42,48,67,4,423,272,18,42,38,106,5,481
2020-02-04,전북,서울,998,25,41,42,30,25,1161,1047,20,48,24,16,22,1177
2020-02-04,전북,세종,518,14,15,19,30,19,615,546,20,22,13,28,22,651
2020-02-04,전북,울산,45,1,6,2,4,0,58,44,1,7,4,16,0,72
2020-02-04,전북,전남,4233,253,447,662,1246,122,6963,4354,285,542,655,1297,136,7269
2020-02-04,전북,전북,15312,631,984,619,802,552,18900,15312,631,984,619,802,552,18900
2020-02-04,전북,충남,11314,518,1539,1177,1439,406,16393,11503,499,1492,1004,1446,394,16338
2020-02-04,전북,충북,1588,114,194,312,250,67,2525,1603,123,213,297,253,63,2552
2020-02-04,충남,강원,332,11,25,47,84,9,508,270,9,20,17,36,6,358
2020-02-04,충남,경기,32309,1501,2731,2465,4349,1712,45067,33214,1586,2941,2664,4818,1769,46992
2020-02-04,충남,경남,1359,58,182,363,569,37,2568,1033,49,139,279,297,24,1821
2020-02-04,충남,경북,2913,156,401,519,815,105,4909,2750,147,395,604,637,73,4606
2020-02-04,충남,광주,3554,157,585,707,464,91,5558,3434,112,577,496,331,82,5032
2020-02-04,충남,대구,966,61,120,170,199,27,1543,1293,71,137,241,262,32,2036
2020-02-04,충남,대전,14238,435,511,263,208,1107,16762,15505,455,551,250,200,1188,18149
2020-02-04,충남,부산,122,11,25,83,195,2,438,108,14,28,63,171,6,390
2020-02-04,충남,서울,21694,604,2268,1402,1295,817,28080,22166,553,2271,880,845,876,27591
2020-02-04,충남,세종,3987,129,152,100,138,201,4707,5519,159,164,113,147,295,6397
2020-02-04,충남,울산,96,4,23,41,123,3,290,93,4,20,49,157,3,326
2020-02-04,충남,전남,3718,103,462,541,1142,117,6083,3573,96,463,743,1266,107,6248
2020-02-04,충남,전북,11503,499,1492,1004,1446,394,16338,11314,518,1539,1177,1439,406,16393
2020-02-04,충남,충남,87024,3756,8115,7369,10638,4247,121149,87024,3756,8115,7369,10638,4247,121149
2020-02-04,충남,충북,12696,665,919,995,1546,746,17567,11406,603,843,854,1435,704,15845
2020-02-04,충북,강원,4359,198,258,242,348,242,5647,4318,229,296,252,341,269,5705
2020-02-04,충북,경기,23941,2173,2941,2914,3403,1149,36521,24930,2203,3114,3218,3227,1236,37928
2020-02-04,충북,경남,1162,84,225,490,670,44,2675,888,72,158,298,304,42,1762
2020-02-04,충북,경북,4402,215,604,687,990,171,7069,4466,248,590,715,864,162,7045
2020-02-04,충북,광주,539,31,97,202,115,17,1001,494,22,66,97,75,16,770
2020-02-04,충북,대구,1175,90,162,263,154,48,1892,1465,120,229,293,407,57,2571
2020-02-04,충북,대전,9525,433,452,194,147,755,11506,10621,469,480,205,153,787,12715
2020-02-04,충북,부산,87,22,31,122,214,3,479,99,13,25,98,251,2,488
2020-02-04,충북,서울,11713,662,1172,856,724,518,15645,12202,574,1123,817,674,538,15928
2020-02-04,충북,세종,280,18,24,11,15,22,370,334,13,26,13,10,30,426
2020-02-04,충북,울산,15,1,3,14,49,0,82,18,3,3,23,46,2,95
2020-02-04,충북,전남,353,17,65,130,266,5,836,336,24,32,101,291,6,790
2020-02-04,충북,전북,1603,123,213,297,253,63,2552,1588,114,194,312,250,67,2525
2020-02-04,충북,충남,11406,603,843,854,1435,704,15845,12696,665,919,995,1546,746,17567
2020-02-04,충북,충북,34221,1923,2328,2411,2780,2027,45690,34221,1923,2328,2411,2780,2027,45690
2020-02-05,강원,강원,54991,2044,2902,1216,2298,3892,67343,54991,2044,2902,1216,2298,3892,67343
2020-02-05,강원,경기,14270,534,1207,619,704,711,18045,14871,584,1232,645,800,705,18837
2020-02-05,강원,경남,124,3,11,10,23,2,173,75,6,6,12,7,5,111
2020-02-05,강원,경북,361,18,36,21,29,18,483,322,15,29,24,25,22,437
2020-02-05,강원,광주,55,4,19,11,9,1,99,72,0,11,10,3,2,98
2020-02-05,강원,대구,172,3,12,10,9,9,215,241,10,25,21,17,6,320
2020-02-05,강원,대전,124,3,30,6,0,1,164,146,7,32,4,3,2,194
2020-02-05,강원,부산,5,0,1,3,2,0,11,1,0,0,2,0,0,3
2020-02-05,강원,서울,493,17,260,8,13,21,812,579,18,215,11,11,31,865
2020-02-05,강원,세종,5,0,1,0,1,1,8,6,0,0,0,2,0,8
2020-02-05,강원,울산,3,0,0,0,0,0,3,0,0,0,0,1,1,2
2020-02-05,강원,전남,30,2,2,5,17,3,59,51,0,1,3,8,0,63
2020-02-05,강원,전북,104,5,12,11,15,4,151,93,7,7,19,17,5,148
2020-02-05,강원,충남,291,7,23,20,36,11,388,375,12,25,36,60,7,515
2020-02-05,강원,충북,4063,193,284,211,305,237,5293,4158,192,268,226,274,254,5372
2020-02-05,경기,강원,14871,584,1232,645,800,705,18837,14270,534,1207,619,704,711,18045
2020-02-05,경기,경기,391985,22384,24789,17937,22119,29892,509106,391985,22384,24789,17937,22119,29892,509106
2020-02-05,경기,경남,2227,94,347,796,599,55,4118,1549,69,244,544,401,56,2863
2020-02-05,경기,경북,3630,174,556,796,623,111,5890,3498,193,484,909,603,117,5804
2020-02-05,경기,광주,622,35,174,326,138,12,1307,527,30,137,279,103,17,1093
2020-02-05,경기,대구,1775,100,225,364,248,47,2759,2311,105,217,457,495,73,3658
2020-02-05,경기,대전,1761,105,213,125,46,83,2333,1769,108,188,98,38,94,2295
2020-02-05,경기,부산,147,17,56,198,158,3,579,219,26,51,156,271,4,727
2020-02-05,경기,서울,135360,7342,9041,4987,3525,9230,169485,135837,6910,9270,4683,3115,9397,169212
2020-02-05,경기,세종,27,2,0,4,2,1,36,46,4,3,3,4,4,64
2020-02-05,경기,울산,28,2,2,27,27,0,86,34,2,9,38,90,1,174
2020-02-05,경기,전남,632,15,114,164,135,19,1079,573,19,67,116,137,19,931
2020-02-05,경기,전북,1038,35,173,115,199,29,1589,991,45,164,184,170,35,1589
2020-02-05,경기,충남,31246,1481,2857,2461,4488,1603,44136,31136,1432,2737,2344,4118,1593,43360
2020-02-05,경기,충북,23391,2171,3011,3041,2926,1090,35630,23283,2108,2865,2822,3020,1095,35193
2020-02-05,경남,강원,75,6,6,12,7,5,111,124,3,11,10,23,2,173
2020-02-05,경남,경기,1549,69,244,544,401,56,2863,2227,94,347,796,599,55,4118
2020-02-05,경남,경남,186436,10051,10017,6613,13240,14389,240746,186436,10051,10017,6613,13240,14389,240746
2020-02-05,경남,경북,8858,616,1023,918,1793,389,13597,11405,870,1252,1276,2637,505,17945
2020-02-05,경남,광주,910,64,131,178,147,20,1450,938,62,132,149,102,19,1402
2020-02-05,경남,대구,12275,774,972,1051,1613,473,17158,10010,530,769,399,437,424,12569
2020-02-05,경남,대전,611,18,98,65,33,15,840,852,21,101,121,67,36,1198
2020-02-05,경남,부산,84876,2682,3096,1653,4458,6104,102869,83471,2786,3214,1603,4684,6042,101800
2020-02-05,경남,서울,1394,38,415,253,132,55,2287,2004,56,462,181,134,62,2899
2020-02-05,경남,세종,153,4,9,12,5,4,187,214,1,23,14,17,3,272
2020-02-05,경남,울산,9472,654,743,464,605,585,12523,9041,627,801,417,597,527,12010
2020-02-05,경남,전남,5198,292,443,521,1493,227,8174,5397,292,471,411,1530,232,8333
2020-02-05,경남,전북,1012,34,131,120,158,34,1489,1029,43,127,124,133,28,1484
2020-02-05,경남,충남,975,51,120,283,234,24,1687,1361,60,166,341,531,31,2490
2020-02-05,경남,충북,880,50,147,288,254,21,1640,1238,68,212,499,594,36,2647
2020-02-05,경북,강원,322,15,29,24,25,22,437,361,18,36,21,29,18,483
2020-02-05,경북,경기,3498,193,484,909,603,117,5804,3630,174,556,796,623,111,5890
2020-02-05,경북,경남,11405,870,1252,1276,2637,505,17945,8858,616,1023,918,1793,389,13597
2020-02-05,경북,경북,68597,3903,4231,2884,4994,3830,88439,68597,3903,4231,2884,4994,3830,88439
2020-02-05,경북,광주,709,63,139,206,127,7,1251,704,66,121,206,86,14,1197
2020-02-05,경북,대구,69937,2969,2924,1540,2900,3888,84158,72256,3108,3349,1869,3382,3875,87839
2020-02-05,경북,대전,1544,51,124,99,87,66,1971,1581,49,121,130,72,71,2024
2020-02-05,경북,부산,3606,147,347,214,664,166,5144,3781,142,357,202,781,205,5468
2020-02-05,경북,서울,2092,100,347,385,163,78,3165,2418,83,324,212,120,71,3228
2020-02-05,경북,세종,248,4,15,23,10,8,308,246,5,15,22,22,9,319
2020-02-05,경북,울산,4651,167,373,419,1010,240,6860,4573,146,352,354,1263,256,6944
2020-02-05,경북,전남,822,28,76,101,510,19,1556,889,42,71,86,617,29,1734
2020-02-05,경북,전북,1570,94,198,197,262,41,2362,1323,84,171,149,261,44,2032
2020-02-05,경북,충남,2554,141,389,591,574,99,4348,2698,132,385,468,801,100,4584
2020-02-05,경북,충북,4418,205,560,648,863,179,6873,4298,228,583,617,982,170,6878
2020-02-05,광주,강원,72,0,11,10,3,2,98,55,4,19,11,9,1,99
2020-02-05,광주,경기,527,30,137,279,103,17,1093,622,35,174,326,138,12,1307
2020-02-05,광주,경남,938,62,132,149,102,19,1402,910,64,131,178,147,20,1450
2020-02-05,광주,경북,704,66,121,206,86,14,1197,709,63,139,206,127,7,1251
2020-02-05,광주,광주,11806,416,626,330,270,510,13958,11806,416,626,330,270,510,13958
2020-02-05,광주,대구,572,25,98,81,29,10,815,581,26,105,76,34,8,830
2020-02-05,광주,대전,391,17,19,28,18,11,484,412,24,23,28,16,10,513
2020-02-05,광주,부산,393,12,57,40,84,9,595,381,19,58,84,113,11,666
2020-02-05,광주,서울,486,18,26,67,14,12,623,591,19,26,33,21,22,712
2020-02-05,광주,세종,108,3,8,12,1,4,136,136,3,7,6,4,3,159
2020-02-05,광주,울산,52,1,9,0,4,1,67,37,1,6,7,8,0,59
2020-02-05,광주,전남,29427,944,1204,756,2048,1164,35543,28470,933,1028,671,1926,1134,34162
2020-02-05,광주,전북,7001,438,569,376,358,265,9007,7131,426,501,335,377,249,9019
2020-02-05,광주,충남,3333,113,572,439,291,86,4834,3244,140,546,645,427,109,5111
2020-02-05,광주,충북,457,22,73,110,64,13,739,540,37,97,180,98,17,969
2020-02-05,대구,강원,241,10,25,21,17,6,320,172,3,12,10,9,9,215
2020-02-05,대구,경기,2311,105,217,457,495,73,3658,1775,100,225,364,248,47,2759
2020-02-05,대구,경남,10010,530,769,399,437,424,12569,12275,774,972,1051,1613,473,17158
2020-02-05,대구,경북,72256,3108,3349,1869,3382,3875,87839,69937,2969,2924,1540,2900,3888,84158
2020-02-05,대구,광주,581,26,105,76,34,8,830,572,25,98,81,29,10,815
2020-02-05,대구,대구,59215,2173,1827,877,1304,3878,69274,59215,2173,1827,877,1304,3878,69274
2020-02-05,대구,대전,865,42,54,76,49,28,1114,617,26,34,52,29,23,781
2020-02-05,대구,부산,555,53,112,51,166,16,953,2591,108,231,99,258,107,3394
2020-02-05,대구,서울,1974,78,179,255,125,45,2656,1441,59,137,138,50,35,1860
2020-02-05,대구,세종,234,5,16,5,12,4,276,166,4,2,2,3,1,178
2020-02-05,대구,울산,1159,52,148,59,173,54,1645,1184,55,143,83,207,48,1720
2020-02-05,대구,전남,419,14,39,32,50,5,559,446,22,40,46,75,14,643
2020-02-05,대구,전북,293,10,42,16,21,11,393,304,10,45,25,27,11,422
2020-02-05,대구,충남,1230,80,147,205,243,37,1942,1013,72,112,164,189,31,1581
2020-02-05,대구,충북,1451,80,223,278,370,51,2453,1183,94,172,238,136,46,1869
2020-02-05,대전,강원,146,7,32,4,3,2,194,124,3,30,6,0,1,164
2020-02-05,대전,경기,1769,108,188,98,38,94,2295,1761,105,213,125,46,83,2333
2020-02-05,대전,경남,852,21,101,121,67,36,1198,611,18,98,65,33,15,840
2020-02-05,대전,경북,1581,49,121,130,72,71,2024,1544,51,124,99,87,66,1971
2020-02-05,대전,광주,412,24,23,28,16,10,513,391,17,19,28,18,11,484
2020-02-05,대전,대구,617,26,34,52,29,23,781,865,42,54,76,49,28,1114
2020-02-05,대전,대전,12919,391,434,192,171,1003,15110,12919,391,434,192,171,1003,15110
2020-02-05,대전,부산,64,3,5,15,12,1,100,57,5,9,19,12,5,107
2020-02-05,대전,서울,1522,47,181,30,11,59,1850,1490,40,196,42,7,55,1830
2020-02-05,대전,세종,3283,115,75,25,72,278,3848,3251,120,76,33,113,261,3854
2020-02-05,대전,울산,85,0,10,25,25,2,147,68,2,11,15,25,3,124
2020-02-05,대전,전남,223,13,6,31,45,9,327,242,10,13,35,29,7,336
2020-02-05,대전,전북,2742,77,101,77,35,119,3151,2742,95,101,72,35,114,3159
2020-02-05,대전,충남,15336,419,499,248,242,1137,17881,13778,414,480,227,253,1024,16176
2020-02-05,대전,충북,10133,487,483,190,147,795,12235,9217,376,414,178,127,736,11048
2020-02-05,부산,강원,1,0,0,2,0,0,3,5,0,1,3,2,0,11
2020-02-05,부산,경기,219,26,51,156,271,4,727,147,17,56,198,158,3,579
2020-02-05,부산,경남,83471,2786,3214,1603,4684,6042,101800,84876,2682,3096,1653,4458,6104,102869
2020-02-05,부산,경북,3781,142,357,202,781,205,5468,3606,147,347,214,664,166,5144
2020-02-05,부산,광주,381,19,58,84,113,11,666,393,12,57,40,84,9,595
2020-02-05,부산,대구,2591,108,231,99,258,107,3394,555,53,112,51,166,16,953
2020-02-05,부산,대전,57,5,9,19,12,5,107,64,3,5,15,12,1,100
2020-02-05,부산,부산,40019,734,665,804,1958,2876,47056,40019,734,665,804,1958,2876,47056
2020-02-05,부산,서울,168,13,12,87,86,8,374,161,7,24,66,35,4,297
2020-02-05,부산,세종,20,1,2,5,5,0,33,13,1,1,2,0,0,17
2020-02-05,부산,울산,15752,396,525,623,2516,1079,20891,15970,418,430,396,2335,1109,20658
2020-02-05,부산,전남,1781,94,125,169,536,67,2772,1691,80,118,157,614,65,2725
2020-02-05,부산,전북,254,8,37,37,100,7,443,234,10,38,51,76,7,416
2020-02-05,부산,충남,115,17,28,66,154,3,383,119,16,22,79,195,3,434
2020-02-05,부산,충북,84,10,23,73,206,4,400,92,14,28,124,187,3,448
2020-02-05,서울,강원,579,18,215,11,11,31,865,493,17,260,8,13,21,812
2020-02-05,서울,경기,135837,6910,9270,4683,3115,9397,169212,135360,7342,9041,4987,3525,9230,169485
2020-02-05,서울,경남,2004,56,462,181,134,62,2899,1394,38,415,253,132,55,2287
2020-02-05,서울,경북,2418,83,324,212,120,71,3228,2092,100,347,385,163,78,3165
2020-02-05,서울,광주,591,19,26,33,21,22,712,486,18,26,67,14,12,623
2020-02-05,서울,대구,1441,59,137,138,50,35,1860,1974,78,179,255,125,45,2656
2020-02-05,서울,대전,1490,40,196,42,7,55,1830,1522,47,181,30,11,59,1850
2020-02-05,서울,부산,161,7,24,66,35,4,297,168,13,12,87,86,8,374
2020-02-05,서울,서울,185,7,15,2,3,15,227,185,7,15,2,3,15,227
2020-02-05,서울,세종,27,0,0,0,0,1,28,35,1,2,2,0,3,43
2020-02-05,서울,울산,22,1,5,4,3,1,36,14,0,6,6,13,1,40
2020-02-05,서울,전남,676,8,22,50,27,16,799,654,12,26,68,47,12,819
2020-02-05,서울,전북,974,27,45,18,25,28,1117,946,23,41,29,22,30,1091
2020-02-05,서울,충남,20534,490,2237,789,820,813,25683,20992,620,2262,1233,1119,809,27035
2020-02-05,서울,충북,11344,535,1086,743,640,476,14824,11204,627,1148,753,678,441,14851
2020-02-05,세종,강원,6,0,0,0,2,0,8,5,0,1,0,1,1,8
2020-02-05,세종,경기,46,4,3,3,4,4,64,27,2,0,4,2,1,36
2020-02-05,세종,경남,214,1,23,14,17,3,272,153,4,9,12,5,4,187
2020-02-05,세종,경북,246,5,15,22,22,9,319,248,4,15,23,10,8,308
2020-02-05,세종,광주,136,3,7,6,4,3,159,108,3,8,12,1,4,136
2020-02-05,세종,대구,166,4,2,2,3,1,178,234,5,16,5,12,4,276
2020-02-05,세종,대전,3251,120,76,33,113,261,3854,3283,115,75,25,72,278,3848
2020-02-05,세종,부산,13,1,1,2,0,0,17,20,1,2,5,5,0,33
2020-02-05,세종,서울,35,1,2,2,0,3,43,27,0,0,0,0,1,28
2020-02-05,세종,세종,241,25,2,8,1,20,297,241,25,2,8,1,20,297
2020-02-05,세종,울산,6,0,0,1,3,0,10,9,0,1,2,4,0,16
2020-02-05,세종,전남,119,2,10,15,16,4,166,127,0,3,4,7,2,143
2020-02-05,세종,전북,585,21,18,16,25,24,689,561,15,23,18,29,24,670
2020-02-05,세종,충남,5325,157,150,105,159,287,6183,3937,137,148,126,143,184,4675
2020-02-05,세종,충북,330,14,14,11,5,26,400,292,16,18,4,10,18,358
2020-02-05,울산,강원,0,0,0,0,1,1,2,3,0,0,0,0,0,3
2020-02-05,울산,경기,34,2,9,38,90,1,174,28,2,2,27,27,0,86
2020-02-05,울산,경남,9041,627,801,417,597,527,12010,9472,654,743,464,605,585,12523
2020-02-05,울산,경북,4573,146,352,354,1263,256,6944,4651,167,373,419,1010,240,6860
2020-02-05,울산,광주,37,1,6,7,8,0,59,52,1,9,0,4,1,67
2020-02-05,울산,대구,1184,55,143,83,207,48,1720,1159,52,148,59,173,54,1645
2020-02-05,울산,대전,68,2,11,15,25,3,124,85,0,10,25,25,2,147
2020-02-05,울산,부산,15970,418,430,396,2335,1109,20658,15752,396,525,623,2516,1079,20891
2020-02-05,울산,서울,14,0,6,6,13,1,40,22,1,5,4,3,1,36
2020-02-05,울산,세종,9,0,1,2,4,0,16,6,0,0,1,3,0,10
2020-02-05,울산,울산,8067,289,548,263,573,741,10481,8067,289,548,263,573,741,10481
2020-02-05,울산,전남,183,11,24,15,31,4,268,167,17,20,14,53,5,276
2020-02-05,울산,전북,43,0,11,4,20,0,78,29,1,7,4,5,1,47
2020-02-05,울산,충남,85,6,18,50,131,3,293,104,4,16,43,126,2,295
2020-02-05,울산,충북,15,2,5,18,42,2,84,14,3,3,17,37,1,75
2020-02-05,전남,강원,51,0,1,3,8,0,63,30,2,2,5,17,3,59
2020-02-05,전남,경기,573,19,67,116,137,19,931,632,15,114,164,135,19,1079
2020-02-05,전남,경남,5397,292,471,411,1530,232,8333,5198,292,443,521,1493,227,8174
2020-02-05,전남,경북,889,42,71,86,617,29,1734,822,28,76,101,510,19,1556
2020-02-05,전남,광주,28470,933,1028,671,1926,1134,34162,29427,944,1204,756,2048,1164,35543
2020-02-05,전남,대구,446,22,40,46,75,14,643,419,14,39,32,50,5,559
2020-02-05,전남,대전,242,10,13,35,29,7,336,223,13,6,31,45,9,327
2020-02-05,전남,부산,1691,80,118,157,614,65,2725,1781,94,125,169,536,67,2772
2020-02-05,전남,서울,654,12,26,68,47,12,819,676,8,22,50,27,16,799
2020-02-05,전남,세종,127,0,3,4,7,2,143,119,2,10,15,16,4,166
2020-02-05,전남,울산,167,17,20,14,53,5,276,183,11,24,15,31,4,268
2020-02-05,전남,전남,39408,1358,1593,1773,4642,1691,50465,39408,1358,1593,1773,4642,1691,50465
2020-02-05,전남,전북,4076,250,476,536,1218,133,6689,3869,212,461,569,1170,127,6408
2020-02-05,전남,충남,3397,111,463,694,1235,86,5986,3416,97,476,496,1008,81,5574
2020-02-05,전남,충북,326,13,37,91,235,5,707,317,22,42,110,276,6,773
2020-02-05,전북,강원,93,7,7,19,17,5,148,104,5,12,11,15,4,151
2020-02-05,전북,경기,991,45,164,184,170,35,1589,1038,35,173,115,199,29,1589
2020-02-05,전북,경남,1029,43,127,124,133,28,1484,1012,34,131,120,158,34,1489
2020-02-05,전북,경북,1323,84,171,149,261,44,2032,1570,94,198,197,262,41,2362
2020-02-05,전북,광주,7131,426,501,335,377,249,9019,7001,438,569,376,358,265,9007
2020-02-05,전북,대구,304,10,45,25,27,11,422,293,10,42,16,21,11,393
2020-02-05,전북,대전,2742,95,101,72,35,114,3159,2742,77,101,77,35,119,3151
2020-02-05,전북,부산,234,10,38,51,76,7,416,254,8,37,37,100,7,443
2020-02-05,전북,서울,946,23,41,29,22,30,1091,974,27,45,18,25,28,1117
2020-02-05,전북,세종,561,15,23,18,29,24,670,585,21,18,16,25,24,689
2020-02-05,전북,울산,29,1,7,4,5,1,47,43,0,11,4,20,0,78
2020-02-05,전북,전남,3869,212,461,569,1170,127,6408,4076,250,476,536,1218,133,6689
2020-02-05,전북,전북,14927,563,921,628,699,570,18308,14927,563,921,628,699,570,18308
2020-02-05,전북,충남,10788,504,1509,1136,1371,340,15648,10696,490,1494,990,1391,343,15404
2020-02-05,전북,충북,1535,129,168,276,275,42,2425,1464,129,219,259,242,42,2355
2020-02-05,충남,강원,375,12,25,36,60,7,515,291,7,23,20,36,11,388
2020-02-05,충남,경기,31136,1432,2737,2344,4118,1593,43360,31246,1481,2857,2461,4488,1603,44136
2020-02-05,충남,경남,1361,60,166,341,531,31,2490,975,51,120,283,234,24,1687
2020-02-05,충남,경북,2698,132,385,468,801,100,4584,2554,141,389,591,574,99,4348
2020-02-05,충남,광주,3244,140,546,645,427,109,5111,3333,113,572,439,291,86,4834
2020-02-05,충남,대구,1013,72,112,164,189,31,1581,1230,80,147,205,243,37,1942
2020-02-05,충남,대전,13778,414,480,227,253,1024,16176,15336,419,499,248,242,1137,17881
2020-02-05,충남,부산,119,16,22,79,195,3,434,115,17,28,66,154,3,383
2020-02-05,충남,서울,20992,620,2262,1233,1119,809,27035,20534,490,2237,789,820,813,25683
2020-02-05,충남,세종,3937,137,148,126,143,184,4675,5325,157,150,105,159,287,6183
2020-02-05,충남,울산,104,4,16,43,126,2,295,85,6,18,50,131,3,293
2020-02-05,충남,전남,3416,97,476,496,1008,81,5574,3397,111,463,694,1235,86,5986
2020-02-05,충남,전북,10696,490,1494,990,1391,343,15404,10788,504,1509,1136,1371,340,15648
2020-02-05,충남,충남,83563,3551,7917,6928,10064,3985,116008,83563,3551,7917,6928,10064,3985,116008
2020-02-05,충남,충북,12556,624,841,921,1539,732,17213,11348,614,838,871,1454,682,15807
2020-02-05,충북,강원,4158,192,268,226,274,254,5372,4063,193,284,211,305,237,5293
2020-02-05,충북,경기,23283,2108,2865,2822,3020,1095,35193,23391,2171,3011,3041,2926,1090,35630
2020-02-05,충북,경남,1238,68,212,499,594,36,2647,880,50,147,288,254,21,1640
2020-02-05,충북,경북,4298,228,583,617,982,170,6878,4418,205,560,648,863,179,6873
2020-02-05,충북,광주,540,37,97,180,98,17,969,457,22,73,110,64,13,739
2020-02-05,충북,대구,1183,94,172,238,136,46,1869,1451,80,223,278,370,51,2453
2020-02-05,충북,대전,9217,376,414,178,127,736,11048,10133,487,483,190,147,795,12235
2020-02-05,충북,부산,92,14,28,124,187,3,448,84,10,23,73,206,4,400
2020-02-05,충북,서울,11204,627,1148,753,678,441,14851,11344,535,1086,743,640,476,14824
2020-02-05,충북,세종,292,16,18,4,10,18,358,330,14,14,11,5,26,400
2020-02-05,충북,울산,14,3,3,17,37,1,75,15,2,5,18,42,2,84
2020-02-05,충북,전남,317,22,42,110,276,6,773,326,13,37,91,235,5,707
2020-02-05,충북,전북,1464,129,219,259,242,42,2355,1535,129,168,276,275,42,2425
2020-02-05,충북,충남,11348,614,838,871,1454,682,15807,12556,624,841,921,1539,732,17213
2020-02-05,충북,충북,33213,1880,2255,2103,2559,1988,43998,33213,1880,2255,2103,2559,1988,43998
2020-02-06,강원,강원,56546,2135,3013,1151,2195,3976,69016,56546,2135,3013,1151,2195,3976,69016
2020-02-06,강원,경기,15163,560,1252,573,694,756,18998,16271,583,1240,625,783,807,20309
2020-02-06,강원,경남,139,1,13,16,29,1,199,87,0,8,23,11,2,131
2020-02-06,강원,경북,369,19,32,18,25,10,473,358,10,28,28,22,14,460
2020-02-06,강원,광주,72,1,19,6,14,1,113,89,3,22,11,2,3,130
2020-02-06,강원,대구,181,1,14,12,14,4,226,239,7,16,30,18,5,315
2020-02-06,강원,대전,140,2,27,3,1,6,179,152,1,30,5,1,3,192
2020-02-06,강원,부산,2,0,0,0,3,0,5,3,1,1,1,1,0,7
2020-02-06,강원,서울,543,17,260,12,17,18,867,648,9,220,15,6,20,918
2020-02-06,강원,세종,7,1,0,0,0,0,8,4,0,0,0,1,0,5
2020-02-06,강원,울산,0,0,0,0,0,0,0,2,0,0,1,1,0,4
2020-02-06,강원,전남,54,0,4,6,7,1,72,45,1,4,7,18,1,76
2020-02-06,강원,전북,109,1,10,16,14,4,154,120,2,13,21,12,4,172
2020-02-06,강원,충남,281,5,14,19,32,10,361,403,9,25,41,77,15,570
2020-02-06,강원,충북,4231,206,295,215,331,271,5549,4285,185,262,212,281,270,5495
2020-02-06,경기,강원,16271,583,1240,625,783,807,20309,15163,560,1252,573,694,756,18998
2020-02-06,경기,경기,400915,22188,25302,17787,22080,30780,519052,400915,22188,25302,17787,22080,30780,519052
2020-02-06,경기,경남,2315,90,351,751,592,80,4179,1778,65,274,547,401,44,3109
2020-02-06,경기,경북,3681,198,479,752,583,110,5803,3687,192,468,908,573,109,5937
2020-02-06,경기,광주,698,24,169,317,123,18,1349,643,22,144,249,105,11,1174
2020-02-06,경기,대구,1907,87,212,370,252,64,2892,2485,118,254,462,454,92,3865
2020-02-06,경기,대전,1819,87,210,107,61,72,2356,1744,117,196,105,73,76,2311
2020-02-06,경기,부산,206,24,49,206,137,4,626,223,15,32,174,263,10,717
2020-02-06,경기,서울,139308,7187,9174,4814,3553,9589,173625,138642,6839,9355,4604,3216,9471,172127
2020-02-06,경기,세종,26,3,1,4,0,1,35,48,3,2,7,0,1,61
2020-02-06,경기,울산,47,6,2,10,11,2,78,45,4,9,41,82,4,185
2020-02-06,경기,전남,691,24,103,170,159,17,1164,642,25,78,125,144,27,1041
2020-02-06,경기,전북,1138,59,162,139,192,29,1719,1099,49,162,159,191,29,1689
2020-02-06,경기,충남,33480,1516,2791,2422,4493,1752,46454,33208,1459,2706,2291,4088,1692,45444
2020-02-06,경기,충북,24635,2174,3010,3011,3010,1196,37036,23914,2070,2802,2814,3134,1097,35831
2020-02-06,경남,강원,87,0,8,23,11,2,131,139,1,13,16,29,1,199
2020-02-06,경남,경기,1778,65,274,547,401,44,3109,2315,90,351,751,592,80,4179
2020-02-06,경남,경남,185857,9840,9832,6785,13008,14369,239691,185857,9840,9832,6785,13008,14369,239691
2020-02-06,경남,경북,8861,580,985,914,1738,420,13498,11314,834,1206,1264,2534,516,17668
2020-02-06,경남,광주,980,41,130,176,128,23,1478,945,36,133,166,102,33,1415
2020-02-06,경남,대구,12727,755,1046,1013,1656,488,17685,10020,521,798,410,444,433,12626
2020-02-06,경남,대전,683,18,96,71,37,29,934,924,35,103,100,65,22,1249
2020-02-06,경남,부산,84552,2591,2985,1698,4202,6084,102112,83276,2698,3122,1790,4587,5956,101429
2020-02-06,경남,서울,1645,37,446,283,139,49,2599,2131,46,446,214,112,60,3009
2020-02-06,경남,세종,174,3,9,7,6,5,204,247,4,17,10,18,6,302
2020-02-06,경남,울산,9599,604,706,457,668,589,12623,9174,578,738,395,649,525,12059
2020-02-06,경남,전남,5186,274,489,429,1516,240,8134,5310,281,483,378,1529,215,8196
2020-02-06,경남,전북,1041,35,118,114,154,27,1489,1012,46,128,106,164,36,1492
2020-02-06,경남,충남,1119,52,119,257,235,34,1816,1539,63,171,344,501,45,2663
2020-02-06,경남,충북,928,52,135,285,287,26,1713,1251,66,215,438,633,38,2641
2020-02-06,경북,강원,358,10,28,28,22,14,460,369,19,32,18,25,10,473
2020-02-06,경북,경기,3687,192,468,908,573,109,5937,3681,198,479,752,583,110,5803
2020-02-06,경북,경남,11314,834,1206,1264,2534,516,17668,8861,580,985,914,1738,420,13498
2020-02-06,경북,경북,68850,3702,4086,2864,4714,3707,87923,68850,3702,4086,2864,4714,3707,87923
2020-02-06,경북,광주,710,61,147,198,102,17,1235,755,52,110,182,83,25,1207
2020-02-06,경북,대구,68851,2875,2872,1727,2978,3843,83146,71795,2968,3313,2079,3465,3867,87487
2020-02-06,경북,대전,1547,59,118,101,83,73,1981,1563,51,119,143,64,70,2010
2020-02-06,경북,부산,3751,125,340,201,625,172,5214,3923,119,359,211,770,179,5561
2020-02-06,경북,서울,2615,97,317,370,168,63,3630,2604,85,308,224,124,78,3423
2020-02-06,경북,세종,262,6,24,20,15,10,337,250,8,27,16,8,8,317
2020-02-06,경북,울산,4452,159,345,425,947,259,6587,4571,155,339,325,1209,253,6852
2020-02-06,경북,전남,854,46,77,115,423,23,1538,878,42,84,84,517,23,1628
2020-02-06,경북,전북,1540,88,190,183,250,50,2301,1432,98,186,157,236,38,2147
2020-02-06,경북,충남,2916,139,356,560,603,90,4664,3099,110,331,487,773,122,4922
2020-02-06,경북,충북,4557,243,517,658,918,165,7058,4353,246,511,640,1004,168,6922
2020-02-06,광주,강원,89,3,22,11,2,3,130,72,1,19,6,14,1,113
2020-02-06,광주,경기,643,22,144,249,105,11,1174,698,24,169,317,123,18,1349
2020-02-06,광주,경남,945,36,133,166,102,33,1415,980,41,130,176,128,23,1478
2020-02-06,광주,경북,755,52,110,182,83,25,1207,710,61,147,198,102,17,1235
2020-02-06,광주,광주,11884,480,622,339,309,514,14148,11884,480,622,339,309,514,14148
2020-02-06,광주,대구,574,27,94,74,23,12,804,575,25,99,72,28,17,816
2020-02-06,광주,대전,408,20,23,25,17,13,506,424,18,23,44,24,8,541
2020-02-06,광주,부산,413,12,48,36,82,9,600,385,20,44,78,109,6,642
2020-02-06,광주,서울,547,16,26,71,22,15,697,572,17,20,57,28,13,707
2020-02-06,광주,세종,112,3,9,2,2,3,131,134,1,8,4,1,2,150
2020-02-06,광주,울산,57,2,14,3,2,3,81,38,1,8,5,9,0,61
2020-02-06,광주,전남,29268,918,1177,751,1839,1159,35112,28233,928,985,688,1773,1112,33719
2020-02-06,광주,전북,6935,418,540,374,386,287,8940,6861,442,481,312,383,296,8775
2020-02-06,광주,충남,3521,108,548,447,277,101,5002,3420,113,546,547,426,87,5139
2020-02-06,광주,충북,469,24,66,98,57,8,722,545,34,83,151,93,9,915
2020-02-06,대구,강원,239,7,16,30,18,5,315,181,1,14,12,14,4,226
2020-02-06,대구,경기,2485,118,254,462,454,92,3865,1907,87,212,370,252,64,2892
2020-02-06,대구,경남,10020,521,798,410,444,433,12626,12727,755,1046,1013,1656,488,17685
2020-02-06,대구,경북,71795,2968,3313,2079,3465,3867,87487,68851,2875,2872,1727,2978,3843,83146
2020-02-06,대구,광주,575,25,99,72,28,17,816,574,27,94,74,23,12,804
2020-02-06,대구,대구,58858,2060,1864,934,1337,4063,69116,58858,2060,1864,934,1337,4063,69116
2020-02-06,대구,대전,928,41,58,89,50,32,1198,664,31,40,43,31,30,839
2020-02-06,대구,부산,594,51,107,65,149,23,989,2634,114,240,87,205,108,3388
2020-02-06,대구,서울,2389,69,184,223,91,73,3029,1620,52,137,138,48,43,2038
2020-02-06,대구,세종,235,2,10,3,9,3,262,156,2,4,4,6,2,174
2020-02-06,대구,울산,1200,52,162,69,174,39,1696,1188,63,141,68,202,65,1727
2020-02-06,대구,전남,416,8,59,23,46,12,564,438,14,45,27,67,11,602
2020-02-06,대구,전북,317,16,43,18,18,6,418,331,18,43,19,32,3,446
2020-02-06,대구,충남,1307,67,150,202,259,39,2024,1078,58,114,158,201,25,1634
2020-02-06,대구,충북,1641,95,223,258,393,51,2661,1216,74,158,227,149,40,1864
2020-02-06,대전,강원,152,1,30,5,1,3,192,140,2,27,3,1,6,179
2020-02-06,대전,경기,1744,117,196,105,73,76,2311,1819,87,210,107,61,72,2356
2020-02-06,대전,경남,924,35,103,100,65,22,1249,683,18,96,71,37,29,934
2020-02-06,대전,경북,1563,51,119,143,64,70,2010,1547,59,118,101,83,73,1981
2020-02-06,대전,광주,424,18,23,44,24,8,541,408,20,23,25,17,13,506
2020-02-06,대전,대구,664,31,40,43,31,30,839,928,41,58,89,50,32,1198
2020-02-06,대전,대전,12840,401,428,181,237,1028,15115,12840,401,428,181,237,1028,15115
2020-02-06,대전,부산,73,6,6,16,18,1,120,64,0,8,17,22,2,113
2020-02-06,대전,서울,1576,29,199,29,9,54,1896,1611,33,200,51,10,57,1962
2020-02-06,대전,세종,3236,93,75,24,101,298,3827,3314,91,64,27,117,282,3895
2020-02-06,대전,울산,60,2,12,17,27,4,122,88,3,13,10,27,3,144
2020-02-06,대전,전남,250,9,7,39,34,7,346,237,8,17,18,21,3,304
2020-02-06,대전,전북,2799,81,79,78,38,143,3218,2817,96,81,86,41,133,3254
2020-02-06,대전,충남,15373,454,507,242,207,1181,17964,13863,409,461,236,225,1068,16262
2020-02-06,대전,충북,10311,448,448,201,124,785,12317,9309,379,409,165,94,765,11121
2020-02-06,부산,강원,3,1,1,1,1,0,7,2,0,0,0,3,0,5
2020-02-06,부산,경기,223,15,32,174,263,10,717,206,24,49,206,137,4,626
2020-02-06,부산,경남,83276,2698,3122,1790,4587,5956,101429,84552,2591,2985,1698,4202,6084,102112
2020-02-06,부산,경북,3923,119,359,211,770,179,5561,3751,125,340,201,625,172,5214
2020-02-06,부산,광주,385,20,44,78,109,6,642,413,12,48,36,82,9,600
2020-02-06,부산,대구,2634,114,240,87,205,108,3388,594,51,107,65,149,23,989
2020-02-06,부산,대전,64,0,8,17,22,2,113,73,6,6,16,18,1,120
2020-02-06,부산,부산,39641,700,684,583,2068,2908,46584,39641,700,684,583,2068,2908,46584
2020-02-06,부산,서울,196,12,18,76,78,3,383,139,17,19,67,52,6,300
2020-02-06,부산,세종,18,0,2,2,3,0,25,14,0,0,2,2,0,18
2020-02-06,부산,울산,15777,388,456,631,2519,1055,20826,15902,408,421,419,2351,1083,20584
2020-02-06,부산,전남,1758,79,132,195,574,55,2793,1710,75,128,150,596,57,2716
2020-02-06,부산,전북,283,14,39,48,91,9,484,260,12,34,51,73,3,433
2020-02-06,부산,충남,122,17,29,63,139,4,374,132,11,16,89,181,9,438
2020-02-06,부산,충북,93,12,25,80,215,0,425,99,11,21,121,167,2,421
2020-02-06,서울,강원,648,9,220,15,6,20,918,543,17,260,12,17,18,867
2020-02-06,서울,경기,138642,6839,9355,4604,3216,9471,172127,139308,7187,9174,4814,3553,9589,173625
2020-02-06,서울,경남,2131,46,446,214,112,60,3009,1645,37,446,283,139,49,2599
2020-02-06,서울,경북,2604,85,308,224,124,78,3423,2615,97,317,370,168,63,3630
2020-02-06,서울,광주,572,17,20,57,28,13,707,547,16,26,71,22,15,697
2020-02-06,서울,대구,1620,52,137,138,48,43,2038,2389,69,184,223,91,73,3029
2020-02-06,서울,대전,1611,33,200,51,10,57,1962,1576,29,199,29,9,54,1896
2020-02-06,서울,부산,139,17,19,67,52,6,300,196,12,18,76,78,3,383
2020-02-06,서울,서울,207,11,13,7,4,12,254,207,11,13,7,4,12,254
2020-02-06,서울,세종,20,1,1,0,0,0,22,33,1,1,1,0,0,36
2020-02-06,서울,울산,25,1,6,5,1,0,38,30,0,9,13,17,1,70
2020-02-06,서울,전남,723,11,18,45,34,18,849,662,3,30,52,39,23,809
2020-02-06,서울,전북,1031,21,54,34,18,32,1190,959,24,49,43,25,25,1125
2020-02-06,서울,충남,22169,477,2249,799,781,843,27318,23046,583,2290,1259,1125,879,29182
2020-02-06,서울,충북,11931,518,1115,707,655,469,15395,11891,626,1128,759,686,459,15549
2020-02-06,세종,강원,4,0,0,0,1,0,5,7,1,0,0,0,0,8
2020-02-06,세종,경기,48,3,2,7,0,1,61,26,3,1,4,0,1,35
2020-02-06,세종,경남,247,4,17,10,18,6,302,174,3,9,7,6,5,204
2020-02-06,세종,경북,250,8,27,16,8,8,317,262,6,24,20,15,10,337
2020-02-06,세종,광주,134,1,8,4,1,2,150,112,3,9,2,2,3,131
2020-02-06,세종,대구,156,2,4,4,6,2,174,235,2,10,3,9,3,262
2020-02-06,세종,대전,3314,91,64,27,117,282,3895,3236,93,75,24,101,298,3827
2020-02-06,세종,부산,14,0,0,2,2,0,18,18,0,2,2,3,0,25
2020-02-06,세종,서울,33,1,1,1,0,0,36,20,1,1,0,0,0,22
2020-02-06,세종,세종,257,20,1,4,1,29,312,257,20,1,4,1,29,312
2020-02-06,세종,울산,6,0,1,1,1,0,9,5,0,0,0,7,1,13
2020-02-06,세종,전남,151,3,2,8,15,7,186,140,5,1,7,6,2,161
2020-02-06,세종,전북,597,21,26,22,18,25,709,514,11,21,20,24,19,609
2020-02-06,세종,충남,5513,157,149,96,162,288,6365,4131,129,146,111,144,207,4868
2020-02-06,세종,충북,335,17,17,21,10,24,424,323,13,16,14,17,19,402
2020-02-06,울산,강원,2,0,0,1,1,0,4,0,0,0,0,0,0,0
2020-02-06,울산,경기,45,4,9,41,82,4,185,47,6,2,10,11,2,78
2020-02-06,울산,경남,9174,578,738,395,649,525,12059,9599,604,706,457,668,589,12623
2020-02-06,울산,경북,4571,155,339,325,1209,253,6852,4452,159,345,425,947,259,6587
2020-02-06,울산,광주,38,1,8,5,9,0,61,57,2,14,3,2,3,81
2020-02-06,울산,대구,1188,63,141,68,202,65,1727,1200,52,162,69,174,39,1696
2020-02-06,울산,대전,88,3,13,10,27,3,144,60,2,12,17,27,4,122
2020-02-06,울산,부산,15902,408,421,419,2351,1083,20584,15777,388,456,631,2519,1055,20826
2020-02-06,울산,서울,30,0,9,13,17,1,70,25,1,6,5,1,0,38
2020-02-06,울산,세종,5,0,0,0,7,1,13,6,0,1,1,1,0,9
2020-02-06,울산,울산,8096,268,556,268,543,719,10450,8096,268,556,268,543,719,10450
2020-02-06,울산,전남,176,11,26,21,30,7,271,200,18,18,19,44,3,302
2020-02-06,울산,전북,45,1,8,2,14,1,71,34,0,9,3,3,0,49
2020-02-06,울산,충남,97,5,20,41,113,1,277,114,7,19,31,104,0,275
2020-02-06,울산,충북,25,2,6,21,44,1,99,17,2,2,11,36,0,68
2020-02-06,전남,강원,45,1,4,7,18,1,76,54,0,4,6,7,1,72
2020-02-06,전남,경기,642,25,78,125,144,27,1041,691,24,103,170,159,17,1164
2020-02-06,전남,경남,5310,281,483,378,1529,215,8196,5186,274,489,429,1516,240,8134
2020-02-06,전남,경북,878,42,84,84,517,23,1628,854,46,77,115,423,23,1538
2020-02-06,전남,광주,28233,928,985,688,1773,1112,33719,29268,918,1177,751,1839,1159,35112
2020-02-06,전남,대구,438,14,45,27,67,11,602,416,8,59,23,46,12,564
2020-02-06,전남,대전,237,8,17,18,21,3,304,250,9,7,39,34,7,346
2020-02-06,전남,부산,1710,75,128,150,596,57,2716,1758,79,132,195,574,55,2793
2020-02-06,전남,서울,662,3,30,52,39,23,809,723,11,18,45,34,18,849
2020-02-06,전남,세종,140,5,1,7,6,2,161,151,3,2,8,15,7,186
2020-02-06,전남,울산,200,18,18,19,44,3,302,176,11,26,21,30,7,271
2020-02-06,전남,전남,40570,1254,1490,1453,4450,1607,50824,40570,1254,1490,1453,4450,1607,50824
2020-02-06,전남,전북,4046,272,527,528,1224,110,6707,4021,241,455,527,1191,136,6571
2020-02-06,전남,충남,3720,100,460,649,1227,95,6251,3758,79,450,547,1026,97,5957
2020-02-06,전남,충북,338,12,27,89,243,16,725,358,16,44,95,242,8,763
2020-02-06,전북,강원,120,2,13,21,12,4,172,109,1,10,16,14,4,154
2020-02-06,전북,경기,1099,49,162,159,191,29,1689,1138,59,162,139,192,29,1719
2020-02-06,전북,경남,1012,46,128,106,164,36,1492,1041,35,118,114,154,27,1489
2020-02-06,전북,경북,1432,98,186,157,236,38,2147,1540,88,190,183,250,50,2301
2020-02-06,전북,광주,6861,442,481,312,383,296,8775,6935,418,540,374,386,287,8940
2020-02-06,전북,대구,331,18,43,19,32,3,446,317,16,43,18,18,6,418
2020-02-06,전북,대전,2817,96,81,86,41,133,3254,2799,81,79,78,38,143,3218
2020-02-06,전북,부산,260,12,34,51,73,3,433,283,14,39,48,91,9,484
2020-02-06,전북,서울,959,24,49,43,25,25,1125,1031,21,54,34,18,32,1190
2020-02-06,전북,세종,514,11,21,20,24,19,609,597,21,26,22,18,25,709
2020-02-06,전북,울산,34,0,9,3,3,0,49,45,1,8,2,14,1,71
2020-02-06,전북,전남,4021,241,455,527,1191,136,6571,4046,272,527,528,1224,110,6707
2020-02-06,전북,전북,15025,544,950,815,727,574,18635,15025,544,950,815,727,574,18635
2020-02-06,전북,충남,11730,482,1531,1065,1406,403,16617,11560,466,1457,922,1343,380,16128
2020-02-06,전북,충북,1565,113,174,275,225,52,2404,1583,121,201,264,224,47,2440
2020-02-06,충남,강원,403,9,25,41,77,15,570,281,5,14,19,32,10,361
2020-02-06,충남,경기,33208,1459,2706,2291,4088,1692,45444,33480,1516,2791,2422,4493,1752,46454
2020-02-06,충남,경남,1539,63,171,344,501,45,2663,1119,52,119,257,235,34,1816
2020-02-06,충남,경북,3099,110,331,487,773,122,4922,2916,139,356,560,603,90,4664
2020-02-06,충남,광주,3420,113,546,547,426,87,5139,3521,108,548,447,277,101,5002
2020-02-06,충남,대구,1078,58,114,158,201,25,1634,1307,67,150,202,259,39,2024
2020-02-06,충남,대전,13863,409,461,236,225,1068,16262,15373,454,507,242,207,1181,17964
2020-02-06,충남,부산,132,11,16,89,181,9,438,122,17,29,63,139,4,374
2020-02-06,충남,서울,23046,583,2290,1259,1125,879,29182,22169,477,2249,799,781,843,27318
2020-02-06,충남,세종,4131,129,146,111,144,207,4868,5513,157,149,96,162,288,6365
2020-02-06,충남,울산,114,7,19,31,104,0,275,97,5,20,41,113,1,277
2020-02-06,충남,전남,3758,79,450,547,1026,97,5957,3720,100,460,649,1227,95,6251
2020-02-06,충남,전북,11560,466,1457,922,1343,380,16128,11730,482,1531,1065,1406,403,16617
2020-02-06,충남,충남,88692,3477,7851,6689,10150,4244,121103,88692,3477,7851,6689,10150,4244,121103
2020-02-06,충남,충북,12735,662,910,939,1431,712,17389,11584,636,892,829,1387,667,15995
2020-02-06,충북,강원,4285,185,262,212,281,270,5495,4231,206,295,215,331,271,5549
2020-02-06,충북,경기,23914,2070,2802,2814,3134,1097,35831,24635,2174,3010,3011,3010,1196,37036
2020-02-06,충북,경남,1251,66,215,438,633,38,2641,928,52,135,285,287,26,1713
2020-02-06,충북,경북,4353,246,511,640,1004,168,6922,4557,243,517,658,918,165,7058
2020-02-06,충북,광주,545,34,83,151,93,9,915,469,24,66,98,57,8,722
2020-02-06,충북,대구,1216,74,158,227,149,40,1864,1641,95,223,258,393,51,2661
2020-02-06,충북,대전,9309,379,409,165,94,765,11121,10311,448,448,201,124,785,12317
2020-02-06,충북,부산,99,11,21,121,167,2,421,93,12,25,80,215,0,425
2020-02-06,충북,서울,11891,626,1128,759,686,459,15549,11931,518,1115,707,655,469,15395
2020-02-06,충북,세종,323,13,16,14,17,19,402,335,17,17,21,10,24,424
2020-02-06,충북,울산,17,2,2,11,36,0,68,25,2,6,21,44,1,99
2020-02-06,충북,전남,358,16,44,95,242,8,763,338,12,27,89,243,16,725
2020-02-06,충북,전북,1583,121,201,264,224,47,2440,1565,113,174,275,225,52,2404
2020-02-06,충북,충남,11584,636,892,829,1387,667,15995,12735,662,910,939,1431,712,17389
2020-02-06,충북,충북,34208,1877,2346,2023,2535,2106,45095,34208,1877,2346,2023,2535,2106,45095
2020-02-07,강원,강원,69708,2145,3045,1251,2216,4494,82859,69708,2145,3045,1251,2216,4494,82859
2020-02-07,강원,경기,19391,567,1235,595,646,1030,23464,26250,604,1310,634,797,1192,30787
2020-02-07,강원,경남,209,1,14,16,28,7,275,135,0,6,29,12,3,185
2020-02-07,강원,경북,550,19,39,22,34,34,698,511,14,32,32,26,26,641
2020-02-07,강원,광주,97,1,20,4,14,1,137,97,0,12,20,9,1,139
2020-02-07,강원,대구,265,4,16,12,9,5,311,383,6,21,17,12,14,453
2020-02-07,강원,대전,200,3,27,3,5,13,251,218,5,34,5,0,9,271
2020-02-07,강원,부산,6,0,0,1,2,0,9,4,0,1,1,0,0,6
2020-02-07,강원,서울,703,12,312,12,22,26,1087,972,13,271,11,9,34,1310
2020-02-07,강원,세종,5,0,0,0,0,0,5,16,0,0,0,0,0,16
2020-02-07,강원,울산,0,0,0,0,1,0,1,2,0,0,0,0,0,2
2020-02-07,강원,전남,64,1,3,14,7,1,90,75,1,4,10,12,2,104
2020-02-07,강원,전북,154,5,18,20,11,10,218,189,7,11,11,22,10,250
2020-02-07,강원,충남,410,10,27,19,31,19,516,622,12,28,36,63,34,795
2020-02-07,강원,충북,5056,198,265,222,348,310,6399,5492,184,238,204,324,307,6749
2020-02-07,경기,강원,26250,604,1310,634,797,1192,30787,19391,567,1235,595,646,1030,23464
2020-02-07,경기,경기,430207,22633,25345,18676,23142,32432,552435,430207,22633,25345,18676,23142,32432,552435
2020-02-07,경기,경남,3494,102,357,713,611,139,5416,2420,87,281,507,382,78,3755
2020-02-07,경기,경북,5190,164,537,715,560,179,7345,5028,201,487,877,534,171,7298
2020-02-07,경기,광주,1103,39,168,301,141,24,1776,861,28,132,247,93,17,1378
2020-02-07,경기,대구,2817,112,209,388,245,91,3862,3274,119,244,456,447,96,4636
2020-02-07,경기,대전,2750,100,213,117,58,133,3371,2109,106,200,100,47,93,2655
2020-02-07,경기,부산,245,16,48,222,120,14,665,305,26,42,152,232,7,764
2020-02-07,경기,서울,152389,7230,9430,4878,3450,10481,187858,143050,6902,9572,4672,3028,10039,177263
2020-02-07,경기,세종,38,6,1,2,2,2,51,57,4,4,0,2,4,71
2020-02-07,경기,울산,49,5,1,14,22,3,94,52,4,8,28,74,2,168
2020-02-07,경기,전남,923,15,99,145,132,27,1341,871,23,74,131,125,25,1249
2020-02-07,경기,전북,1888,43,165,124,213,55,2488,1537,38,156,156,175,54,2116
2020-02-07,경기,충남,38913,1533,2869,2506,4402,2012,52235,41282,1466,2723,2350,4242,2133,54196
2020-02-07,경기,충북,30130,2207,2960,2976,3142,1622,43037,29351,2145,2791,2697,3304,1508,41796
2020-02-07,경남,강원,135,0,6,29,12,3,185,209,1,14,16,28,7,275
2020-02-07,경남,경기,2420,87,281,507,382,78,3755,3494,102,357,713,611,139,5416
2020-02-07,경남,경남,201517,10004,10160,6944,13192,15637,257454,201517,10004,10160,6944,13192,15637,257454
2020-02-07,경남,경북,11349,608,972,874,1824,534,16161,14831,850,1219,1271,2668,686,21525
2020-02-07,경남,광주,1328,42,145,164,126,46,1851,1183,45,154,166,97,39,1684
2020-02-07,경남,대구,15087,715,1014,1001,1467,624,19908,11587,513,769,389,478,499,14235
2020-02-07,경남,대전,996,18,94,77,53,33,1271,1221,26,113,113,67,49,1589
2020-02-07,경남,부산,93291,2616,3089,1869,4485,6526,111876,88910,2683,3207,1847,4706,6389,107742
2020-02-07,경남,서울,2009,40,475,254,119,54,2951,2729,38,492,163,112,83,3617
2020-02-07,경남,세종,266,4,14,12,7,11,314,341,2,26,12,17,10,408
2020-02-07,경남,울산,11101,615,628,431,571,670,14016,10737,536,669,384,594,655,13575
2020-02-07,경남,전남,6046,248,446,487,1462,276,8965,6863,293,487,410,1471,329,9853
2020-02-07,경남,전북,1456,53,120,79,152,48,1908,1470,50,136,90,169,42,1957
2020-02-07,경남,충남,1365,50,130,231,238,52,2066,2418,65,169,319,526,101,3598
2020-02-07,경남,충북,1253,43,143,274,276,48,2037,1938,71,200,462,644,68,3383
2020-02-07,경북,강원,511,14,32,32,26,26,641,550,19,39,22,34,34,698
2020-02-07,경북,경기,5028,201,487,877,534,171,7298,5190,164,537,715,560,179,7345
2020-02-07,경북,경남,14831,850,1219,1271,2668,686,21525,11349,608,972,874,1824,534,16161
2020-02-07,경북,경북,78423,3711,3988,2674,4498,4221,97515,78423,3711,3988,2674,4498,4221,97515
2020-02-07,경북,광주,1076,55,114,179,110,30,1564,845,38,104,174,79,26,1266
2020-02-07,경북,대구,77769,2825,2904,1547,3290,4229,92564,77245,3009,3232,1864,3714,4180,93244
2020-02-07,경북,대전,2154,73,125,110,106,82,2650,1915,39,133,119,88,78,2372
2020-02-07,경북,부산,5204,115,309,181,592,233,6634,4726,133,354,225,716,205,6359
2020-02-07,경북,서울,2972,89,354,330,151,105,4001,3316,77,332,228,119,102,4174
2020-02-07,경북,세종,367,6,24,21,13,16,447,346,6,17,13,14,17,413
2020-02-07,경북,울산,5470,159,306,430,992,295,7652,5632,136,319,336,1230,313,7966
2020-02-07,경북,전남,1122,48,77,108,390,34,1779,1179,50,78,98,507,29,1941
2020-02-07,경북,전북,1926,93,180,193,249,81,2722,1741,94,166,153,233,40,2427
2020-02-07,경북,충남,3364,147,346,507,591,129,5084,4197,134,362,446,785,179,6103
2020-02-07,경북,충북,5797,210,508,653,981,230,8379,5691,232,558,589,1053,241,8364
2020-02-07,광주,강원,97,0,12,20,9,1,139,97,1,20,4,14,1,137
2020-02-07,광주,경기,861,28,132,247,93,17,1378,1103,39,168,301,141,24,1776
2020-02-07,광주,경남,1183,45,154,166,97,39,1684,1328,42,145,164,126,46,1851
2020-02-07,광주,경북,845,38,104,174,79,26,1266,1076,55,114,179,110,30,1564
2020-02-07,광주,광주,12671,480,636,408,284,530,15009,12671,480,636,408,284,530,15009
2020-02-07,광주,대구,757,26,104,79,31,20,1017,685,28,101,74,34,17,939
2020-02-07,광주,대전,517,19,19,36,12,9,612,520,22,22,46,17,13,640
2020-02-07,광주,부산,486,6,31,31,59,9,622,530,16,48,76,101,12,783
2020-02-07,광주,서울,676,24,24,65,21,24,834,972,19,19,39,28,23,1100
2020-02-07,광주,세종,149,2,9,3,5,2,170,222,2,8,8,2,2,244
2020-02-07,광주,울산,40,0,7,0,1,1,49,68,1,5,8,7,2,91
2020-02-07,광주,전남,31743,935,1134,731,2036,1276,37855,32376,920,1031,666,1985,1310,38288
2020-02-07,광주,전북,7532,411,536,362,319,292,9452,8075,430,473,320,373,288,9959
2020-02-07,광주,충남,4355,106,600,414,244,127,5846,4939,127,591,548,359,128,6692
2020-02-07,광주,충북,598,33,65,115,56,18,885,790,31,85,156,101,30,1193
2020-02-07,대구,강원,383,6,21,17,12,14,453,265,4,16,12,9,5,311
2020-02-07,대구,경기,3274,119,244,456,447,96,4636,2817,112,209,388,245,91,3862
2020-02-07,대구,경남,11587,513,769,389,478,499,14235,15087,715,1014,1001,1467,624,19908
2020-02-07,대구,경북,77245,3009,3232,1864,3714,4180,93244,77769,2825,2904,1547,3290,4229,92564
2020-02-07,대구,광주,685,28,101,74,34,17,939,757,26,104,79,31,20,1017
2020-02-07,대구,대구,61759,2124,1886,824,1442,4078,72113,61759,2124,1886,824,1442,4078,72113
2020-02-07,대구,대전,1103,27,59,79,44,35,1347,863,24,38,45,28,37,1035
2020-02-07,대구,부산,699,53,104,60,111,28,1055,2920,94,227,90,199,120,3650
2020-02-07,대구,서울,2712,72,181,219,111,85,3380,2064,65,136,118,44,56,2483
2020-02-07,대구,세종,322,5,15,4,12,10,368,245,2,5,6,2,9,269
2020-02-07,대구,울산,1437,55,157,71,150,65,1935,1752,56,135,69,178,76,2266
2020-02-07,대구,전남,501,14,34,49,49,14,661,665,24,49,28,74,13,853
2020-02-07,대구,전북,409,12,42,20,21,9,513,463,10,47,20,22,15,577
2020-02-07,대구,충남,1431,71,135,210,242,42,2131,1724,49,118,158,221,70,2340
2020-02-07,대구,충북,1912,80,210,253,405,61,2921,1842,84,144,218,128,61,2477
2020-02-07,대전,강원,218,5,34,5,0,9,271,200,3,27,3,5,13,251
2020-02-07,대전,경기,2109,106,200,100,47,93,2655,2750,100,213,117,58,133,3371
2020-02-07,대전,경남,1221,26,113,113,67,49,1589,996,18,94,77,53,33,1271
2020-02-07,대전,경북,1915,39,133,119,88,78,2372,2154,73,125,110,106,82,2650
2020-02-07,대전,광주,520,22,22,46,17,13,640,517,19,19,36,12,9,612
2020-02-07,대전,대구,863,24,38,45,28,37,1035,1103,27,59,79,44,35,1347
2020-02-07,대전,대전,14025,405,440,224,255,1100,16449,14025,405,440,224,255,1100,16449
2020-02-07,대전,부산,85,2,8,14,20,2,131,104,3,3,18,17,2,147
2020-02-07,대전,서울,1873,47,191,34,9,88,2242,2040,45,208,50,16,89,2448
2020-02-07,대전,세종,3530,97,83,34,73,277,4094,3610,96,88,33,65,283,4175
2020-02-07,대전,울산,95,3,11,11,17,3,140,154,4,12,12,25,7,214
2020-02-07,대전,전남,284,5,7,35,32,6,369,363,9,13,27,22,7,441
2020-02-07,대전,전북,3219,81,94,83,53,144,3674,3362,76,98,68,42,131,3777
2020-02-07,대전,충남,16261,442,531,227,211,1217,18889,15707,419,484,207,215,1175,18207
2020-02-07,대전,충북,10950,454,455,205,144,898,13106,10307,391,406,167,158,830,12259
2020-02-07,부산,강원,4,0,1,1,0,0,6,6,0,0,1,2,0,9
2020-02-07,부산,경기,305,26,42,152,232,7,764,245,16,48,222,120,14,665
2020-02-07,부산,경남,88910,2683,3207,1847,4706,6389,107742,93291,2616,3089,1869,4485,6526,111876
2020-02-07,부산,경북,4726,133,354,225,716,205,6359,5204,115,309,181,592,233,6634
2020-02-07,부산,광주,530,16,48,76,101,12,783,486,6,31,31,59,9,622
2020-02-07,부산,대구,2920,94,227,90,199,120,3650,699,53,104,60,111,28,1055
2020-02-07,부산,대전,104,3,3,18,17,2,147,85,2,8,14,20,2,131
2020-02-07,부산,부산,43635,731,710,880,1871,3169,50996,43635,731,710,880,1871,3169,50996
2020-02-07,부산,서울,240,13,21,71,78,4,427,221,16,12,59,35,2,345
2020-02-07,부산,세종,26,0,0,5,8,2,41,21,0,2,3,4,1,31
2020-02-07,부산,울산,16935,386,456,651,2532,1158,22118,18877,420,448,418,2337,1280,23780
2020-02-07,부산,전남,2266,85,149,169,588,72,3329,2083,89,125,119,623,80,3119
2020-02-07,부산,전북,398,11,34,38,88,5,574,322,9,36,44,70,11,492
2020-02-07,부산,충남,164,9,21,50,142,1,387,180,14,23,65,174,1,457
2020-02-07,부산,충북,134,11,22,79,173,3,422,127,10,20,104,173,2,436
2020-02-07,서울,강원,972,13,271,11,9,34,1310,703,12,312,12,22,26,1087
2020-02-07,서울,경기,143050,6902,9572,4672,3028,10039,177263,152389,7230,9430,4878,3450,10481,187858
2020-02-07,서울,경남,2729,38,492,163,112,83,3617,2009,40,475,254,119,54,2951
2020-02-07,서울,경북,3316,77,332,228,119,102,4174,2972,89,354,330,151,105,4001
2020-02-07,서울,광주,972,19,19,39,28,23,1100,676,24,24,65,21,24,834
2020-02-07,서울,대구,2064,65,136,118,44,56,2483,2712,72,181,219,111,85,3380
2020-02-07,서울,대전,2040,45,208,50,16,89,2448,1873,47,191,34,9,88,2242
2020-02-07,서울,부산,221,16,12,59,35,2,345,240,13,21,71,78,4,427
2020-02-07,서울,서울,219,6,8,2,2,13,250,219,6,8,2,2,13,250
2020-02-07,서울,세종,36,0,1,0,0,2,39,48,3,0,0,0,3,54
2020-02-07,서울,울산,24,0,2,2,0,2,30,28,0,3,10,15,2,58
2020-02-07,서울,전남,976,19,22,31,27,32,1107,868,14,24,58,38,21,1023
2020-02-07,서울,전북,1603,12,43,24,30,52,1764,1303,22,47,28,30,44,1474
2020-02-07,서울,충남,26802,542,2378,773,787,1060,32342,28794,611,2411,1133,1119,1123,35191
2020-02-07,서울,충북,13921,507,1152,757,720,651,17708,15080,625,1166,788,842,643,19144
2020-02-07,세종,강원,16,0,0,0,0,0,16,5,0,0,0,0,0,5
2020-02-07,세종,경기,57,4,4,0,2,4,71,38,6,1,2,2,2,51
2020-02-07,세종,경남,341,2,26,12,17,10,408,266,4,14,12,7,11,314
2020-02-07,세종,경북,346,6,17,13,14,17,413,367,6,24,21,13,16,447
2020-02-07,세종,광주,222,2,8,8,2,2,244,149,2,9,3,5,2,170
2020-02-07,세종,대구,245,2,5,6,2,9,269,322,5,15,4,12,10,368
2020-02-07,세종,대전,3610,96,88,33,65,283,4175,3530,97,83,34,73,277,4094
2020-02-07,세종,부산,21,0,2,3,4,1,31,26,0,0,5,8,2,41
2020-02-07,세종,서울,48,3,0,0,0,3,54,36,0,1,0,0,2,39
2020-02-07,세종,세종,266,19,2,7,3,22,319,266,19,2,7,3,22,319
2020-02-07,세종,울산,15,0,0,6,2,0,23,16,0,0,1,15,3,35
2020-02-07,세종,전남,203,3,4,10,13,11,244,238,1,6,3,12,6,266
2020-02-07,세종,전북,800,21,22,10,40,37,930,777,17,17,16,44,35,906
2020-02-07,세종,충남,6008,158,150,106,127,326,6875,5232,136,161,117,143,260,6049
2020-02-07,세종,충북,359,9,17,10,12,15,422,318,15,20,6,12,30,401
2020-02-07,울산,강원,2,0,0,0,0,0,2,0,0,0,0,1,0,1
2020-02-07,울산,경기,52,4,8,28,74,2,168,49,5,1,14,22,3,94
2020-02-07,울산,경남,10737,536,669,384,594,655,13575,11101,615,628,431,571,670,14016
2020-02-07,울산,경북,5632,136,319,336,1230,313,7966,5470,159,306,430,992,295,7652
2020-02-07,울산,광주,68,1,5,8,7,2,91,40,0,7,0,1,1,49
2020-02-07,울산,대구,1752,56,135,69,178,76,2266,1437,55,157,71,150,65,1935
2020-02-07,울산,대전,154,4,12,12,25,7,214,95,3,11,11,17,3,140
2020-02-07,울산,부산,18877,420,448,418,2337,1280,23780,16935,386,456,651,2532,1158,22118
2020-02-07,울산,서울,28,0,3,10,15,2,58,24,0,2,2,0,2,30
2020-02-07,울산,세종,16,0,0,1,15,3,35,15,0,0,6,2,0,23
2020-02-07,울산,울산,8621,273,461,257,637,759,11008,8621,273,461,257,637,759,11008
2020-02-07,울산,전남,224,16,25,9,16,7,297,257,12,19,8,38,7,341
2020-02-07,울산,전북,54,1,8,3,18,1,85,51,1,6,4,4,1,67
2020-02-07,울산,충남,144,7,13,51,104,2,321,183,11,14,42,108,3,361
2020-02-07,울산,충북,23,2,2,22,53,2,104,20,1,5,20,32,0,78
2020-02-07,전남,강원,75,1,4,10,12,2,104,64,1,3,14,7,1,90
2020-02-07,전남,경기,871,23,74,131,125,25,1249,923,15,99,145,132,27,1341
2020-02-07,전남,경남,6863,293,487,410,1471,329,9853,6046,248,446,487,1462,276,8965
2020-02-07,전남,경북,1179,50,78,98,507,29,1941,1122,48,77,108,390,34,1779
2020-02-07,전남,광주,32376,920,1031,666,1985,1310,38288,31743,935,1134,731,2036,1276,37855
2020-02-07,전남,대구,665,24,49,28,74,13,853,501,14,34,49,49,14,661
2020-02-07,전남,대전,363,9,13,27,22,7,441,284,5,7,35,32,6,369
2020-02-07,전남,부산,2083,89,125,119,623,80,3119,2266,85,149,169,588,72,3329
2020-02-07,전남,서울,868,14,24,58,38,21,1023,976,19,22,31,27,32,1107
2020-02-07,전남,세종,238,1,6,3,12,6,266,203,3,4,10,13,11,244
2020-02-07,전남,울산,257,12,19,8,38,7,341,224,16,25,9,16,7,297
2020-02-07,전남,전남,46448,1304,1584,1467,4410,1911,57124,46448,1304,1584,1467,4410,1911,57124
2020-02-07,전남,전북,5213,252,492,547,1248,163,7915,4677,198,421,590,1177,162,7225
2020-02-07,전남,충남,5003,107,417,592,1033,156,7308,5404,99,446,495,969,144,7557
2020-02-07,전남,충북,444,17,28,68,239,9,805,461,21,46,103,267,14,912
2020-02-07,전북,강원,189,7,11,11,22,10,250,154,5,18,20,11,10,218
2020-02-07,전북,경기,1537,38,156,156,175,54,2116,1888,43,165,124,213,55,2488
2020-02-07,전북,경남,1470,50,136,90,169,42,1957,1456,53,120,79,152,48,1908
2020-02-07,전북,경북,1741,94,166,153,233,40,2427,1926,93,180,193,249,81,2722
2020-02-07,전북,광주,8075,430,473,320,373,288,9959,7532,411,536,362,319,292,9452
2020-02-07,전북,대구,463,10,47,20,22,15,577,409,12,42,20,21,9,513
2020-02-07,전북,대전,3362,76,98,68,42,131,3777,3219,81,94,83,53,144,3674
2020-02-07,전북,부산,322,9,36,44,70,11,492,398,11,34,38,88,5,574
2020-02-07,전북,서울,1303,22,47,28,30,44,1474,1603,12,43,24,30,52,1764
2020-02-07,전북,세종,777,17,17,16,44,35,906,800,21,22,10,40,37,930
2020-02-07,전북,울산,51,1,6,4,4,1,67,54,1,8,3,18,1,85
2020-02-07,전북,전남,4677,198,421,590,1177,162,7225,5213,252,492,547,1248,163,7915
2020-02-07,전북,전북,16210,574,937,801,719,601,19842,16210,574,937,801,719,601,19842
2020-02-07,전북,충남,14822,494,1520,1077,1319,507,19739,15832,480,1480,909,1327,542,20570
2020-02-07,전북,충북,2012,118,163,257,242,66,2858,2137,120,190,268,244,68,3027
2020-02-07,충남,강원,622,12,28,36,63,34,795,410,10,27,19,31,19,516
2020-02-07,충남,경기,41282,1466,2723,2350,4242,2133,54196,38913,1533,2869,2506,4402,2012,52235
2020-02-07,충남,경남,2418,65,169,319,526,101,3598,1365,50,130,231,238,52,2066
2020-02-07,충남,경북,4197,134,362,446,785,179,6103,3364,147,346,507,591,129,5084
2020-02-07,충남,광주,4939,127,591,548,359,128,6692,4355,106,600,414,244,127,5846
2020-02-07,충남,대구,1724,49,118,158,221,70,2340,1431,71,135,210,242,42,2131
2020-02-07,충남,대전,15707,419,484,207,215,1175,18207,16261,442,531,227,211,1217,18889
2020-02-07,충남,부산,180,14,23,65,174,1,457,164,9,21,50,142,1,387
2020-02-07,충남,서울,28794,611,2411,1133,1119,1123,35191,26802,542,2378,773,787,1060,32342
2020-02-07,충남,세종,5232,136,161,117,143,260,6049,6008,158,150,106,127,326,6875
2020-02-07,충남,울산,183,11,14,42,108,3,361,144,7,13,51,104,2,321
2020-02-07,충남,전남,5404,99,446,495,969,144,7557,5003,107,417,592,1033,156,7308
2020-02-07,충남,전북,15832,480,1480,909,1327,542,20570,14822,494,1520,1077,1319,507,19739
2020-02-07,충남,충남,104119,3441,7971,6578,9892,5102,137103,104119,3441,7971,6578,9892,5102,137103
2020-02-07,충남,충북,14183,664,891,898,1400,818,18854,12691,610,858,799,1377,717,17052
2020-02-07,충북,강원,5492,184,238,204,324,307,6749,5056,198,265,222,348,310,6399
2020-02-07,충북,경기,29351,2145,2791,2697,3304,1508,41796,30130,2207,2960,2976,3142,1622,43037
2020-02-07,충북,경남,1938,71,200,462,644,68,3383,1253,43,143,274,276,48,2037
2020-02-07,충북,경북,5691,232,558,589,1053,241,8364,5797,210,508,653,981,230,8379
2020-02-07,충북,광주,790,31,85,156,101,30,1193,598,33,65,115,56,18,885
2020-02-07,충북,대구,1842,84,144,218,128,61,2477,1912,80,210,253,405,61,2921
2020-02-07,충북,대전,10307,391,406,167,158,830,12259,10950,454,455,205,144,898,13106
2020-02-07,충북,부산,127,10,20,104,173,2,436,134,11,22,79,173,3,422
2020-02-07,충북,서울,15080,625,1166,788,842,643,19144,13921,507,1152,757,720,651,17708
2020-02-07,충북,세종,318,15,20,6,12,30,401,359,9,17,10,12,15,422
2020-02-07,충북,울산,20,1,5,20,32,0,78,23,2,2,22,53,2,104
2020-02-07,충북,전남,461,21,46,103,267,14,912,444,17,28,68,239,9,805
2020-02-07,충북,전북,2137,120,190,268,244,68,3027,2012,118,163,257,242,66,2858
2020-02-07,충북,충남,12691,610,858,799,1377,717,17052,14183,664,891,898,1400,818,18854
2020-02-07,충북,충북,37358,1945,2233,2017,2716,2156,48425,37358,1945,2233,2017,2716,2156,48425
2020-02-08,강원,강원,86492,1356,2538,716,1600,4643,97345,86492,1356,2538,716,1600,4643,97345
2020-02-08,강원,경기,28524,289,1057,300,403,1230,31803,39694,335,1062,354,472,1687,43604
2020-02-08,강원,경남,202,2,20,10,6,5,245,143,1,13,11,11,4,183
2020-02-08,강원,경북,596,17,32,12,16,48,721,630,14,29,9,11,24,717
2020-02-08,강원,광주,112,1,19,4,1,2,139,95,2,14,7,2,3,123
2020-02-08,강원,대구,307,1,13,7,0,12,340,475,5,23,8,3,12,526
2020-02-08,강원,대전,218,4,30,4,1,5,262,286,4,29,2,0,11,332
2020-02-08,강원,부산,5,0,0,1,0,2,8,2,0,2,0,0,0,4
2020-02-08,강원,서울,833,6,339,4,10,40,1232,1499,10,308,7,4,58,1886
2020-02-08,강원,세종,1,0,0,1,0,0,2,7,0,0,1,2,1,11
2020-02-08,강원,울산,2,0,0,0,0,0,2,1,0,0,0,0,0,1
2020-02-08,강원,전남,42,1,1,3,5,2,54,57,0,1,4,9,2,73
2020-02-08,강원,전북,140,3,6,5,3,2,159,190,3,6,14,4,5,222
2020-02-08,강원,충남,365,5,15,12,11,11,419,636,7,19,26,37,26,751
2020-02-08,강원,충북,5216,121,161,115,212,282,6107,6032,112,170,122,177,285,6898
2020-02-08,경기,강원,39694,335,1062,354,472,1687,43604,28524,289,1057,300,403,1230,31803
2020-02-08,경기,경기,347369,9829,12294,8021,13518,22753,413784,347369,9829,12294,8021,13518,22753,413784
2020-02-08,경기,경남,3233,44,317,456,313,105,4468,1903,24,215,235,174,69,2620
2020-02-08,경기,경북,5894,59,297,400,314,213,7177,4336,56,242,385,265,168,5452
2020-02-08,경기,광주,960,15,134,165,55,23,1352,705,8,90,114,29,25,971
2020-02-08,경기,대구,2585,41,156,219,142,89,3232,2826,40,163,242,171,81,3523
2020-02-08,경기,대전,3194,52,185,88,31,145,3695,2641,40,182,50,29,111,3053
2020-02-08,경기,부산,270,16,41,107,84,5,523,264,6,16,95,94,9,484
2020-02-08,경기,서울,126708,4028,5531,2615,2437,7530,148849,122769,3462,5467,2045,2031,7435,143209
2020-02-08,경기,세종,47,1,1,0,1,4,54,52,3,3,1,0,0,59
2020-02-08,경기,울산,31,0,2,5,8,2,48,39,0,1,12,41,2,95
2020-02-08,경기,전남,1119,12,86,78,90,26,1411,816,14,63,84,58,19,1054
2020-02-08,경기,전북,2247,27,141,55,85,70,2625,1586,27,114,74,87,48,1936
2020-02-08,경기,충남,40586,680,1648,1036,2145,2013,48108,38191,633,1636,1025,2179,1900,45564
2020-02-08,경기,충북,30735,919,1407,1358,1823,1497,37739,27606,880,1305,1209,2085,1351,34436
2020-02-08,경남,강원,143,1,13,11,11,4,183,202,2,20,10,6,5,245
2020-02-08,경남,경기,1903,24,215,235,174,69,2620,3233,44,317,456,313,105,4468
2020-02-08,경남,경남,183449,5427,5606,3867,7988,12555,218892,183449,5427,5606,3867,7988,12555,218892
2020-02-08,경남,경북,14827,270,572,431,883,712,17695,17379,365,702,568,1178,788,20980
2020-02-08,경남,광주,1308,24,106,94,59,34,1625,1475,21,87,73,32,42,1730
2020-02-08,경남,대구,16718,352,730,447,656,774,19677,14453,259,584,199,244,645,16384
2020-02-08,경남,대전,1045,9,84,24,17,45,1224,1473,18,101,75,34,51,1752
2020-02-08,경남,부산,91822,1433,2173,1021,2254,5873,104576,87889,1433,2102,930,2278,5641,100273
2020-02-08,경남,서울,1849,22,470,98,56,45,2540,2974,27,545,136,66,75,3823
2020-02-08,경남,세종,190,0,7,3,3,9,212,334,1,15,3,7,15,375
2020-02-08,경남,울산,11342,312,371,157,283,702,13167,11188,303,391,156,251,615,12904
2020-02-08,경남,전남,6849,160,294,241,805,283,8632,6844,141,284,220,870,292,8651
2020-02-08,경남,전북,2029,19,88,48,79,65,2328,1702,30,81,54,90,53,2010
2020-02-08,경남,충남,1218,14,70,66,68,43,1479,2081,25,104,177,259,71,2717
2020-02-08,경남,충북,1355,17,83,105,159,60,1779,1911,30,142,255,332,71,2741
2020-02-08,경북,강원,630,14,29,9,11,24,717,596,17,32,12,16,48,721
2020-02-08,경북,경기,4336,56,242,385,265,168,5452,5894,59,297,400,314,213,7177
2020-02-08,경북,경남,17379,365,702,568,1178,788,20980,14827,270,572,431,883,712,17695
2020-02-08,경북,경북,79282,1940,2532,1482,2924,4017,92177,79282,1940,2532,1482,2924,4017,92177
2020-02-08,경북,광주,825,16,82,85,47,24,1079,875,19,55,81,24,26,1080
2020-02-08,경북,대구,72314,1642,1896,914,2311,3639,82716,77819,1658,2046,1042,2382,3924,88871
2020-02-08,경북,대전,2357,29,90,44,39,136,2695,2534,31,86,88,38,130,2907
2020-02-08,경북,부산,6982,63,290,65,218,320,7938,7868,67,318,90,206,361,8910
2020-02-08,경북,서울,3010,50,315,145,92,102,3714,4353,39,330,124,81,161,5088
2020-02-08,경북,세종,335,0,7,11,12,18,383,421,4,14,5,8,20,472
2020-02-08,경북,울산,6642,64,193,224,609,364,8096,7106,68,171,142,801,390,8678
2020-02-08,경북,전남,1322,20,52,53,231,35,1713,1248,25,44,49,277,35,1678
2020-02-08,경북,전북,1904,47,113,76,158,73,2371,1689,60,108,54,142,44,2097
2020-02-08,경북,충남,3419,51,126,187,298,129,4210,4247,45,162,181,372,166,5173
2020-02-08,경북,충북,6479,106,305,268,470,243,7871,6755,102,314,312,605,258,8346
2020-02-08,광주,강원,95,2,14,7,2,3,123,112,1,19,4,1,2,139
2020-02-08,광주,경기,705,8,90,114,29,25,971,960,15,134,165,55,23,1352
2020-02-08,광주,경남,1475,21,87,73,32,42,1730,1308,24,106,94,59,34,1625
2020-02-08,광주,경북,875,19,55,81,24,26,1080,825,16,82,85,47,24,1079
2020-02-08,광주,광주,10830,314,463,180,243,422,12452,10830,314,463,180,243,422,12452
2020-02-08,광주,대구,641,17,74,36,11,15,794,634,12,88,29,6,15,784
2020-02-08,광주,대전,501,10,6,12,5,20,554,538,4,16,34,14,20,626
2020-02-08,광주,부산,591,3,49,12,19,16,690,496,8,50,35,25,18,632
2020-02-08,광주,서울,641,11,13,34,10,18,727,842,13,14,32,12,30,943
2020-02-08,광주,세종,168,1,2,0,3,3,177,254,1,2,1,1,7,266
2020-02-08,광주,울산,60,0,6,1,1,1,69,44,1,10,1,0,2,58
2020-02-08,광주,전남,32920,584,933,508,952,1254,37151,30987,579,832,460,1049,1123,35030
2020-02-08,광주,전북,7879,234,290,144,200,279,9026,7859,265,290,163,225,274,9076
2020-02-08,광주,충남,4470,43,543,197,126,129,5508,4634,57,554,316,218,156,5935
2020-02-08,광주,충북,575,8,36,42,12,15,688,661,12,39,78,49,16,855
2020-02-08,대구,강원,475,5,23,8,3,12,526,307,1,13,7,0,12,340
2020-02-08,대구,경기,2826,40,163,242,171,81,3523,2585,41,156,219,142,89,3232
2020-02-08,대구,경남,14453,259,584,199,244,645,16384,16718,352,730,447,656,774,19677
2020-02-08,대구,경북,77819,1658,2046,1042,2382,3924,88871,72314,1642,1896,914,2311,3639,82716
2020-02-08,대구,광주,634,12,88,29,6,15,784,641,17,74,36,11,15,794
2020-02-08,대구,대구,51536,1141,1079,491,907,3117,58271,51536,1141,1079,491,907,3117,58271
2020-02-08,대구,대전,1230,16,50,30,17,38,1381,912,14,31,36,9,39,1041
2020-02-08,대구,부산,887,20,79,42,52,31,1111,3789,42,207,33,76,164,4311
2020-02-08,대구,서울,2719,33,217,116,62,66,3213,2214,31,186,91,31,62,2615
2020-02-08,대구,세종,302,3,10,1,5,13,334,266,1,3,1,3,12,286
2020-02-08,대구,울산,1763,29,112,40,91,80,2115,1986,25,107,37,116,83,2354
2020-02-08,대구,전남,744,7,38,18,30,29,866,618,10,36,17,17,21,719
2020-02-08,대구,전북,496,5,39,4,17,12,573,457,5,32,2,8,15,519
2020-02-08,대구,충남,1581,26,89,66,84,55,1901,1359,18,62,73,85,58,1655
2020-02-08,대구,충북,2209,31,140,122,121,92,2715,1728,40,99,140,83,62,2152
2020-02-08,대전,강원,286,4,29,2,0,11,332,218,4,30,4,1,5,262
2020-02-08,대전,경기,2641,40,182,50,29,111,3053,3194,52,185,88,31,145,3695
2020-02-08,대전,경남,1473,18,101,75,34,51,1752,1045,9,84,24,17,45,1224
2020-02-08,대전,경북,2534,31,86,88,38,130,2907,2357,29,90,44,39,136,2695
2020-02-08,대전,광주,538,4,16,34,14,20,626,501,10,6,12,5,20,554
2020-02-08,대전,대구,912,14,31,36,9,39,1041,1230,16,50,30,17,38,1381
2020-02-08,대전,대전,11598,227,311,289,265,770,13460,11598,227,311,289,265,770,13460
2020-02-08,대전,부산,109,1,4,11,8,4,137,105,1,8,10,14,4,142
2020-02-08,대전,서울,2098,25,245,23,3,117,2511,2429,15,242,24,12,107,2829
2020-02-08,대전,세종,2900,71,51,14,43,223,3302,2896,78,45,23,60,220,3322
2020-02-08,대전,울산,112,1,10,11,8,0,142,118,0,9,3,13,5,148
2020-02-08,대전,전남,452,4,10,31,21,11,529,439,2,15,10,16,18,500
2020-02-08,대전,전북,4353,52,66,65,36,186,4758,4009,59,85,28,39,180,4400
2020-02-08,대전,충남,14376,237,332,118,153,914,16130,13834,237,337,94,170,878,15550
2020-02-08,대전,충북,10040,299,339,108,116,656,11558,9447,235,305,99,127,628,10841
2020-02-08,부산,강원,2,0,2,0,0,0,4,5,0,0,1,0,2,8
2020-02-08,부산,경기,264,6,16,95,94,9,484,270,16,41,107,84,5,523
2020-02-08,부산,경남,87889,1433,2102,930,2278,5641,100273,91822,1433,2173,1021,2254,5873,104576
2020-02-08,부산,경북,7868,67,318,90,206,361,8910,6982,63,290,65,218,320,7938
2020-02-08,부산,광주,496,8,50,35,25,18,632,591,3,49,12,19,16,690
2020-02-08,부산,대구,3789,42,207,33,76,164,4311,887,20,79,42,52,31,1111
2020-02-08,부산,대전,105,1,8,10,14,4,142,109,1,4,11,8,4,137
2020-02-08,부산,부산,48759,354,391,646,1001,2920,54071,48759,354,391,646,1001,2920,54071
2020-02-08,부산,서울,249,8,22,24,23,9,335,252,5,17,32,28,3,337
2020-02-08,부산,세종,17,0,0,2,0,1,20,29,2,0,0,0,1,32
2020-02-08,부산,울산,18654,192,220,223,1069,1159,21517,20406,175,181,168,1091,1325,23346
2020-02-08,부산,전남,2305,32,89,76,253,95,2850,2080,31,88,63,271,93,2626
2020-02-08,부산,전북,450,5,48,10,35,15,563,352,3,42,14,17,15,443
2020-02-08,부산,충남,169,5,16,18,39,6,253,175,0,9,37,79,4,304
2020-02-08,부산,충북,138,2,11,33,74,6,264,153,5,16,54,83,8,319
2020-02-08,서울,강원,1499,10,308,7,4,58,1886,833,6,339,4,10,40,1232
2020-02-08,서울,경기,122769,3462,5467,2045,2031,7435,143209,126708,4028,5531,2615,2437,7530,148849
2020-02-08,서울,경남,2974,27,545,136,66,75,3823,1849,22,470,98,56,45,2540
2020-02-08,서울,경북,4353,39,330,124,81,161,5088,3010,50,315,145,92,102,3714
2020-02-08,서울,광주,842,13,14,32,12,30,943,641,11,13,34,10,18,727
2020-02-08,서울,대구,2214,31,186,91,31,62,2615,2719,33,217,116,62,66,3213
2020-02-08,서울,대전,2429,15,242,24,12,107,2829,2098,25,245,23,3,117,2511
2020-02-08,서울,부산,252,5,17,32,28,3,337,249,8,22,24,23,9,335
2020-02-08,서울,서울,184,1,7,1,4,8,205,184,1,7,1,4,8,205
2020-02-08,서울,세종,49,0,0,1,0,1,51,25,0,0,0,0,3,28
2020-02-08,서울,울산,28,0,1,2,1,1,33,25,1,4,2,2,2,36
2020-02-08,서울,전남,1163,7,16,21,20,15,1242,900,12,13,27,10,28,990
2020-02-08,서울,전북,2001,8,47,9,19,48,2132,1403,10,37,10,12,39,1511
2020-02-08,서울,충남,31978,254,2210,436,428,1283,36589,30743,283,2171,543,667,1232,35639
2020-02-08,서울,충북,16174,184,983,381,332,716,18770,14947,228,987,424,497,652,17735
2020-02-08,세종,강원,7,0,0,1,2,1,11,1,0,0,1,0,0,2
2020-02-08,세종,경기,52,3,3,1,0,0,59,47,1,1,0,1,4,54
2020-02-08,세종,경남,334,1,15,3,7,15,375,190,0,7,3,3,9,212
2020-02-08,세종,경북,421,4,14,5,8,20,472,335,0,7,11,12,18,383
2020-02-08,세종,광주,254,1,2,1,1,7,266,168,1,2,0,3,3,177
2020-02-08,세종,대구,266,1,3,1,3,12,286,302,3,10,1,5,13,334
2020-02-08,세종,대전,2896,78,45,23,60,220,3322,2900,71,51,14,43,223,3302
2020-02-08,세종,부산,29,2,0,0,0,1,32,17,0,0,2,0,1,20
2020-02-08,세종,서울,25,0,0,0,0,3,28,49,0,0,1,0,1,51
2020-02-08,세종,세종,215,18,2,15,1,16,267,215,18,2,15,1,16,267
2020-02-08,세종,울산,7,0,0,0,1,1,9,12,0,1,0,2,0,15
2020-02-08,세종,전남,205,3,2,1,11,4,226,173,5,0,0,9,7,194
2020-02-08,세종,전북,1097,6,11,5,25,30,1174,872,6,11,9,21,27,946
2020-02-08,세종,충남,5958,106,93,47,73,309,6586,4478,101,75,44,81,210,4989
2020-02-08,세종,충북,295,10,9,11,10,18,353,292,13,11,11,13,21,361
2020-02-08,울산,강원,1,0,0,0,0,0,1,2,0,0,0,0,0,2
2020-02-08,울산,경기,39,0,1,12,41,2,95,31,0,2,5,8,2,48
2020-02-08,울산,경남,11188,303,391,156,251,615,12904,11342,312,371,157,283,702,13167
2020-02-08,울산,경북,7106,68,171,142,801,390,8678,6642,64,193,224,609,364,8096
2020-02-08,울산,광주,44,1,10,1,0,2,58,60,0,6,1,1,1,69
2020-02-08,울산,대구,1986,25,107,37,116,83,2354,1763,29,112,40,91,80,2115
2020-02-08,울산,대전,118,0,9,3,13,5,148,112,1,10,11,8,0,142
2020-02-08,울산,부산,20406,175,181,168,1091,1325,23346,18654,192,220,223,1069,1159,21517
2020-02-08,울산,서울,25,1,4,2,2,2,36,28,0,1,2,1,1,33
2020-02-08,울산,세종,12,0,1,0,2,0,15,7,0,0,0,1,1,9
2020-02-08,울산,울산,6243,113,157,137,346,526,7522,6243,113,157,137,346,526,7522
2020-02-08,울산,전남,254,8,9,4,9,1,285,263,9,8,6,11,9,306
2020-02-08,울산,전북,59,0,10,1,6,3,79,51,0,7,2,1,1,62
2020-02-08,울산,충남,146,1,10,10,32,3,202,130,2,8,18,37,4,199
2020-02-08,울산,충북,16,0,1,9,21,0,47,22,0,1,6,27,0,56
2020-02-08,전남,강원,57,0,1,4,9,2,73,42,1,1,3,5,2,54
2020-02-08,전남,경기,816,14,63,84,58,19,1054,1119,12,86,78,90,26,1411
2020-02-08,전남,경남,6844,141,284,220,870,292,8651,6849,160,294,241,805,283,8632
2020-02-08,전남,경북,1248,25,44,49,277,35,1678,1322,20,52,53,231,35,1713
2020-02-08,전남,광주,30987,579,832,460,1049,1123,35030,32920,584,933,508,952,1254,37151
2020-02-08,전남,대구,618,10,36,17,17,21,719,744,7,38,18,30,29,866
2020-02-08,전남,대전,439,2,15,10,16,18,500,452,4,10,31,21,11,529
2020-02-08,전남,부산,2080,31,88,63,271,93,2626,2305,32,89,76,253,95,2850
2020-02-08,전남,서울,900,12,13,27,10,28,990,1163,7,16,21,20,15,1242
2020-02-08,전남,세종,173,5,0,0,9,7,194,205,3,2,1,11,4,226
2020-02-08,전남,울산,263,9,8,6,11,9,306,254,8,9,4,9,1,285
2020-02-08,전남,전남,44992,829,1114,1074,2617,1640,52266,44992,829,1114,1074,2617,1640,52266
2020-02-08,전남,전북,6124,146,340,336,672,173,7791,6016,114,302,369,736,169,7706
2020-02-08,전남,충남,4661,47,321,222,345,118,5714,5911,50,386,267,449,179,7242
2020-02-08,전남,충북,474,10,23,40,114,12,673,521,4,22,52,150,13,762
2020-02-08,전북,강원,190,3,6,14,4,5,222,140,3,6,5,3,2,159
2020-02-08,전북,경기,1586,27,114,74,87,48,1936,2247,27,141,55,85,70,2625
2020-02-08,전북,경남,1702,30,81,54,90,53,2010,2029,19,88,48,79,65,2328
2020-02-08,전북,경북,1689,60,108,54,142,44,2097,1904,47,113,76,158,73,2371
2020-02-08,전북,광주,7859,265,290,163,225,274,9076,7879,234,290,144,200,279,9026
2020-02-08,전북,대구,457,5,32,2,8,15,519,496,5,39,4,17,12,573
2020-02-08,전북,대전,4009,59,85,28,39,180,4400,4353,52,66,65,36,186,4758
2020-02-08,전북,부산,352,3,42,14,17,15,443,450,5,48,10,35,15,563
2020-02-08,전북,서울,1403,10,37,10,12,39,1511,2001,8,47,9,19,48,2132
2020-02-08,전북,세종,872,6,11,9,21,27,946,1097,6,11,5,25,30,1174
2020-02-08,전북,울산,51,0,7,2,1,1,62,59,0,10,1,6,3,79
2020-02-08,전북,전남,6016,114,302,369,736,169,7706,6124,146,340,336,672,173,7791
2020-02-08,전북,전북,15300,365,618,472,503,549,17807,15300,365,618,472,503,549,17807
2020-02-08,전북,충남,16021,261,1152,467,696,557,19154,17922,253,1209,515,799,682,21380
2020-02-08,전북,충북,2040,58,81,146,115,75,2515,2371,70,114,137,157,81,2930
2020-02-08,충남,강원,636,7,19,26,37,26,751,365,5,15,12,11,11,419
2020-02-08,충남,경기,38191,633,1636,1025,2179,1900,45564,40586,680,1648,1036,2145,2013,48108
2020-02-08,충남,경남,2081,25,104,177,259,71,2717,1218,14,70,66,68,43,1479
2020-02-08,충남,경북,4247,45,162,181,372,166,5173,3419,51,126,187,298,129,4210
2020-02-08,충남,광주,4634,57,554,316,218,156,5935,4470,43,543,197,126,129,5508
2020-02-08,충남,대구,1359,18,62,73,85,58,1655,1581,26,89,66,84,55,1901
2020-02-08,충남,대전,13834,237,337,94,170,878,15550,14376,237,332,118,153,914,16130
2020-02-08,충남,부산,175,0,9,37,79,4,304,169,5,16,18,39,6,253
2020-02-08,충남,서울,30743,283,2171,543,667,1232,35639,31978,254,2210,436,428,1283,36589
2020-02-08,충남,세종,4478,101,75,44,81,210,4989,5958,106,93,47,73,309,6586
2020-02-08,충남,울산,130,2,8,18,37,4,199,146,1,10,10,32,3,202
2020-02-08,충남,전남,5911,50,386,267,449,179,7242,4661,47,321,222,345,118,5714
2020-02-08,충남,전북,17922,253,1209,515,799,682,21380,16021,261,1152,467,696,557,19154
2020-02-08,충남,충남,100205,1737,5479,2840,4603,4325,119189,100205,1737,5479,2840,4603,4325,119189
2020-02-08,충남,충북,11535,290,462,426,807,588,14108,10448,304,413,348,727,548,12788
2020-02-08,충북,강원,6032,112,170,122,177,285,6898,5216,121,161,115,212,282,6107
2020-02-08,충북,경기,27606,880,1305,1209,2085,1351,34436,30735,919,1407,1358,1823,1497,37739
2020-02-08,충북,경남,1911,30,142,255,332,71,2741,1355,17,83,105,159,60,1779
2020-02-08,충북,경북,6755,102,314,312,605,258,8346,6479,106,305,268,470,243,7871
2020-02-08,충북,광주,661,12,39,78,49,16,855,575,8,36,42,12,15,688
2020-02-08,충북,대구,1728,40,99,140,83,62,2152,2209,31,140,122,121,92,2715
2020-02-08,충북,대전,9447,235,305,99,127,628,10841,10040,299,339,108,116,656,11558
2020-02-08,충북,부산,153,5,16,54,83,8,319,138,2,11,33,74,6,264
2020-02-08,충북,서울,14947,228,987,424,497,652,17735,16174,184,983,381,332,716,18770
2020-02-08,충북,세종,292,13,11,11,13,21,361,295,10,9,11,10,18,353
2020-02-08,충북,울산,22,0,1,6,27,0,56,16,0,1,9,21,0,47
2020-02-08,충북,전남,521,4,22,52,150,13,762,474,10,23,40,114,12,673
2020-02-08,충북,전북,2371,70,114,137,157,81,2930,2040,58,81,146,115,75,2515
2020-02-08,충북,충남,10448,304,413,348,727,548,12788,11535,290,462,426,807,588,14108
2020-02-08,충북,충북,33156,925,1076,924,1493,1858,39432,33156,925,1076,924,1493,1858,39432
2020-02-09,강원,강원,70417,566,2224,289,396,3628,77520,70417,566,2224,289,396,3628,77520
2020-02-09,강원,경기,40048,212,888,159,119,1564,42990,25279,158,830,140,143,1159,27709
2020-02-09,강원,경남,268,1,16,4,3,11,303,164,1,4,6,6,3,184
2020-02-09,강원,경북,744,14,25,4,3,27,817,600,8,24,5,5,28,670
2020-02-09,강원,광주,116,0,18,5,1,6,146,100,0,14,4,2,4,124
2020-02-09,강원,대구,417,0,4,4,0,12,437,444,4,14,4,1,16,483
2020-02-09,강원,대전,282,0,29,0,1,19,331,258,0,30,0,0,9,297
2020-02-09,강원,부산,7,0,1,0,0,0,8,6,0,0,0,0,0,6
2020-02-09,강원,서울,1522,7,399,2,4,49,1983,861,8,282,1,0,28,1180
2020-02-09,강원,세종,12,0,0,0,0,0,12,11,0,0,0,0,0,11
2020-02-09,강원,울산,2,0,0,0,0,0,2,2,0,0,0,0,0,2
2020-02-09,강원,전남,79,0,3,0,1,2,85,66,2,1,2,10,2,83
2020-02-09,강원,전북,190,2,17,7,1,4,221,165,4,7,12,1,4,193
2020-02-09,강원,충남,666,2,18,4,9,31,730,578,3,19,7,7,32,646
2020-02-09,강원,충북,5411,52,131,45,42,245,5926,4814,37,149,29,41,247,5317
2020-02-09,경기,강원,25279,158,830,140,143,1159,27709,40048,212,888,159,119,1564,42990
2020-02-09,경기,경기,268145,4568,6374,2800,2863,16940,301690,268145,4568,6374,2800,2863,16940,301690
2020-02-09,경기,경남,2604,20,207,114,51,82,3078,2710,15,188,114,57,91,3175
2020-02-09,경기,경북,4068,32,188,139,48,165,4640,6167,36,175,182,64,233,6857
2020-02-09,경기,광주,667,6,95,25,16,20,829,912,0,80,36,24,25,1077
2020-02-09,경기,대구,1841,15,107,62,33,70,2128,3659,20,129,65,49,146,4068
2020-02-09,경기,대전,2029,5,143,8,3,109,2297,2927,18,141,13,6,154,3259
2020-02-09,경기,부산,227,3,7,34,19,8,298,490,5,9,27,17,25,573
2020-02-09,경기,서울,96812,1580,3963,1083,511,5696,109645,107542,1724,3934,1003,481,6321,121005
2020-02-09,경기,세종,34,0,2,0,0,2,38,50,0,2,1,0,3,56
2020-02-09,경기,울산,29,0,0,1,1,0,31,46,0,1,4,7,0,58
2020-02-09,경기,전남,828,2,60,30,25,33,978,1270,7,59,63,26,32,1457
2020-02-09,경기,전북,1382,8,95,34,18,54,1591,2283,11,80,43,24,91,2532
2020-02-09,경기,충남,33177,274,1129,413,518,1690,37201,36432,269,1167,354,533,1796,40551
2020-02-09,경기,충북,23766,434,787,448,424,1178,27037,27528,441,779,399,353,1390,30890
2020-02-09,경남,강원,164,1,4,6,6,3,184,268,1,16,4,3,11,303
2020-02-09,경남,경기,2710,15,188,114,57,91,3175,2604,20,207,114,51,82,3078
2020-02-09,경남,경남,154315,2031,3442,913,1594,9940,172235,154315,2031,3442,913,1594,9940,172235
2020-02-09,경남,경북,13687,131,397,128,175,633,15151,18092,188,515,198,221,848,20062
2020-02-09,경남,광주,1385,19,72,27,7,42,1552,1353,16,72,24,8,46,1519
2020-02-09,경남,대구,16030,163,553,231,308,730,18015,13059,113,442,79,44,576,14313
2020-02-09,경남,대전,1208,8,91,27,8,51,1393,1395,14,94,11,5,55,1574
2020-02-09,경남,부산,75464,559,1608,219,666,4530,83046,73416,607,1547,210,664,4573,81017
2020-02-09,경남,서울,2389,18,447,113,53,75,3095,2481,14,495,30,14,74,3108
2020-02-09,경남,세종,295,0,6,3,0,10,314,276,0,15,0,0,17,308
2020-02-09,경남,울산,10626,147,294,43,52,605,11767,10088,122,282,47,58,612,11209
2020-02-09,경남,전남,6638,63,238,92,148,304,7483,6662,75,226,113,159,294,7529
2020-02-09,경남,전북,1750,15,73,16,4,55,1913,2085,16,72,13,17,71,2274
2020-02-09,경남,충남,1688,9,51,35,33,68,1884,1623,10,48,44,45,72,1842
2020-02-09,경남,충북,1708,8,65,57,41,71,1950,1697,17,106,91,46,76,2033
2020-02-09,경북,강원,600,8,24,5,5,28,670,744,14,25,4,3,27,817
2020-02-09,경북,경기,6167,36,175,182,64,233,6857,4068,32,188,139,48,165,4640
2020-02-09,경북,경남,18092,188,515,198,221,848,20062,13687,131,397,128,175,633,15151
2020-02-09,경북,경북,73036,850,1479,474,551,3481,79871,73036,850,1479,474,551,3481,79871
2020-02-09,경북,광주,881,15,56,53,12,27,1044,971,16,41,56,8,21,1113
2020-02-09,경북,대구,62013,572,1141,232,288,2953,67199,65062,598,1335,264,349,3057,70665
2020-02-09,경북,대전,2238,8,70,26,18,107,2467,2277,12,73,13,6,98,2479
2020-02-09,경북,부산,7272,28,250,24,57,291,7922,7731,35,265,25,80,316,8452
2020-02-09,경북,서울,4313,24,308,100,20,154,4919,3109,16,268,38,21,107,3559
2020-02-09,경북,세종,371,1,5,7,8,14,406,292,1,8,7,3,19,330
2020-02-09,경북,울산,7091,36,132,68,187,364,7878,6223,34,129,36,197,309,6928
2020-02-09,경북,전남,1330,19,47,28,65,47,1536,1365,12,31,24,123,43,1598
2020-02-09,경북,전북,1650,24,47,37,50,51,1859,1697,23,42,31,41,58,1892
2020-02-09,경북,충남,3911,27,73,40,90,148,4289,3241,28,84,49,96,110,3608
2020-02-09,경북,충북,6952,58,173,124,134,291,7732,6035,58,200,116,98,239,6746
2020-02-09,광주,강원,100,0,14,4,2,4,124,116,0,18,5,1,6,146
2020-02-09,광주,경기,912,0,80,36,24,25,1077,667,6,95,25,16,20,829
2020-02-09,광주,경남,1353,16,72,24,8,46,1519,1385,19,72,27,7,42,1552
2020-02-09,광주,경북,971,16,41,56,8,21,1113,881,15,56,53,12,27,1044
2020-02-09,광주,광주,9595,115,404,93,49,339,10595,9595,115,404,93,49,339,10595
2020-02-09,광주,대구,625,9,49,35,15,17,750,681,11,66,19,6,19,802
2020-02-09,광주,대전,443,7,3,3,8,15,479,480,7,5,1,2,22,517
2020-02-09,광주,부산,538,4,39,6,7,12,606,702,1,52,6,3,17,781
2020-02-09,광주,서울,800,7,11,9,7,23,857,686,9,18,8,2,23,746
2020-02-09,광주,세종,196,0,2,0,0,6,204,161,2,2,0,6,2,173
2020-02-09,광주,울산,59,1,8,0,0,2,70,42,0,8,1,0,2,53
2020-02-09,광주,전남,28300,246,648,139,114,980,30427,28470,230,549,248,122,1058,30677
2020-02-09,광주,전북,6962,74,185,56,32,230,7539,7399,89,195,73,28,267,8051
2020-02-09,광주,충남,4817,33,480,110,66,175,5681,3987,33,494,89,34,93,4730
2020-02-09,광주,충북,648,9,33,20,3,19,732,592,7,36,29,13,15,692
2020-02-09,대구,강원,444,4,14,4,1,16,483,417,0,4,4,0,12,437
2020-02-09,대구,경기,3659,20,129,65,49,146,4068,1841,15,107,62,33,70,2128
2020-02-09,대구,경남,13059,113,442,79,44,576,14313,16030,163,553,231,308,730,18015
2020-02-09,대구,경북,65062,598,1335,264,349,3057,70665,62013,572,1141,232,288,2953,67199
2020-02-09,대구,광주,681,11,66,19,6,19,802,625,9,49,35,15,17,750
2020-02-09,대구,대구,37684,338,541,124,122,2101,40910,37684,338,541,124,122,2101,40910
2020-02-09,대구,대전,1173,5,40,10,5,54,1287,776,1,25,7,2,41,852
2020-02-09,대구,부산,715,4,24,7,4,35,789,4320,24,121,23,26,178,4692
2020-02-09,대구,서울,2898,24,188,56,19,104,3289,1885,8,138,17,2,57,2107
2020-02-09,대구,세종,384,0,10,0,0,22,416,167,0,4,1,1,3,176
2020-02-09,대구,울산,1923,13,102,8,42,84,2172,1639,11,103,8,39,71,1871
2020-02-09,대구,전남,717,5,43,4,15,25,809,698,11,34,14,12,27,796
2020-02-09,대구,전북,449,1,32,2,4,18,506,458,1,30,6,4,16,515
2020-02-09,대구,충남,1930,11,34,23,30,77,2105,997,7,28,22,18,39,1111
2020-02-09,대구,충북,2385,14,113,47,66,97,2722,1474,8,63,42,16,70,1673
2020-02-09,대전,강원,258,0,30,0,0,9,297,282,0,29,0,1,19,331
2020-02-09,대전,경기,2927,18,141,13,6,154,3259,2029,5,143,8,3,109,2297
2020-02-09,대전,경남,1395,14,94,11,5,55,1574,1208,8,91,27,8,51,1393
2020-02-09,대전,경북,2277,12,73,13,6,98,2479,2238,8,70,26,18,107,2467
2020-02-09,대전,광주,480,7,5,1,2,22,517,443,7,3,3,8,15,479
2020-02-09,대전,대구,776,1,25,7,2,41,852,1173,5,40,10,5,54,1287
2020-02-09,대전,대전,8843,68,124,28,15,609,9687,8843,68,124,28,15,609,9687
2020-02-09,대전,부산,132,0,1,0,1,0,134,157,0,2,0,1,3,163
2020-02-09,대전,서울,2202,10,234,1,1,118,2566,1770,15,234,3,1,98,2121
2020-02-09,대전,세종,2241,36,25,5,5,153,2465,1922,28,26,4,9,134,2123
2020-02-09,대전,울산,147,1,8,1,10,12,179,103,0,13,1,4,7,128
2020-02-09,대전,전남,379,2,2,10,5,8,406,437,1,3,4,4,11,460
2020-02-09,대전,전북,3549,19,53,9,9,148,3787,3974,24,54,27,11,168,4258
2020-02-09,대전,충남,11316,66,231,41,23,684,12361,10475,84,230,42,21,620,11472
2020-02-09,대전,충북,8002,113,244,28,15,532,8934,7066,88,225,32,13,472,7896
2020-02-09,부산,강원,6,0,0,0,0,0,6,7,0,1,0,0,0,8
2020-02-09,부산,경기,490,5,9,27,17,25,573,227,3,7,34,19,8,298
2020-02-09,부산,경남,73416,607,1547,210,664,4573,81017,75464,559,1608,219,666,4530,83046
2020-02-09,부산,경북,7731,35,265,25,80,316,8452,7272,28,250,24,57,291,7922
2020-02-09,부산,광주,702,1,52,6,3,17,781,538,4,39,6,7,12,606
2020-02-09,부산,대구,4320,24,121,23,26,178,4692,715,4,24,7,4,35,789
2020-02-09,부산,대전,157,0,2,0,1,3,163,132,0,1,0,1,0,134
2020-02-09,부산,부산,45663,143,154,71,230,2438,48699,45663,143,154,71,230,2438,48699
2020-02-09,부산,서울,391,3,13,15,10,10,442,226,4,10,7,7,5,259
2020-02-09,부산,세종,49,0,0,0,1,1,51,19,1,0,0,0,2,22
2020-02-09,부산,울산,18427,80,147,72,359,1147,20232,17078,87,87,42,355,1074,18723
2020-02-09,부산,전남,2394,17,92,33,108,102,2746,2012,16,73,61,106,80,2348
2020-02-09,부산,전북,451,7,48,4,10,16,536,451,4,50,10,13,11,539
2020-02-09,부산,충남,274,4,8,2,10,8,306,168,1,10,4,9,5,197
2020-02-09,부산,충북,246,1,4,5,18,13,287,139,3,2,19,9,6,178
2020-02-09,서울,강원,861,8,282,1,0,28,1180,1522,7,399,2,4,49,1983
2020-02-09,서울,경기,107542,1724,3934,1003,481,6321,121005,96812,1580,3963,1083,511,5696,109645
2020-02-09,서울,경남,2481,14,495,30,14,74,3108,2389,18,447,113,53,75,3095
2020-02-09,서울,경북,3109,16,268,38,21,107,3559,4313,24,308,100,20,154,4919
2020-02-09,서울,광주,686,9,18,8,2,23,746,800,7,11,9,7,23,857
2020-02-09,서울,대구,1885,8,138,17,2,57,2107,2898,24,188,56,19,104,3289
2020-02-09,서울,대전,1770,15,234,3,1,98,2121,2202,10,234,1,1,118,2566
2020-02-09,서울,부산,226,4,10,7,7,5,259,391,3,13,15,10,10,442
2020-02-09,서울,서울,175,1,9,0,2,7,194,175,1,9,0,2,7,194
2020-02-09,서울,세종,28,0,0,0,0,2,30,29,0,1,0,0,1,31
2020-02-09,서울,울산,20,0,1,0,0,1,22,16,1,3,1,2,1,24
2020-02-09,서울,전남,825,3,22,15,1,21,887,1234,4,17,48,26,28,1357
2020-02-09,서울,전북,1295,6,31,2,1,38,1373,1993,5,40,10,3,66,2117
2020-02-09,서울,충남,29289,136,2039,175,158,1236,33033,32071,153,2007,485,257,1277,36250
2020-02-09,서울,충북,13552,105,823,176,120,598,15374,14135,102,857,170,82,614,15960
2020-02-09,세종,강원,11,0,0,0,0,0,11,12,0,0,0,0,0,12
2020-02-09,세종,경기,50,0,2,1,0,3,56,34,0,2,0,0,2,38
2020-02-09,세종,경남,276,0,15,0,0,17,308,295,0,6,3,0,10,314
2020-02-09,세종,경북,292,1,8,7,3,19,330,371,1,5,7,8,14,406
2020-02-09,세종,광주,161,2,2,0,6,2,173,196,0,2,0,0,6,204
2020-02-09,세종,대구,167,0,4,1,1,3,176,384,0,10,0,0,22,416
2020-02-09,세종,대전,1922,28,26,4,9,134,2123,2241,36,25,5,5,153,2465
2020-02-09,세종,부산,19,1,0,0,0,2,22,49,0,0,0,1,1,51
2020-02-09,세종,서울,29,0,1,0,0,1,31,28,0,0,0,0,2,30
2020-02-09,세종,세종,212,4,0,0,0,3,219,212,4,0,0,0,3,219
2020-02-09,세종,울산,13,0,0,0,0,0,13,12,0,0,0,0,0,12
2020-02-09,세종,전남,170,2,1,2,0,4,179,239,0,2,0,4,4,249
2020-02-09,세종,전북,695,1,10,2,6,19,733,902,1,8,2,8,30,951
2020-02-09,세종,충남,4815,37,65,23,20,224,5184,4191,28,73,24,24,203,4543
2020-02-09,세종,충북,277,5,2,6,2,22,314,270,6,4,2,1,16,299
2020-02-09,울산,강원,2,0,0,0,0,0,2,2,0,0,0,0,0,2
2020-02-09,울산,경기,46,0,1,4,7,0,58,29,0,0,1,1,0,31
2020-02-09,울산,경남,10088,122,282,47,58,612,11209,10626,147,294,43,52,605,11767
2020-02-09,울산,경북,6223,34,129,36,197,309,6928,7091,36,132,68,187,364,7878
2020-02-09,울산,광주,42,0,8,1,0,2,53,59,1,8,0,0,2,70
2020-02-09,울산,대구,1639,11,103,8,39,71,1871,1923,13,102,8,42,84,2172
2020-02-09,울산,대전,103,0,13,1,4,7,128,147,1,8,1,10,12,179
2020-02-09,울산,부산,17078,87,87,42,355,1074,18723,18427,80,147,72,359,1147,20232
2020-02-09,울산,서울,16,1,3,1,2,1,24,20,0,1,0,0,1,22
2020-02-09,울산,세종,12,0,0,0,0,0,12,13,0,0,0,0,0,13
2020-02-09,울산,울산,5068,43,126,23,46,384,5690,5068,43,126,23,46,384,5690
2020-02-09,울산,전남,247,3,7,1,2,13,273,272,5,11,4,2,7,301
2020-02-09,울산,전북,78,2,8,0,6,0,94,66,1,7,0,0,2,76
2020-02-09,울산,충남,148,2,4,4,17,5,180,112,0,7,3,17,1,140
2020-02-09,울산,충북,26,1,1,1,6,1,36,25,0,0,0,8,0,33
2020-02-09,전남,강원,66,2,1,2,10,2,83,79,0,3,0,1,2,85
2020-02-09,전남,경기,1270,7,59,63,26,32,1457,828,2,60,30,25,33,978
2020-02-09,전남,경남,6662,75,226,113,159,294,7529,6638,63,238,92,148,304,7483
2020-02-09,전남,경북,1365,12,31,24,123,43,1598,1330,19,47,28,65,47,1536
2020-02-09,전남,광주,28470,230,549,248,122,1058,30677,28300,246,648,139,114,980,30427
2020-02-09,전남,대구,698,11,34,14,12,27,796,717,5,43,4,15,25,809
2020-02-09,전남,대전,437,1,3,4,4,11,460,379,2,2,10,5,8,406
2020-02-09,전남,부산,2012,16,73,61,106,80,2348,2394,17,92,33,108,102,2746
2020-02-09,전남,서울,1234,4,17,48,26,28,1357,825,3,22,15,1,21,887
2020-02-09,전남,세종,239,0,2,0,4,4,249,170,2,1,2,0,4,179
2020-02-09,전남,울산,272,5,11,4,2,7,301,247,3,7,1,2,13,273
2020-02-09,전남,전남,40882,420,836,773,694,1420,45025,40882,420,836,773,694,1420,45025
2020-02-09,전남,전북,6089,81,176,252,243,180,7021,5715,84,224,166,238,175,6602
2020-02-09,전남,충남,6664,57,348,408,380,163,8020,4557,34,357,106,163,122,5339
2020-02-09,전남,충북,556,5,11,48,36,20,676,498,5,17,25,43,15,603
2020-02-09,전북,강원,165,4,7,12,1,4,193,190,2,17,7,1,4,221
2020-02-09,전북,경기,2283,11,80,43,24,91,2532,1382,8,95,34,18,54,1591
2020-02-09,전북,경남,2085,16,72,13,17,71,2274,1750,15,73,16,4,55,1913
2020-02-09,전북,경북,1697,23,42,31,41,58,1892,1650,24,47,37,50,51,1859
2020-02-09,전북,광주,7399,89,195,73,28,267,8051,6962,74,185,56,32,230,7539
2020-02-09,전북,대구,458,1,30,6,4,16,515,449,1,32,2,4,18,506
2020-02-09,전북,대전,3974,24,54,27,11,168,4258,3549,19,53,9,9,148,3787
2020-02-09,전북,부산,451,4,50,10,13,11,539,451,7,48,4,10,16,536
2020-02-09,전북,서울,1993,5,40,10,3,66,2117,1295,6,31,2,1,38,1373
2020-02-09,전북,세종,902,1,8,2,8,30,951,695,1,10,2,6,19,733
2020-02-09,전북,울산,66,1,7,0,0,2,76,78,2,8,0,6,0,94
2020-02-09,전북,전남,5715,84,224,166,238,175,6602,6089,81,176,252,243,180,7021
2020-02-09,전북,전북,12984,162,391,96,91,466,14190,12984,162,391,96,91,466,14190
2020-02-09,전북,충남,17904,129,942,236,315,661,20187,13927,112,907,157,237,519,15859
2020-02-09,전북,충북,2441,31,60,129,45,84,2790,1898,40,98,75,47,86,2244
2020-02-09,충남,강원,578,3,19,7,7,32,646,666,2,18,4,9,31,730
2020-02-09,충남,경기,36432,269,1167,354,533,1796,40551,33177,274,1129,413,518,1690,37201
2020-02-09,충남,경남,1623,10,48,44,45,72,1842,1688,9,51,35,33,68,1884
2020-02-09,충남,경북,3241,28,84,49,96,110,3608,3911,27,73,40,90,148,4289
2020-02-09,충남,광주,3987,33,494,89,34,93,4730,4817,33,480,110,66,175,5681
2020-02-09,충남,대구,997,7,28,22,18,39,1111,1930,11,34,23,30,77,2105
2020-02-09,충남,대전,10475,84,230,42,21,620,11472,11316,66,231,41,23,684,12361
2020-02-09,충남,부산,168,1,10,4,9,5,197,274,4,8,2,10,8,306
2020-02-09,충남,서울,32071,153,2007,485,257,1277,36250,29289,136,2039,175,158,1236,33033
2020-02-09,충남,세종,4191,28,73,24,24,203,4543,4815,37,65,23,20,224,5184
2020-02-09,충남,울산,112,0,7,3,17,1,140,148,2,4,4,17,5,180
2020-02-09,충남,전남,4557,34,357,106,163,122,5339,6664,57,348,408,380,163,8020
2020-02-09,충남,전북,13927,112,907,157,237,519,15859,17904,129,942,236,315,661,20187
2020-02-09,충남,충남,90976,855,4278,1264,1658,3808,102839,90976,855,4278,1264,1658,3808,102839
2020-02-09,충남,충북,9451,144,256,185,218,499,10753,9022,117,279,152,238,466,10274
2020-02-09,충북,강원,4814,37,149,29,41,247,5317,5411,52,131,45,42,245,5926
2020-02-09,충북,경기,27528,441,779,399,353,1390,30890,23766,434,787,448,424,1178,27037
2020-02-09,충북,경남,1697,17,106,91,46,76,2033,1708,8,65,57,41,71,1950
2020-02-09,충북,경북,6035,58,200,116,98,239,6746,6952,58,173,124,134,291,7732
2020-02-09,충북,광주,592,7,36,29,13,15,692,648,9,33,20,3,19,732
2020-02-09,충북,대구,1474,8,63,42,16,70,1673,2385,14,113,47,66,97,2722
2020-02-09,충북,대전,7066,88,225,32,13,472,7896,8002,113,244,28,15,532,8934
2020-02-09,충북,부산,139,3,2,19,9,6,178,246,1,4,5,18,13,287
2020-02-09,충북,서울,14135,102,857,170,82,614,15960,13552,105,823,176,120,598,15374
2020-02-09,충북,세종,270,6,4,2,1,16,299,277,5,2,6,2,22,314
2020-02-09,충북,울산,25,0,0,0,8,0,33,26,1,1,1,6,1,36
2020-02-09,충북,전남,498,5,17,25,43,15,603,556,5,11,48,36,20,676
2020-02-09,충북,전북,1898,40,98,75,47,86,2244,2441,31,60,129,45,84,2790
2020-02-09,충북,충남,9022,117,279,152,238,466,10274,9451,144,256,185,218,499,10753
2020-02-09,충북,충북,27908,412,648,384,386,1422,31160,27908,412,648,384,386,1422,31160
2020-02-10,강원,강원,65980,1980,2931,1244,2381,4480,78996,65980,1980,2931,1244,2381,4480,78996
2020-02-10,강원,경기,51349,1179,3315,823,1507,1964,60137,20026,552,1151,606,790,1048,24173
2020-02-10,강원,경남,154,1,16,11,23,7,212,120,1,6,23,12,3,165
2020-02-10,강원,경북,447,29,41,14,27,16,574,424,20,33,21,40,26,564
2020-02-10,강원,광주,101,1,15,8,5,4,134,117,2,13,6,5,1,144
2020-02-10,강원,대구,226,1,7,6,5,4,249,302,2,12,20,11,7,354
2020-02-10,강원,대전,146,4,28,4,1,10,193,193,10,30,3,2,10,248
2020-02-10,강원,부산,4,1,0,0,1,0,6,5,0,0,0,0,0,5
2020-02-10,강원,서울,676,18,277,7,23,40,1041,706,16,235,13,9,31,1010
2020-02-10,강원,세종,4,0,1,0,1,0,6,8,1,1,2,0,2,14
2020-02-10,강원,울산,3,0,0,0,1,0,4,0,0,0,0,1,0,1
2020-02-10,강원,전남,229,2,9,13,42,7,302,51,0,1,8,11,1,72
2020-02-10,강원,전북,119,1,13,9,16,1,159,140,2,11,27,12,4,196
2020-02-10,강원,충남,388,6,14,21,28,24,481,467,7,18,23,59,25,599
2020-02-10,강원,충북,4804,184,279,218,378,310,6173,4850,187,287,179,320,293,6116
2020-02-10,경기,강원,20026,552,1151,606,790,1048,24173,51349,1179,3315,823,1507,1964,60137
2020-02-10,경기,경기,1497922,50501,63750,28828,63217,100783,1805001,1497922,50501,63750,28828,63217,100783,1805001
2020-02-10,경기,경남,2752,67,320,376,380,87,3982,8739,207,498,819,518,243,11024
2020-02-10,경기,경북,4451,172,488,564,475,162,6312,23580,567,1393,2811,1081,606,30038
2020-02-10,경기,광주,718,27,169,201,127,24,1266,839,18,181,190,106,16,1350
2020-02-10,경기,대구,1984,80,187,227,165,67,2710,13580,353,480,906,522,349,16190
2020-02-10,경기,대전,1984,97,229,81,30,89,2510,7495,183,848,167,79,279,9051
2020-02-10,경기,부산,191,17,21,85,84,11,409,1301,112,52,208,270,32,1975
2020-02-10,경기,서울,140473,6988,8391,4101,3435,9667,173055,201838,8280,9526,4725,3476,13259,241104
2020-02-10,경기,세종,40,2,2,1,3,0,48,73,4,4,1,2,2,86
2020-02-10,경기,울산,23,1,0,9,7,0,40,157,5,12,36,198,2,410
2020-02-10,경기,전남,1253,30,107,145,164,44,1743,1066,17,104,128,118,42,1475
2020-02-10,경기,전북,1412,54,163,82,171,37,1919,2847,73,205,168,186,77,3556
2020-02-10,경기,충남,39017,1416,2651,2179,4047,2054,51364,90119,2523,5197,3169,5140,4036,110184
2020-02-10,경기,충북,28996,2127,2802,2737,3256,1419,41337,105219,4068,7127,5307,8497,3928,134146
2020-02-10,경남,강원,120,1,6,23,12,3,165,154,1,16,11,23,7,212
2020-02-10,경남,경기,8739,207,498,819,518,243,11024,2752,67,320,376,380,87,3982
2020-02-10,경남,경남,192483,9881,9666,7177,12887,15028,247122,192483,9881,9666,7177,12887,15028,247122
2020-02-10,경남,경북,10442,610,956,901,1723,509,15141,12502,834,1153,1076,2411,591,18567
2020-02-10,경남,광주,1081,52,126,146,137,26,1568,1200,44,119,130,108,27,1628
2020-02-10,경남,대구,13449,715,931,869,1477,578,18019,11282,487,741,379,467,520,13876
2020-02-10,경남,대전,691,21,84,62,33,30,921,1049,26,88,64,46,53,1326
2020-02-10,경남,부산,85404,2541,2826,1477,4204,6183,102635,87529,2641,3052,1557,4537,6181,105497
2020-02-10,경남,서울,1769,37,435,214,103,53,2611,2418,33,452,96,62,69,3130
2020-02-10,경남,세종,173,2,6,6,3,6,196,285,3,23,12,9,7,339
2020-02-10,경남,울산,10304,580,639,409,571,630,13133,9565,537,654,353,586,571,12266
2020-02-10,경남,전남,17486,648,669,668,1844,566,21881,5761,275,449,405,1381,246,8517
2020-02-10,경남,전북,1190,33,108,75,123,44,1573,1256,34,110,73,118,42,1633
2020-02-10,경남,충남,1278,40,130,219,199,57,1923,1544,41,146,221,350,46,2348
2020-02-10,경남,충북,1201,41,131,253,326,53,2005,1393,62,171,316,451,57,2450
2020-02-10,경북,강원,424,20,33,21,40,26,564,447,29,41,14,27,16,574
2020-02-10,경북,경기,23580,567,1393,2811,1081,606,30038,4451,172,488,564,475,162,6312
2020-02-10,경북,경남,12502,834,1153,1076,2411,591,18567,10442,610,956,901,1723,509,15141
2020-02-10,경북,경북,73571,3611,3967,2625,4643,4016,92433,73571,3611,3967,2625,4643,4016,92433
2020-02-10,경북,광주,750,51,126,149,92,20,1188,811,34,88,161,68,23,1185
2020-02-10,경북,대구,72003,2749,2681,1353,3024,3980,85790,78813,2861,3117,1797,3678,4179,94445
2020-02-10,경북,대전,1551,55,112,110,68,71,1967,1879,41,98,85,76,89,2268
2020-02-10,경북,부산,3970,95,330,133,539,198,5265,4947,115,328,193,671,218,6472
2020-02-10,경북,서울,2529,85,346,307,100,84,3451,3024,82,301,163,79,106,3755
2020-02-10,경북,세종,266,3,25,24,13,16,347,318,7,18,14,15,10,382
2020-02-10,경북,울산,5269,167,300,365,928,303,7332,5053,164,257,342,1158,293,7267
2020-02-10,경북,전남,2839,74,122,155,682,69,3941,922,43,73,98,515,35,1686
2020-02-10,경북,전북,1726,77,191,193,225,56,2468,1487,79,163,146,232,49,2156
2020-02-10,경북,충남,3386,132,332,457,575,113,4995,3296,131,314,342,622,119,4824
2020-02-10,경북,충북,5066,233,497,637,961,202,7596,5055,224,505,571,1005,207,7567
2020-02-10,광주,강원,117,2,13,6,5,1,144,101,1,15,8,5,4,134
2020-02-10,광주,경기,839,18,181,190,106,16,1350,718,27,169,201,127,24,1266
2020-02-10,광주,경남,1200,44,119,130,108,27,1628,1081,52,126,146,137,26,1568
2020-02-10,광주,경북,811,34,88,161,68,23,1185,750,51,126,149,92,20,1188
2020-02-10,광주,광주,12677,426,609,374,371,565,15022,12677,426,609,374,371,565,15022
2020-02-10,광주,대구,546,21,91,64,26,18,766,560,28,93,54,24,23,782
2020-02-10,광주,대전,419,18,15,23,18,11,504,490,15,14,17,15,16,567
2020-02-10,광주,부산,410,11,38,15,56,16,546,479,19,29,48,82,17,674
2020-02-10,광주,서울,573,20,21,63,17,21,715,694,19,20,20,11,23,787
2020-02-10,광주,세종,154,1,7,2,2,1,167,166,2,8,3,1,6,186
2020-02-10,광주,울산,53,0,9,4,3,2,71,46,1,10,7,3,1,68
2020-02-10,광주,전남,139694,3987,3868,1712,7865,3674,160800,29780,909,966,645,1439,1213,34952
2020-02-10,광주,전북,8046,401,479,320,335,293,9874,7482,432,411,265,339,290,9219
2020-02-10,광주,충남,4015,110,503,403,214,110,5355,3814,119,513,419,264,109,5238
2020-02-10,광주,충북,578,22,64,101,54,12,831,555,20,82,157,65,15,894
2020-02-10,대구,강원,302,2,12,20,11,7,354,226,1,7,6,5,4,249
2020-02-10,대구,경기,13580,353,480,906,522,349,16190,1984,80,187,227,165,67,2710
2020-02-10,대구,경남,11282,487,741,379,467,520,13876,13449,715,931,869,1477,578,18019
2020-02-10,대구,경북,78813,2861,3117,1797,3678,4179,94445,72003,2749,2681,1353,3024,3980,85790
2020-02-10,대구,광주,560,28,93,54,24,23,782,546,21,91,64,26,18,766
2020-02-10,대구,대구,60808,2132,1650,820,1134,4064,70608,60808,2132,1650,820,1134,4064,70608
2020-02-10,대구,대전,968,38,49,60,31,43,1189,660,26,41,28,19,22,796
2020-02-10,대구,부산,646,58,101,54,171,31,1061,3123,113,216,95,220,116,3883
2020-02-10,대구,서울,2425,54,172,149,86,66,2952,1805,41,130,72,21,57,2126
2020-02-10,대구,세종,236,4,12,6,12,5,275,199,1,1,2,4,8,215
2020-02-10,대구,울산,1522,55,136,67,176,69,2025,1260,44,131,61,203,76,1775
2020-02-10,대구,전남,1448,19,75,39,55,25,1661,437,20,40,24,75,8,604
2020-02-10,대구,전북,422,12,47,10,25,13,529,323,14,46,14,24,7,428
2020-02-10,대구,충남,1731,63,133,160,235,63,2385,1107,56,90,106,131,18,1508
2020-02-10,대구,충북,2076,88,195,238,366,87,3050,1253,73,150,155,124,49,1804
2020-02-10,대전,강원,193,10,30,3,2,10,248,146,4,28,4,1,10,193
2020-02-10,대전,경기,7495,183,848,167,79,279,9051,1984,97,229,81,30,89,2510
2020-02-10,대전,경남,1049,26,88,64,46,53,1326,691,21,84,62,33,30,921
2020-02-10,대전,경북,1879,41,98,85,76,89,2268,1551,55,112,110,68,71,1967
2020-02-10,대전,광주,490,15,14,17,15,16,567,419,18,15,23,18,11,504
2020-02-10,대전,대구,660,26,41,28,19,22,796,968,38,49,60,31,43,1189
2020-02-10,대전,대전,13702,416,398,367,582,1015,16480,13702,416,398,367,582,1015,16480
2020-02-10,대전,부산,71,4,9,7,18,4,113,74,5,4,10,14,4,111
2020-02-10,대전,서울,1891,36,201,31,13,81,2253,1776,52,195,25,10,70,2128
2020-02-10,대전,세종,3385,103,88,23,40,314,3953,3404,105,91,29,52,308,3989
2020-02-10,대전,울산,113,6,10,10,23,2,164,78,5,7,9,25,3,127
2020-02-10,대전,전남,1082,12,12,20,46,31,1203,223,9,12,26,20,5,295
2020-02-10,대전,전북,3288,67,94,45,41,157,3692,2829,92,79,69,39,145,3253
2020-02-10,대전,충남,16833,427,560,219,305,1265,19609,14234,432,489,212,285,1115,16767
2020-02-10,대전,충북,11149,450,460,185,147,828,13219,9593,373,404,143,133,730,11376
2020-02-10,부산,강원,5,0,0,0,0,0,5,4,1,0,0,1,0,6
2020-02-10,부산,경기,1301,112,52,208,270,32,1975,191,17,21,85,84,11,409
2020-02-10,부산,경남,87529,2641,3052,1557,4537,6181,105497,85404,2541,2826,1477,4204,6183,102635
2020-02-10,부산,경북,4947,115,328,193,671,218,6472,3970,95,330,133,539,198,5265
2020-02-10,부산,광주,479,19,29,48,82,17,674,410,11,38,15,56,16,546
2020-02-10,부산,대구,3123,113,216,95,220,116,3883,646,58,101,54,171,31,1061
2020-02-10,부산,대전,74,5,4,10,14,4,111,71,4,9,7,18,4,113
2020-02-10,부산,부산,41902,668,643,802,1874,3088,48977,41902,668,643,802,1874,3088,48977
2020-02-10,부산,서울,181,5,15,43,51,8,303,181,9,9,18,20,3,240
2020-02-10,부산,세종,18,0,0,2,7,1,28,23,0,0,0,3,1,27
2020-02-10,부산,울산,17483,365,445,639,2475,1182,22589,16166,400,392,367,2394,1168,20887
2020-02-10,부산,전남,5217,142,197,210,814,125,6705,1705,79,101,124,578,56,2643
2020-02-10,부산,전북,335,9,23,35,69,12,483,322,9,28,41,55,5,460
2020-02-10,부산,충남,218,7,22,45,118,2,412,139,4,25,33,159,1,361
2020-02-10,부산,충북,143,7,18,65,153,4,390,90,8,19,65,154,6,342
2020-02-10,서울,강원,706,16,235,13,9,31,1010,676,18,277,7,23,40,1041
2020-02-10,서울,경기,201838,8280,9526,4725,3476,13259,241104,140473,6988,8391,4101,3435,9667,173055
2020-02-10,서울,경남,2418,33,452,96,62,69,3130,1769,37,435,214,103,53,2611
2020-02-10,서울,경북,3024,82,301,163,79,106,3755,2529,85,346,307,100,84,3451
2020-02-10,서울,광주,694,19,20,20,11,23,787,573,20,21,63,17,21,715
2020-02-10,서울,대구,1805,41,130,72,21,57,2126,2425,54,172,149,86,66,2952
2020-02-10,서울,대전,1776,52,195,25,10,70,2128,1891,36,201,31,13,81,2253
2020-02-10,서울,부산,181,9,9,18,20,3,240,181,5,15,43,51,8,303
2020-02-10,서울,서울,178,8,12,2,0,13,213,178,8,12,2,0,13,213
2020-02-10,서울,세종,19,0,0,0,0,4,23,31,0,0,1,0,2,34
2020-02-10,서울,울산,27,0,6,1,2,1,37,15,0,1,5,10,0,31
2020-02-10,서울,전남,1351,19,32,34,33,41,1510,715,7,23,60,28,15,848
2020-02-10,서울,전북,1316,15,39,16,17,44,1447,1075,22,48,23,19,43,1230
2020-02-10,서울,충남,27429,528,2280,717,639,1150,32743,24199,592,2261,1060,1064,986,30162
2020-02-10,서울,충북,14815,488,1078,669,643,647,18340,12161,607,1146,698,748,539,15899
2020-02-10,세종,강원,8,1,1,2,0,2,14,4,0,1,0,1,0,6
2020-02-10,세종,경기,73,4,4,1,2,2,86,40,2,2,1,3,0,48
2020-02-10,세종,경남,285,3,23,12,9,7,339,173,2,6,6,3,6,196
2020-02-10,세종,경북,318,7,18,14,15,10,382,266,3,25,24,13,16,347
2020-02-10,세종,광주,166,2,8,3,1,6,186,154,1,7,2,2,1,167
2020-02-10,세종,대구,199,1,1,2,4,8,215,236,4,12,6,12,5,275
2020-02-10,세종,대전,3404,105,91,29,52,308,3989,3385,103,88,23,40,314,3953
2020-02-10,세종,부산,23,0,0,0,3,1,27,18,0,0,2,7,1,28
2020-02-10,세종,서울,31,0,0,1,0,2,34,19,0,0,0,0,4,23
2020-02-10,세종,세종,248,17,3,2,0,25,295,248,17,3,2,0,25,295
2020-02-10,세종,울산,7,0,0,1,2,1,11,4,0,0,0,6,0,10
2020-02-10,세종,전남,422,2,10,11,27,12,484,144,2,5,7,12,6,176
2020-02-10,세종,전북,774,17,23,15,32,33,894,633,19,18,17,51,25,763
2020-02-10,세종,충남,6286,142,153,98,122,357,7158,4191,133,130,91,146,229,4920
2020-02-10,세종,충북,332,12,18,16,14,25,417,320,13,20,9,29,17,408
2020-02-10,울산,강원,0,0,0,0,1,0,1,3,0,0,0,1,0,4
2020-02-10,울산,경기,157,5,12,36,198,2,410,23,1,0,9,7,0,40
2020-02-10,울산,경남,9565,537,654,353,586,571,12266,10304,580,639,409,571,630,13133
2020-02-10,울산,경북,5053,164,257,342,1158,293,7267,5269,167,300,365,928,303,7332
2020-02-10,울산,광주,46,1,10,7,3,1,68,53,0,9,4,3,2,71
2020-02-10,울산,대구,1260,44,131,61,203,76,1775,1522,55,136,67,176,69,2025
2020-02-10,울산,대전,78,5,7,9,25,3,127,113,6,10,10,23,2,164
2020-02-10,울산,부산,16166,400,392,367,2394,1168,20887,17483,365,445,639,2475,1182,22589
2020-02-10,울산,서울,15,0,1,5,10,0,31,27,0,6,1,2,1,37
2020-02-10,울산,세종,4,0,0,0,6,0,10,7,0,0,1,2,1,11
2020-02-10,울산,울산,8155,258,450,297,617,754,10531,8155,258,450,297,617,754,10531
2020-02-10,울산,전남,464,23,13,15,37,8,560,206,19,15,13,30,6,289
2020-02-10,울산,전북,55,1,6,1,7,2,72,38,3,7,3,5,2,58
2020-02-10,울산,충남,141,3,17,29,109,2,301,140,2,10,17,85,1,255
2020-02-10,울산,충북,25,0,3,13,39,2,82,19,0,3,6,31,3,62
2020-02-10,전남,강원,51,0,1,8,11,1,72,229,2,9,13,42,7,302
2020-02-10,전남,경기,1066,17,104,128,118,42,1475,1253,30,107,145,164,44,1743
2020-02-10,전남,경남,5761,275,449,405,1381,246,8517,17486,648,669,668,1844,566,21881
2020-02-10,전남,경북,922,43,73,98,515,35,1686,2839,74,122,155,682,69,3941
2020-02-10,전남,광주,29780,909,966,645,1439,1213,34952,139694,3987,3868,1712,7865,3674,160800
2020-02-10,전남,대구,437,20,40,24,75,8,604,1448,19,75,39,55,25,1661
2020-02-10,전남,대전,223,9,12,26,20,5,295,1082,12,12,20,46,31,1203
2020-02-10,전남,부산,1705,79,101,124,578,56,2643,5217,142,197,210,814,125,6705
2020-02-10,전남,서울,715,7,23,60,28,15,848,1351,19,32,34,33,41,1510
2020-02-10,전남,세종,144,2,5,7,12,6,176,422,2,10,11,27,12,484
2020-02-10,전남,울산,206,19,15,13,30,6,289,464,23,13,15,37,8,560
2020-02-10,전남,전남,107881,2668,2386,2368,7469,3964,126736,107881,2668,2386,2368,7469,3964,126736
2020-02-10,전남,전북,4623,284,491,533,1240,143,7314,16376,474,628,742,2120,401,20741
2020-02-10,전남,충남,3970,97,382,692,1143,108,6392,14048,190,754,741,1662,311,17706
2020-02-10,전남,충북,335,15,30,84,217,10,691,1505,39,91,150,526,28,2339
2020-02-10,전북,강원,140,2,11,27,12,4,196,119,1,13,9,16,1,159
2020-02-10,전북,경기,2847,73,205,168,186,77,3556,1412,54,163,82,171,37,1919
2020-02-10,전북,경남,1256,34,110,73,118,42,1633,1190,33,108,75,123,44,1573
2020-02-10,전북,경북,1487,79,163,146,232,49,2156,1726,77,191,193,225,56,2468
2020-02-10,전북,광주,7482,432,411,265,339,290,9219,8046,401,479,320,335,293,9874
2020-02-10,전북,대구,323,14,46,14,24,7,428,422,12,47,10,25,13,529
2020-02-10,전북,대전,2829,92,79,69,39,145,3253,3288,67,94,45,41,157,3692
2020-02-10,전북,부산,322,9,28,41,55,5,460,335,9,23,35,69,12,483
2020-02-10,전북,서울,1075,22,48,23,19,43,1230,1316,15,39,16,17,44,1447
2020-02-10,전북,세종,633,19,18,17,51,25,763,774,17,23,15,32,33,894
2020-02-10,전북,울산,38,3,7,3,5,2,58,55,1,6,1,7,2,72
2020-02-10,전북,전남,16376,474,628,742,2120,401,20741,4623,284,491,533,1240,143,7314
2020-02-10,전북,전북,15776,617,871,595,756,580,19195,15776,617,871,595,756,580,19195
2020-02-10,전북,충남,13067,441,1511,1037,1356,485,17897,13118,427,1445,832,1277,486,17585
2020-02-10,전북,충북,1794,110,194,288,278,77,2741,1793,101,202,271,242,70,2679
2020-02-10,충남,강원,467,7,18,23,59,25,599,388,6,14,21,28,24,481
2020-02-10,충남,경기,90119,2523,5197,3169,5140,4036,110184,39017,1416,2651,2179,4047,2054,51364
2020-02-10,충남,경남,1544,41,146,221,350,46,2348,1278,40,130,219,199,57,1923
2020-02-10,충남,경북,3296,131,314,342,622,119,4824,3386,132,332,457,575,113,4995
2020-02-10,충남,광주,3814,119,513,419,264,109,5238,4015,110,503,403,214,110,5355
2020-02-10,충남,대구,1107,56,90,106,131,18,1508,1731,63,133,160,235,63,2385
2020-02-10,충남,대전,14234,432,489,212,285,1115,16767,16833,427,560,219,305,1265,19609
2020-02-10,충남,부산,139,4,25,33,159,1,361,218,7,22,45,118,2,412
2020-02-10,충남,서울,24199,592,2261,1060,1064,986,30162,27429,528,2280,717,639,1150,32743
2020-02-10,충남,세종,4191,133,130,91,146,229,4920,6286,142,153,98,122,357,7158
2020-02-10,충남,울산,140,2,10,17,85,1,255,141,3,17,29,109,2,301
2020-02-10,충남,전남,14048,190,754,741,1662,311,17706,3970,97,382,692,1143,108,6392
2020-02-10,충남,전북,13118,427,1445,832,1277,486,17585,13067,441,1511,1037,1356,485,17897
2020-02-10,충남,충남,94945,3404,7651,6166,9261,4632,126059,94945,3404,7651,6166,9261,4632,126059
2020-02-10,충남,충북,13425,654,844,880,1352,814,17969,12389,603,822,844,1343,742,16743
2020-02-10,충북,강원,4850,187,287,179,320,293,6116,4804,184,279,218,378,310,6173
2020-02-10,충북,경기,105219,4068,7127,5307,8497,3928,134146,28996,2127,2802,2737,3256,1419,41337
2020-02-10,충북,경남,1393,62,171,316,451,57,2450,1201,41,131,253,326,53,2005
2020-02-10,충북,경북,5055,224,505,571,1005,207,7567,5066,233,497,637,961,202,7596
2020-02-10,충북,광주,555,20,82,157,65,15,894,578,22,64,101,54,12,831
2020-02-10,충북,대구,1253,73,150,155,124,49,1804,2076,88,195,238,366,87,3050
2020-02-10,충북,대전,9593,373,404,143,133,730,11376,11149,450,460,185,147,828,13219
2020-02-10,충북,부산,90,8,19,65,154,6,342,143,7,18,65,153,4,390
2020-02-10,충북,서울,12161,607,1146,698,748,539,15899,14815,488,1078,669,643,647,18340
2020-02-10,충북,세종,320,13,20,9,29,17,408,332,12,18,16,14,25,417
2020-02-10,충북,울산,19,0,3,6,31,3,62,25,0,3,13,39,2,82
2020-02-10,충북,전남,1505,39,91,150,526,28,2339,335,15,30,84,217,10,691
2020-02-10,충북,전북,1793,101,202,271,242,70,2679,1794,110,194,288,278,77,2741
2020-02-10,충북,충남,12389,603,822,844,1343,742,16743,13425,654,844,880,1352,814,17969
2020-02-10,충북,충북,35920,1908,2226,2026,2760,2252,47092,35920,1908,2226,2026,2760,2252,47092
2020-02-11,강원,강원,63150,2268,3191,1544,2574,4498,77225,63150,2268,3191,1544,2574,4498,77225
2020-02-11,강원,경기,18232,604,1264,632,796,913,22441,18470,610,1195,714,922,894,22805
2020-02-11,강원,경남,137,3,9,11,18,7,185,79,3,2,33,21,2,140
2020-02-11,강원,경북,411,16,34,22,34,18,535,409,13,33,27,31,19,532
2020-02-11,강원,광주,71,1,19,7,14,0,112,69,2,16,17,9,2,115
2020-02-11,강원,대구,208,3,7,12,9,6,245,255,5,16,24,13,4,317
2020-02-11,강원,대전,140,2,33,8,3,1,187,154,4,30,5,2,5,200
2020-02-11,강원,부산,2,0,0,1,3,0,6,8,1,1,1,0,0,11
2020-02-11,강원,서울,666,15,269,7,23,26,1006,686,22,222,7,10,26,973
2020-02-11,강원,세종,9,1,0,0,1,1,12,4,1,0,0,4,0,9
2020-02-11,강원,울산,1,0,0,0,0,0,1,1,0,0,0,0,0,1
2020-02-11,강원,전남,37,1,4,6,12,0,60,42,0,2,7,23,0,74
2020-02-11,강원,전북,135,3,13,16,16,2,185,124,3,16,17,14,4,178
2020-02-11,강원,충남,308,7,20,25,34,9,403,385,12,25,43,61,10,536
2020-02-11,강원,충북,4702,212,283,234,362,284,6077,4775,207,273,226,304,262,6047
2020-02-11,경기,강원,18470,610,1195,714,922,894,22805,18232,604,1264,632,796,913,22441
2020-02-11,경기,경기,420583,23510,24952,19414,22913,31750,543122,420583,23510,24952,19414,22913,31750,543122
2020-02-11,경기,경남,2339,126,349,801,571,75,4261,1661,94,269,550,426,56,3056
2020-02-11,경기,경북,3977,199,500,773,588,137,6174,3801,220,512,916,603,117,6169
2020-02-11,경기,광주,714,26,171,278,126,15,1330,600,17,138,227,85,20,1087
2020-02-11,경기,대구,1943,135,225,400,250,48,3001,2454,129,252,508,460,52,3855
2020-02-11,경기,대전,1940,102,217,132,52,74,2517,1910,120,193,112,56,88,2479
2020-02-11,경기,부산,175,17,47,220,159,6,624,257,26,36,176,301,7,803
2020-02-11,경기,서울,143824,7366,8681,4970,3533,9994,178368,142861,6949,8899,4609,3131,9753,176202
2020-02-11,경기,세종,34,0,2,2,3,1,42,32,4,5,0,4,1,46
2020-02-11,경기,울산,25,2,1,10,15,2,55,40,2,10,44,87,0,183
2020-02-11,경기,전남,675,25,101,182,151,19,1153,699,17,79,119,107,28,1049
2020-02-11,경기,전북,1242,54,187,134,183,32,1832,1207,76,160,178,211,40,1872
2020-02-11,경기,충남,35914,1543,2824,2493,4626,1861,49261,36030,1510,2712,2433,4282,1867,48834
2020-02-11,경기,충북,26613,2217,2976,3313,3424,1285,39828,25744,2193,2869,2787,3568,1270,38431
2020-02-11,경남,강원,79,3,2,33,21,2,140,137,3,9,11,18,7,185
2020-02-11,경남,경기,1661,94,269,550,426,56,3056,2339,126,349,801,571,75,4261
2020-02-11,경남,경남,192634,10393,10284,7211,13831,14952,249305,192634,10393,10284,7211,13831,14952,249305
2020-02-11,경남,경북,9413,629,1007,955,1836,430,14270,12007,892,1252,1310,2673,522,18656
2020-02-11,경남,광주,1001,50,152,153,161,27,1544,1044,44,150,150,117,24,1529
2020-02-11,경남,대구,12888,768,1042,1030,1620,477,17825,10301,531,759,425,513,416,12945
2020-02-11,경남,대전,703,22,113,89,31,29,987,864,40,133,131,62,36,1266
2020-02-11,경남,부산,87269,2718,2963,2006,4511,6254,105721,85871,2828,3144,2015,4759,6174,104791
2020-02-11,경남,서울,1542,42,432,289,132,39,2476,2173,66,437,220,116,68,3080
2020-02-11,경남,세종,157,0,10,10,7,4,188,225,3,19,14,12,7,280
2020-02-11,경남,울산,10041,628,653,411,616,612,12961,9316,580,701,376,622,554,12149
2020-02-11,경남,전남,5568,253,473,490,1557,246,8587,5656,269,472,466,1513,226,8602
2020-02-11,경남,전북,1060,55,121,115,154,27,1532,1086,55,137,110,171,33,1592
2020-02-11,경남,충남,1100,48,157,266,236,35,1842,1435,57,182,330,541,49,2594
2020-02-11,경남,충북,1038,47,143,273,305,25,1831,1296,60,202,480,591,31,2660
2020-02-11,경북,강원,409,13,33,27,31,19,532,411,16,34,22,34,18,535
2020-02-11,경북,경기,3801,220,512,916,603,117,6169,3977,199,500,773,588,137,6174
2020-02-11,경북,경남,12007,892,1252,1310,2673,522,18656,9413,629,1007,955,1836,430,14270
2020-02-11,경북,경북,73196,3903,4192,3082,5066,4093,93532,73196,3903,4192,3082,5066,4093,93532
2020-02-11,경북,광주,715,57,119,199,100,15,1205,688,52,83,175,58,10,1066
2020-02-11,경북,대구,73381,3053,2997,1645,3135,4056,88267,75734,3099,3355,1965,3628,4064,91845
2020-02-11,경북,대전,1593,62,139,106,73,74,2047,1534,58,127,137,70,74,2000
2020-02-11,경북,부산,4085,118,322,189,618,177,5509,4352,127,347,229,788,205,6048
2020-02-11,경북,서울,2464,132,337,419,138,62,3552,2696,85,332,275,117,72,3577
2020-02-11,경북,세종,262,6,20,29,19,5,341,230,8,27,18,25,6,314
2020-02-11,경북,울산,4971,157,342,442,1032,265,7209,4913,156,322,343,1297,284,7315
2020-02-11,경북,전남,947,41,83,118,455,30,1674,1011,54,76,112,518,31,1802
2020-02-11,경북,전북,1636,91,164,185,292,50,2418,1491,89,166,171,256,37,2210
2020-02-11,경북,충남,2957,139,378,522,601,88,4685,3037,141,357,466,768,92,4861
2020-02-11,경북,충북,4887,268,548,749,971,226,7649,4779,275,610,697,1024,198,7583
2020-02-11,광주,강원,69,2,16,17,9,2,115,71,1,19,7,14,0,112
2020-02-11,광주,경기,600,17,138,227,85,20,1087,714,26,171,278,126,15,1330
2020-02-11,광주,경남,1044,44,150,150,117,24,1529,1001,50,152,153,161,27,1544
2020-02-11,광주,경북,688,52,83,175,58,10,1066,715,57,119,199,100,15,1205
2020-02-11,광주,광주,12664,537,628,371,291,536,15027,12664,537,628,371,291,536,15027
2020-02-11,광주,대구,545,30,93,87,38,14,807,564,36,94,68,28,15,805
2020-02-11,광주,대전,365,21,22,33,12,17,470,423,25,21,56,22,13,560
2020-02-11,광주,부산,368,10,45,39,69,12,543,434,20,48,88,113,9,712
2020-02-11,광주,서울,515,25,20,59,15,10,644,692,26,32,47,9,19,825
2020-02-11,광주,세종,128,3,7,2,3,3,146,118,6,7,5,1,2,139
2020-02-11,광주,울산,48,0,8,7,2,1,66,26,3,7,4,4,0,44
2020-02-11,광주,전남,31861,968,1234,824,1811,1266,37964,31194,973,1113,750,1768,1240,37038
2020-02-11,광주,전북,7527,438,537,322,352,301,9477,7717,477,467,335,359,321,9676
2020-02-11,광주,충남,3471,104,513,443,249,89,4869,3548,129,519,560,327,103,5186
2020-02-11,광주,충북,501,27,69,118,51,16,782,582,29,93,176,95,18,993
2020-02-11,대구,강원,255,5,16,24,13,4,317,208,3,7,12,9,6,245
2020-02-11,대구,경기,2454,129,252,508,460,52,3855,1943,135,225,400,250,48,3001
2020-02-11,대구,경남,10301,531,759,425,513,416,12945,12888,768,1042,1030,1620,477,17825
2020-02-11,대구,경북,75734,3099,3355,1965,3628,4064,91845,73381,3053,2997,1645,3135,4056,88267
2020-02-11,대구,광주,564,36,94,68,28,15,805,545,30,93,87,38,14,807
2020-02-11,대구,대구,59987,2159,1893,924,1255,4053,70271,59987,2159,1893,924,1255,4053,70271
2020-02-11,대구,대전,854,47,62,91,43,31,1128,662,38,41,65,15,21,842
2020-02-11,대구,부산,599,55,99,57,121,23,954,2692,102,236,92,189,110,3421
2020-02-11,대구,서울,2157,82,190,260,117,67,2873,1584,54,143,142,43,28,1994
2020-02-11,대구,세종,234,5,12,10,13,7,281,182,2,6,2,6,6,204
2020-02-11,대구,울산,1262,64,149,89,152,56,1772,1269,58,154,65,189,43,1778
2020-02-11,대구,전남,449,14,43,46,40,6,598,502,19,48,41,71,6,687
2020-02-11,대구,전북,384,16,44,16,18,10,488,357,15,42,25,20,11,470
2020-02-11,대구,충남,1352,61,148,210,251,40,2062,1050,61,112,155,181,25,1584
2020-02-11,대구,충북,1619,102,210,270,378,56,2635,1267,77,151,230,137,28,1890
2020-02-11,대전,강원,154,4,30,5,2,5,200,140,2,33,8,3,1,187
2020-02-11,대전,경기,1910,120,193,112,56,88,2479,1940,102,217,132,52,74,2517
2020-02-11,대전,경남,864,40,133,131,62,36,1266,703,22,113,89,31,29,987
2020-02-11,대전,경북,1534,58,127,137,70,74,2000,1593,62,139,106,73,74,2047
2020-02-11,대전,광주,423,25,21,56,22,13,560,365,21,22,33,12,17,470
2020-02-11,대전,대구,662,38,41,65,15,21,842,854,47,62,91,43,31,1128
2020-02-11,대전,대전,13744,439,417,280,495,1053,16428,13744,439,417,280,495,1053,16428
2020-02-11,대전,부산,62,8,7,24,13,2,116,68,2,11,19,18,0,118
2020-02-11,대전,서울,1598,42,194,43,8,77,1962,1553,51,203,42,12,76,1937
2020-02-11,대전,세종,3345,100,85,29,54,272,3885,3438,120,77,35,61,304,4035
2020-02-11,대전,울산,80,2,12,27,27,2,150,74,4,9,18,22,0,127
2020-02-11,대전,전남,264,8,8,40,26,9,355,324,8,18,24,23,4,401
2020-02-11,대전,전북,2913,68,100,94,52,154,3381,2896,94,93,84,46,140,3353
2020-02-11,대전,충남,16053,489,512,233,314,1256,18857,14655,458,480,223,271,1122,17209
2020-02-11,대전,충북,10771,492,498,224,152,790,12927,9649,378,408,176,128,745,11484
2020-02-11,부산,강원,8,1,1,1,0,0,11,2,0,0,1,3,0,6
2020-02-11,부산,경기,257,26,36,176,301,7,803,175,17,47,220,159,6,624
2020-02-11,부산,경남,85871,2828,3144,2015,4759,6174,104791,87269,2718,2963,2006,4511,6254,105721
2020-02-11,부산,경북,4352,127,347,229,788,205,6048,4085,118,322,189,618,177,5509
2020-02-11,부산,광주,434,20,48,88,113,9,712,368,10,45,39,69,12,543
2020-02-11,부산,대구,2692,102,236,92,189,110,3421,599,55,99,57,121,23,954
2020-02-11,부산,대전,68,2,11,19,18,0,118,62,8,7,24,13,2,116
2020-02-11,부산,부산,42309,731,686,797,2116,3129,49768,42309,731,686,797,2116,3129,49768
2020-02-11,부산,서울,179,15,24,87,74,4,383,157,19,27,67,26,8,304
2020-02-11,부산,세종,19,0,0,8,7,0,34,11,0,2,4,1,0,18
2020-02-11,부산,울산,16372,401,496,701,2609,1147,21726,16515,409,435,402,2504,1161,21426
2020-02-11,부산,전남,1825,86,153,180,554,69,2867,1651,79,132,154,599,62,2677
2020-02-11,부산,전북,292,12,46,46,89,7,492,269,10,45,57,70,4,455
2020-02-11,부산,충남,128,7,32,73,177,5,422,100,12,31,103,209,4,459
2020-02-11,부산,충북,105,14,34,97,193,6,449,84,19,15,119,178,4,419
2020-02-11,서울,강원,686,22,222,7,10,26,973,666,15,269,7,23,26,1006
2020-02-11,서울,경기,142861,6949,8899,4609,3131,9753,176202,143824,7366,8681,4970,3533,9994,178368
2020-02-11,서울,경남,2173,66,437,220,116,68,3080,1542,42,432,289,132,39,2476
2020-02-11,서울,경북,2696,85,332,275,117,72,3577,2464,132,337,419,138,62,3552
2020-02-11,서울,광주,692,26,32,47,9,19,825,515,25,20,59,15,10,644
2020-02-11,서울,대구,1584,54,143,142,43,28,1994,2157,82,190,260,117,67,2873
2020-02-11,서울,대전,1553,51,203,42,12,76,1937,1598,42,194,43,8,77,1962
2020-02-11,서울,부산,157,19,27,67,26,8,304,179,15,24,87,74,4,383
2020-02-11,서울,서울,194,5,8,4,3,11,225,194,5,8,4,3,11,225
2020-02-11,서울,세종,19,1,1,1,1,1,24,34,0,2,1,0,0,37
2020-02-11,서울,울산,24,0,3,1,2,0,30,17,0,4,11,16,1,49
2020-02-11,서울,전남,715,11,32,40,31,22,851,659,15,32,91,50,20,867
2020-02-11,서울,전북,1190,26,39,21,23,46,1345,1103,25,35,48,18,32,1261
2020-02-11,서울,충남,23245,552,2238,848,826,955,28664,23615,649,2242,1290,1278,926,30000
2020-02-11,서울,충북,13057,577,1149,804,730,515,16832,12506,656,1209,847,820,488,16526
2020-02-11,세종,강원,4,1,0,0,4,0,9,9,1,0,0,1,1,12
2020-02-11,세종,경기,32,4,5,0,4,1,46,34,0,2,2,3,1,42
2020-02-11,세종,경남,225,3,19,14,12,7,280,157,0,10,10,7,4,188
2020-02-11,세종,경북,230,8,27,18,25,6,314,262,6,20,29,19,5,341
2020-02-11,세종,광주,118,6,7,5,1,2,139,128,3,7,2,3,3,146
2020-02-11,세종,대구,182,2,6,2,6,6,204,234,5,12,10,13,7,281
2020-02-11,세종,대전,3438,120,77,35,61,304,4035,3345,100,85,29,54,272,3885
2020-02-11,세종,부산,11,0,2,4,1,0,18,19,0,0,8,7,0,34
2020-02-11,세종,서울,34,0,2,1,0,0,37,19,1,1,1,1,1,24
2020-02-11,세종,세종,233,22,5,2,3,16,281,233,22,5,2,3,16,281
2020-02-11,세종,울산,6,0,0,0,4,0,10,5,0,2,1,8,0,16
2020-02-11,세종,전남,161,6,3,10,12,3,195,140,3,2,8,15,2,170
2020-02-11,세종,전북,632,18,21,7,35,23,736,562,12,16,13,40,28,671
2020-02-11,세종,충남,5825,160,138,104,184,326,6737,4304,137,170,94,126,216,5047
2020-02-11,세종,충북,313,19,14,16,15,25,402,317,24,15,14,17,24,411
2020-02-11,울산,강원,1,0,0,0,0,0,1,1,0,0,0,0,0,1
2020-02-11,울산,경기,40,2,10,44,87,0,183,25,2,1,10,15,2,55
2020-02-11,울산,경남,9316,580,701,376,622,554,12149,10041,628,653,411,616,612,12961
2020-02-11,울산,경북,4913,156,322,343,1297,284,7315,4971,157,342,442,1032,265,7209
2020-02-11,울산,광주,26,3,7,4,4,0,44,48,0,8,7,2,1,66
2020-02-11,울산,대구,1269,58,154,65,189,43,1778,1262,64,149,89,152,56,1772
2020-02-11,울산,대전,74,4,9,18,22,0,127,80,2,12,27,27,2,150
2020-02-11,울산,부산,16515,409,435,402,2504,1161,21426,16372,401,496,701,2609,1147,21726
2020-02-11,울산,서울,17,0,4,11,16,1,49,24,0,3,1,2,0,30
2020-02-11,울산,세종,5,0,2,1,8,0,16,6,0,0,0,4,0,10
2020-02-11,울산,울산,8238,308,499,294,675,780,10794,8238,308,499,294,675,780,10794
2020-02-11,울산,전남,168,15,30,16,27,8,264,197,14,24,18,35,6,294
2020-02-11,울산,전북,44,2,8,5,14,2,75,46,2,10,9,2,0,69
2020-02-11,울산,충남,102,7,17,46,110,3,285,105,6,16,37,115,4,283
2020-02-11,울산,충북,17,2,5,21,50,2,97,25,1,5,5,32,0,68
2020-02-11,전남,강원,42,0,2,7,23,0,74,37,1,4,6,12,0,60
2020-02-11,전남,경기,699,17,79,119,107,28,1049,675,25,101,182,151,19,1153
2020-02-11,전남,경남,5656,269,472,466,1513,226,8602,5568,253,473,490,1557,246,8587
2020-02-11,전남,경북,1011,54,76,112,518,31,1802,947,41,83,118,455,30,1674
2020-02-11,전남,광주,31194,973,1113,750,1768,1240,37038,31861,968,1234,824,1811,1266,37964
2020-02-11,전남,대구,502,19,48,41,71,6,687,449,14,43,46,40,6,598
2020-02-11,전남,대전,324,8,18,24,23,4,401,264,8,8,40,26,9,355
2020-02-11,전남,부산,1651,79,132,154,599,62,2677,1825,86,153,180,554,69,2867
2020-02-11,전남,서울,659,15,32,91,50,20,867,715,11,32,40,31,22,851
2020-02-11,전남,세종,140,3,2,8,15,2,170,161,6,3,10,12,3,195
2020-02-11,전남,울산,197,14,24,18,35,6,294,168,15,30,16,27,8,264
2020-02-11,전남,전남,43649,1382,1675,2014,4901,1792,55413,43649,1382,1675,2014,4901,1792,55413
2020-02-11,전남,전북,4665,287,493,647,1293,135,7520,4506,252,452,652,1217,122,7201
2020-02-11,전남,충남,3920,129,474,711,1204,112,6550,3667,95,474,517,1033,101,5887
2020-02-11,전남,충북,340,20,34,118,281,6,799,338,16,43,107,269,10,783
2020-02-11,전북,강원,124,3,16,17,14,4,178,135,3,13,16,16,2,185
2020-02-11,전북,경기,1207,76,160,178,211,40,1872,1242,54,187,134,183,32,1832
2020-02-11,전북,경남,1086,55,137,110,171,33,1592,1060,55,121,115,154,27,1532
2020-02-11,전북,경북,1491,89,166,171,256,37,2210,1636,91,164,185,292,50,2418
2020-02-11,전북,광주,7717,477,467,335,359,321,9676,7527,438,537,322,352,301,9477
2020-02-11,전북,대구,357,15,42,25,20,11,470,384,16,44,16,18,10,488
2020-02-11,전북,대전,2896,94,93,84,46,140,3353,2913,68,100,94,52,154,3381
2020-02-11,전북,부산,269,10,45,57,70,4,455,292,12,46,46,89,7,492
2020-02-11,전북,서울,1103,25,35,48,18,32,1261,1190,26,39,21,23,46,1345
2020-02-11,전북,세종,562,12,16,13,40,28,671,632,18,21,7,35,23,736
2020-02-11,전북,울산,46,2,10,9,2,0,69,44,2,8,5,14,2,75
2020-02-11,전북,전남,4506,252,452,652,1217,122,7201,4665,287,493,647,1293,135,7520
2020-02-11,전북,전북,15898,623,919,702,808,625,19575,15898,623,919,702,808,625,19575
2020-02-11,전북,충남,12117,540,1506,1144,1415,408,17130,12338,528,1476,998,1384,436,17160
2020-02-11,전북,충북,1708,109,180,336,284,62,2679,1645,121,248,285,281,75,2655
2020-02-11,충남,강원,385,12,25,43,61,10,536,308,7,20,25,34,9,403
2020-02-11,충남,경기,36030,1510,2712,2433,4282,1867,48834,35914,1543,2824,2493,4626,1861,49261
2020-02-11,충남,경남,1435,57,182,330,541,49,2594,1100,48,157,266,236,35,1842
2020-02-11,충남,경북,3037,141,357,466,768,92,4861,2957,139,378,522,601,88,4685
2020-02-11,충남,광주,3548,129,519,560,327,103,5186,3471,104,513,443,249,89,4869
2020-02-11,충남,대구,1050,61,112,155,181,25,1584,1352,61,148,210,251,40,2062
2020-02-11,충남,대전,14655,458,480,223,271,1122,17209,16053,489,512,233,314,1256,18857
2020-02-11,충남,부산,100,12,31,103,209,4,459,128,7,32,73,177,5,422
2020-02-11,충남,서울,23615,649,2242,1290,1278,926,30000,23245,552,2238,848,826,955,28664
2020-02-11,충남,세종,4304,137,170,94,126,216,5047,5825,160,138,104,184,326,6737
2020-02-11,충남,울산,105,6,16,37,115,4,283,102,7,17,46,110,3,285
2020-02-11,충남,전남,3667,95,474,517,1033,101,5887,3920,129,474,711,1204,112,6550
2020-02-11,충남,전북,12338,528,1476,998,1384,436,17160,12117,540,1506,1144,1415,408,17130
2020-02-11,충남,충남,91552,3738,7819,7022,10240,4418,124789,91552,3738,7819,7022,10240,4418,124789
2020-02-11,충남,충북,13398,663,886,1010,1476,785,18218,12257,643,825,885,1429,730,16769
2020-02-11,충북,강원,4775,207,273,226,304,262,6047,4702,212,283,234,362,284,6077
2020-02-11,충북,경기,25744,2193,2869,2787,3568,1270,38431,26613,2217,2976,3313,3424,1285,39828
2020-02-11,충북,경남,1296,60,202,480,591,31,2660,1038,47,143,273,305,25,1831
2020-02-11,충북,경북,4779,275,610,697,1024,198,7583,4887,268,548,749,971,226,7649
2020-02-11,충북,광주,582,29,93,176,95,18,993,501,27,69,118,51,16,782
2020-02-11,충북,대구,1267,77,151,230,137,28,1890,1619,102,210,270,378,56,2635
2020-02-11,충북,대전,9649,378,408,176,128,745,11484,10771,492,498,224,152,790,12927
2020-02-11,충북,부산,84,19,15,119,178,4,419,105,14,34,97,193,6,449
2020-02-11,충북,서울,12506,656,1209,847,820,488,16526,13057,577,1149,804,730,515,16832
2020-02-11,충북,세종,317,24,15,14,17,24,411,313,19,14,16,15,25,402
2020-02-11,충북,울산,25,1,5,5,32,0,68,17,2,5,21,50,2,97
2020-02-11,충북,전남,338,16,43,107,269,10,783,340,20,34,118,281,6,799
2020-02-11,충북,전북,1645,121,248,285,281,75,2655,1708,109,180,336,284,62,2679
2020-02-11,충북,충남,12257,643,825,885,1429,730,16769,13398,663,886,1010,1476,785,18218
2020-02-11,충북,충북,36067,1967,2345,2162,2875,2122,47538,36067,1967,2345,2162,2875,2122,47538
2020-02-12,강원,강원,57363,1941,2811,1117,2337,4126,69695,57363,1941,2811,1117,2337,4126,69695
2020-02-12,강원,경기,15564,486,1181,596,658,754,19239,15369,513,1155,601,789,792,19219
2020-02-12,강원,경남,129,2,8,10,24,9,182,71,2,3,26,11,4,117
2020-02-12,강원,경북,349,24,40,24,35,12,484,326,13,22,34,48,15,458
2020-02-12,강원,광주,72,4,21,10,6,0,113,57,1,17,11,4,3,93
2020-02-12,강원,대구,169,2,5,9,7,4,196,218,3,15,17,14,8,275
2020-02-12,강원,대전,117,1,28,6,0,9,161,127,1,26,7,0,5,166
2020-02-12,강원,부산,3,0,2,1,1,0,7,6,0,1,1,3,0,11
2020-02-12,강원,서울,552,13,247,11,15,17,855,573,17,216,8,6,19,839
2020-02-12,강원,세종,6,0,0,0,0,1,7,3,1,0,0,0,0,4
2020-02-12,강원,울산,1,1,0,0,1,0,3,2,0,0,0,1,0,3
2020-02-12,강원,전남,35,0,2,3,6,0,46,43,2,1,5,13,2,66
2020-02-12,강원,전북,102,4,33,13,18,5,175,123,6,10,25,16,5,185
2020-02-12,강원,충남,268,8,23,24,37,10,370,315,10,22,40,67,6,460
2020-02-12,강원,충북,4190,186,271,232,275,246,5400,4082,161,283,210,255,233,5224
2020-02-12,경기,강원,15369,513,1155,601,789,792,19219,15564,486,1181,596,658,754,19239
2020-02-12,경기,경기,393775,20793,22909,16604,18061,30323,502465,393775,20793,22909,16604,18061,30323,502465
2020-02-12,경기,경남,2230,87,339,726,553,58,3993,1589,50,254,511,355,45,2804
2020-02-12,경기,경북,3551,175,491,678,601,122,5618,3406,177,446,833,540,95,5497
2020-02-12,경기,광주,680,33,167,279,145,12,1316,587,28,126,224,111,12,1088
2020-02-12,경기,대구,1815,73,196,357,229,46,2716,2309,110,220,448,372,77,3536
2020-02-12,경기,대전,1762,94,213,106,58,69,2302,1711,88,194,85,34,94,2206
2020-02-12,경기,부산,157,19,49,222,126,6,579,196,17,37,148,286,4,688
2020-02-12,경기,서울,136734,6621,8182,4253,2767,9457,168014,134869,6265,8403,4020,2551,9353,165461
2020-02-12,경기,세종,23,1,0,4,3,2,33,29,3,3,2,2,3,42
2020-02-12,경기,울산,41,1,2,10,20,1,75,40,3,6,31,71,0,151
2020-02-12,경기,전남,661,13,93,143,123,9,1042,633,14,71,117,121,17,973
2020-02-12,경기,전북,1046,44,162,103,167,40,1562,1029,61,135,162,173,33,1593
2020-02-12,경기,충남,31967,1352,2669,2156,3689,1650,43483,32304,1346,2490,2077,3417,1683,43317
2020-02-12,경기,충북,23798,1994,2791,2771,2842,1181,35377,23339,1937,2657,2554,2758,1064,34309
2020-02-12,경남,강원,71,2,3,26,11,4,117,129,2,8,10,24,9,182
2020-02-12,경남,경기,1589,50,254,511,355,45,2804,2230,87,339,726,553,58,3993
2020-02-12,경남,경남,171387,8752,8877,5583,10297,13592,218488,171387,8752,8877,5583,10297,13592,218488
2020-02-12,경남,경북,8363,516,832,804,1711,372,12598,10637,766,1040,1098,2341,493,16375
2020-02-12,경남,광주,909,43,134,160,128,20,1394,904,40,132,134,81,25,1316
2020-02-12,경남,대구,11626,647,880,986,1452,456,16047,9255,468,723,382,466,383,11677
2020-02-12,경남,대전,601,17,92,61,28,25,824,791,24,104,108,53,46,1126
2020-02-12,경남,부산,78012,2280,2713,1488,3745,5714,93952,76814,2343,2825,1446,4114,5635,93177
2020-02-12,경남,서울,1432,31,425,258,116,44,2306,1990,63,446,179,103,42,2823
2020-02-12,경남,세종,138,0,9,11,7,6,171,217,2,16,10,15,7,267
2020-02-12,경남,울산,8946,568,603,354,521,527,11519,8321,526,645,318,550,523,10883
2020-02-12,경남,전남,4907,231,401,437,1276,230,7482,5101,242,412,315,1366,218,7654
2020-02-12,경남,전북,891,32,124,79,150,33,1309,918,31,109,88,148,45,1339
2020-02-12,경남,충남,987,51,117,237,202,25,1619,1211,56,157,322,487,46,2279
2020-02-12,경남,충북,813,42,116,251,251,30,1503,1071,56,187,449,560,34,2357
2020-02-12,경북,강원,326,13,22,34,48,15,458,349,24,40,24,35,12,484
2020-02-12,경북,경기,3406,177,446,833,540,95,5497,3551,175,491,678,601,122,5618
2020-02-12,경북,경남,10637,766,1040,1098,2341,493,16375,8363,516,832,804,1711,372,12598
2020-02-12,경북,경북,64163,3195,3652,2598,3744,3615,80967,64163,3195,3652,2598,3744,3615,80967
2020-02-12,경북,광주,661,43,112,157,101,14,1088,659,40,77,146,71,9,1002
2020-02-12,경북,대구,66619,2528,2577,1331,1986,3712,78753,68206,2730,2956,1652,2424,3746,81714
2020-02-12,경북,대전,1457,42,111,106,64,63,1843,1454,45,108,118,59,55,1839
2020-02-12,경북,부산,3450,103,328,165,527,161,4734,3722,115,317,162,703,155,5174
2020-02-12,경북,서울,2380,77,313,355,126,51,3302,2486,77,323,215,109,80,3290
2020-02-12,경북,세종,233,5,16,20,18,6,298,227,8,13,22,11,7,288
2020-02-12,경북,울산,4346,136,293,422,945,249,6391,4197,122,297,309,1220,262,6407
2020-02-12,경북,전남,794,34,63,101,417,28,1437,801,39,69,88,501,20,1518
2020-02-12,경북,전북,1481,68,139,175,210,46,2119,1328,74,115,128,192,40,1877
2020-02-12,경북,충남,2582,121,343,495,528,79,4148,2765,99,326,432,712,104,4438
2020-02-12,경북,충북,4437,181,464,614,747,164,6607,4272,186,513,612,787,168,6538
2020-02-12,광주,강원,57,1,17,11,4,3,93,72,4,21,10,6,0,113
2020-02-12,광주,경기,587,28,126,224,111,12,1088,680,33,167,279,145,12,1316
2020-02-12,광주,경남,904,40,132,134,81,25,1316,909,43,134,160,128,20,1394
2020-02-12,광주,경북,659,40,77,146,71,9,1002,661,43,112,157,101,14,1088
2020-02-12,광주,광주,11257,392,556,314,189,507,13215,11257,392,556,314,189,507,13215
2020-02-12,광주,대구,538,27,98,70,28,9,770,538,28,96,59,24,9,754
2020-02-12,광주,대전,387,16,19,22,12,10,466,403,15,19,44,17,9,507
2020-02-12,광주,부산,319,7,45,32,66,5,474,356,13,47,70,82,14,582
2020-02-12,광주,서울,494,12,21,66,24,13,630,621,21,20,49,19,19,749
2020-02-12,광주,세종,129,1,8,3,1,3,145,151,4,5,3,2,3,168
2020-02-12,광주,울산,44,2,9,0,2,2,59,38,1,9,5,5,0,58
2020-02-12,광주,전남,28180,808,1024,576,1465,1150,33203,27838,803,902,526,1348,1176,32593
2020-02-12,광주,전북,6823,387,502,286,308,280,8586,6898,408,447,256,324,286,8619
2020-02-12,광주,충남,3333,91,514,418,214,102,4672,3308,112,528,522,335,104,4909
2020-02-12,광주,충북,465,20,56,96,64,13,714,558,27,81,160,85,12,923
2020-02-12,대구,강원,218,3,15,17,14,8,275,169,2,5,9,7,4,196
2020-02-12,대구,경기,2309,110,220,448,372,77,3536,1815,73,196,357,229,46,2716
2020-02-12,대구,경남,9255,468,723,382,466,383,11677,11626,647,880,986,1452,456,16047
2020-02-12,대구,경북,68206,2730,2956,1652,2424,3746,81714,66619,2528,2577,1331,1986,3712,78753
2020-02-12,대구,광주,538,28,96,59,24,9,754,538,27,98,70,28,9,770
2020-02-12,대구,대구,57384,1963,1676,713,857,3850,66443,57384,1963,1676,713,857,3850,66443
2020-02-12,대구,대전,838,28,58,67,37,36,1064,624,23,32,56,15,15,765
2020-02-12,대구,부산,445,49,87,48,134,11,774,2411,98,222,74,194,104,3103
2020-02-12,대구,서울,2055,63,175,218,105,50,2666,1514,55,146,110,54,37,1916
2020-02-12,대구,세종,201,3,18,7,11,3,243,136,3,5,5,2,4,155
2020-02-12,대구,울산,1145,42,130,73,148,51,1589,1174,43,118,71,172,47,1625
2020-02-12,대구,전남,415,9,45,28,41,4,542,413,12,35,40,49,11,560
2020-02-12,대구,전북,311,10,36,13,24,5,399,314,10,41,23,24,5,417
2020-02-12,대구,충남,1212,61,131,192,229,34,1859,976,61,110,159,157,35,1498
2020-02-12,대구,충북,1495,83,210,246,352,53,2439,1174,73,147,205,128,41,1768
2020-02-12,대전,강원,127,1,26,7,0,5,166,117,1,28,6,0,9,161
2020-02-12,대전,경기,1711,88,194,85,34,94,2206,1762,94,213,106,58,69,2302
2020-02-12,대전,경남,791,24,104,108,53,46,1126,601,17,92,61,28,25,824
2020-02-12,대전,경북,1454,45,108,118,59,55,1839,1457,42,111,106,64,63,1843
2020-02-12,대전,광주,403,15,19,44,17,9,507,387,16,19,22,12,10,466
2020-02-12,대전,대구,624,23,32,56,15,15,765,838,28,58,67,37,36,1064
2020-02-12,대전,대전,12515,325,380,154,105,1016,14495,12515,325,380,154,105,1016,14495
2020-02-12,대전,부산,41,2,8,7,16,2,76,58,3,6,22,11,3,103
2020-02-12,대전,서울,1412,42,204,36,12,62,1768,1485,40,190,31,17,66,1829
2020-02-12,대전,세종,3123,94,80,28,23,287,3635,3124,101,67,25,30,302,3649
2020-02-12,대전,울산,87,1,11,19,27,5,150,84,2,12,10,25,5,138
2020-02-12,대전,전남,225,4,6,29,21,4,289,254,6,8,25,14,8,315
2020-02-12,대전,전북,2367,63,89,80,49,116,2764,2538,79,86,65,39,121,2928
2020-02-12,대전,충남,14661,401,454,216,180,1134,17046,13323,394,453,191,185,1065,15611
2020-02-12,대전,충북,9943,414,395,175,144,753,11824,9079,343,380,146,126,696,10770
2020-02-12,부산,강원,6,0,1,1,3,0,11,3,0,2,1,1,0,7
2020-02-12,부산,경기,196,17,37,148,286,4,688,157,19,49,222,126,6,579
2020-02-12,부산,경남,76814,2343,2825,1446,4114,5635,93177,78012,2280,2713,1488,3745,5714,93952
2020-02-12,부산,경북,3722,115,317,162,703,155,5174,3450,103,328,165,527,161,4734
2020-02-12,부산,광주,356,13,47,70,82,14,582,319,7,45,32,66,5,474
2020-02-12,부산,대구,2411,98,222,74,194,104,3103,445,49,87,48,134,11,774
2020-02-12,부산,대전,58,3,6,22,11,3,103,41,2,8,7,16,2,76
2020-02-12,부산,부산,35986,573,613,420,1676,2750,42018,35986,573,613,420,1676,2750,42018
2020-02-12,부산,서울,160,13,16,66,63,5,323,138,15,19,74,29,3,278
2020-02-12,부산,세종,14,0,0,3,2,2,21,9,0,1,1,2,0,13
2020-02-12,부산,울산,14667,322,411,577,2330,1009,19316,14864,320,376,344,2313,1042,19259
2020-02-12,부산,전남,1656,64,107,154,548,58,2587,1506,47,84,112,532,57,2338
2020-02-12,부산,전북,265,5,26,35,78,6,415,201,8,26,34,63,4,336
2020-02-12,부산,충남,112,12,29,68,117,1,339,113,11,27,67,169,1,388
2020-02-12,부산,충북,87,12,17,82,157,7,362,82,16,28,105,152,3,386
2020-02-12,서울,강원,573,17,216,8,6,19,839,552,13,247,11,15,17,855
2020-02-12,서울,경기,134869,6265,8403,4020,2551,9353,165461,136734,6621,8182,4253,2767,9457,168014
2020-02-12,서울,경남,1990,63,446,179,103,42,2823,1432,31,425,258,116,44,2306
2020-02-12,서울,경북,2486,77,323,215,109,80,3290,2380,77,313,355,126,51,3302
2020-02-12,서울,광주,621,21,20,49,19,19,749,494,12,21,66,24,13,630
2020-02-12,서울,대구,1514,55,146,110,54,37,1916,2055,63,175,218,105,50,2666
2020-02-12,서울,대전,1485,40,190,31,17,66,1829,1412,42,204,36,12,62,1768
2020-02-12,서울,부산,138,15,19,74,29,3,278,160,13,16,66,63,5,323
2020-02-12,서울,서울,197,8,4,3,1,5,218,197,8,4,3,1,5,218
2020-02-12,서울,세종,32,0,2,0,0,2,36,29,0,1,1,0,1,32
2020-02-12,서울,울산,25,1,2,1,1,1,31,17,0,5,11,13,3,49
2020-02-12,서울,전남,672,5,22,41,30,19,789,618,9,25,61,50,16,779
2020-02-12,서울,전북,1012,27,35,19,15,28,1136,962,26,27,38,20,24,1097
2020-02-12,서울,충남,21376,444,2201,718,634,827,26200,21794,529,2175,1081,899,812,27290
2020-02-12,서울,충북,11369,511,1028,722,570,470,14670,11210,626,1063,730,653,467,14749
2020-02-12,세종,강원,3,1,0,0,0,0,4,6,0,0,0,0,1,7
2020-02-12,세종,경기,29,3,3,2,2,3,42,23,1,0,4,3,2,33
2020-02-12,세종,경남,217,2,16,10,15,7,267,138,0,9,11,7,6,171
2020-02-12,세종,경북,227,8,13,22,11,7,288,233,5,16,20,18,6,298
2020-02-12,세종,광주,151,4,5,3,2,3,168,129,1,8,3,1,3,145
2020-02-12,세종,대구,136,3,5,5,2,4,155,201,3,18,7,11,3,243
2020-02-12,세종,대전,3124,101,67,25,30,302,3649,3123,94,80,28,23,287,3635
2020-02-12,세종,부산,9,0,1,1,2,0,13,14,0,0,3,2,2,21
2020-02-12,세종,서울,29,0,1,1,0,1,32,32,0,2,0,0,2,36
2020-02-12,세종,세종,216,29,3,5,1,21,275,216,29,3,5,1,21,275
2020-02-12,세종,울산,6,0,0,3,1,0,10,2,0,0,1,1,1,5
2020-02-12,세종,전남,120,1,3,10,14,3,151,135,2,3,4,12,1,157
2020-02-12,세종,전북,587,22,22,9,23,25,688,544,10,17,10,27,18,626
2020-02-12,세종,충남,5297,143,152,82,92,290,6056,4047,141,143,90,98,211,4730
2020-02-12,세종,충북,341,10,16,10,12,22,411,277,7,16,7,10,13,330
2020-02-12,울산,강원,2,0,0,0,1,0,3,1,1,0,0,1,0,3
2020-02-12,울산,경기,40,3,6,31,71,0,151,41,1,2,10,20,1,75
2020-02-12,울산,경남,8321,526,645,318,550,523,10883,8946,568,603,354,521,527,11519
2020-02-12,울산,경북,4197,122,297,309,1220,262,6407,4346,136,293,422,945,249,6391
2020-02-12,울산,광주,38,1,9,5,5,0,58,44,2,9,0,2,2,59
2020-02-12,울산,대구,1174,43,118,71,172,47,1625,1145,42,130,73,148,51,1589
2020-02-12,울산,대전,84,2,12,10,25,5,138,87,1,11,19,27,5,150
2020-02-12,울산,부산,14864,320,376,344,2313,1042,19259,14667,322,411,577,2330,1009,19316
2020-02-12,울산,서울,17,0,5,11,13,3,49,25,1,2,1,1,1,31
2020-02-12,울산,세종,2,0,0,1,1,1,5,6,0,0,3,1,0,10
2020-02-12,울산,울산,7672,254,470,253,474,708,9831,7672,254,470,253,474,708,9831
2020-02-12,울산,전남,173,7,21,18,19,2,240,161,13,14,12,26,4,230
2020-02-12,울산,전북,53,0,8,3,18,0,82,44,0,7,2,2,0,55
2020-02-12,울산,충남,85,2,13,45,126,4,275,122,5,18,33,104,0,282
2020-02-12,울산,충북,10,2,7,14,51,1,85,20,2,2,10,32,0,66
2020-02-12,전남,강원,43,2,1,5,13,2,66,35,0,2,3,6,0,46
2020-02-12,전남,경기,633,14,71,117,121,17,973,661,13,93,143,123,9,1042
2020-02-12,전남,경남,5101,242,412,315,1366,218,7654,4907,231,401,437,1276,230,7482
2020-02-12,전남,경북,801,39,69,88,501,20,1518,794,34,63,101,417,28,1437
2020-02-12,전남,광주,27838,803,902,526,1348,1176,32593,28180,808,1024,576,1465,1150,33203
2020-02-12,전남,대구,413,12,35,40,49,11,560,415,9,45,28,41,4,542
2020-02-12,전남,대전,254,6,8,25,14,8,315,225,4,6,29,21,4,289
2020-02-12,전남,부산,1506,47,84,112,532,57,2338,1656,64,107,154,548,58,2587
2020-02-12,전남,서울,618,9,25,61,50,16,779,672,5,22,41,30,19,789
2020-02-12,전남,세종,135,2,3,4,12,1,157,120,1,3,10,14,3,151
2020-02-12,전남,울산,161,13,14,12,26,4,230,173,7,21,18,19,2,240
2020-02-12,전남,전남,38469,1053,1242,1229,3370,1575,46938,38469,1053,1242,1229,3370,1575,46938
2020-02-12,전남,전북,3993,224,467,448,1017,123,6272,3668,186,433,499,1027,111,5924
2020-02-12,전남,충남,3566,104,401,569,1139,105,5884,3443,80,404,459,944,86,5416
2020-02-12,전남,충북,311,16,33,100,232,2,694,276,11,51,92,225,10,665
2020-02-12,전북,강원,123,6,10,25,16,5,185,102,4,33,13,18,5,175
2020-02-12,전북,경기,1029,61,135,162,173,33,1593,1046,44,162,103,167,40,1562
2020-02-12,전북,경남,918,31,109,88,148,45,1339,891,32,124,79,150,33,1309
2020-02-12,전북,경북,1328,74,115,128,192,40,1877,1481,68,139,175,210,46,2119
2020-02-12,전북,광주,6898,408,447,256,324,286,8619,6823,387,502,286,308,280,8586
2020-02-12,전북,대구,314,10,41,23,24,5,417,311,10,36,13,24,5,399
2020-02-12,전북,대전,2538,79,86,65,39,121,2928,2367,63,89,80,49,116,2764
2020-02-12,전북,부산,201,8,26,34,63,4,336,265,5,26,35,78,6,415
2020-02-12,전북,서울,962,26,27,38,20,24,1097,1012,27,35,19,15,28,1136
2020-02-12,전북,세종,544,10,17,10,27,18,626,587,22,22,9,23,25,688
2020-02-12,전북,울산,44,0,7,2,2,0,55,53,0,8,3,18,0,82
2020-02-12,전북,전남,3668,186,433,499,1027,111,5924,3993,224,467,448,1017,123,6272
2020-02-12,전북,전북,14218,476,774,545,614,590,17217,14218,476,774,545,614,590,17217
2020-02-12,전북,충남,11210,426,1473,979,1250,379,15717,11085,417,1435,865,1244,407,15453
2020-02-12,전북,충북,1474,102,179,243,217,47,2262,1460,108,193,247,212,43,2263
2020-02-12,충남,강원,315,10,22,40,67,6,460,268,8,23,24,37,10,370
2020-02-12,충남,경기,32304,1346,2490,2077,3417,1683,43317,31967,1352,2669,2156,3689,1650,43483
2020-02-12,충남,경남,1211,56,157,322,487,46,2279,987,51,117,237,202,25,1619
2020-02-12,충남,경북,2765,99,326,432,712,104,4438,2582,121,343,495,528,79,4148
2020-02-12,충남,광주,3308,112,528,522,335,104,4909,3333,91,514,418,214,102,4672
2020-02-12,충남,대구,976,61,110,159,157,35,1498,1212,61,131,192,229,34,1859
2020-02-12,충남,대전,13323,394,453,191,185,1065,15611,14661,401,454,216,180,1134,17046
2020-02-12,충남,부산,113,11,27,67,169,1,388,112,12,29,68,117,1,339
2020-02-12,충남,서울,21794,529,2175,1081,899,812,27290,21376,444,2201,718,634,827,26200
2020-02-12,충남,세종,4047,141,143,90,98,211,4730,5297,143,152,82,92,290,6056
2020-02-12,충남,울산,122,5,18,33,104,0,282,85,2,13,45,126,4,275
2020-02-12,충남,전남,3443,80,404,459,944,86,5416,3566,104,401,569,1139,105,5884
2020-02-12,충남,전북,11085,417,1435,865,1244,407,15453,11210,426,1473,979,1250,379,15717
2020-02-12,충남,충남,85404,2993,7494,6382,8935,4145,115353,85404,2993,7494,6382,8935,4145,115353
2020-02-12,충남,충북,12388,585,798,903,1253,757,16684,11270,543,767,761,1287,682,15310
2020-02-12,충북,강원,4082,161,283,210,255,233,5224,4190,186,271,232,275,246,5400
2020-02-12,충북,경기,23339,1937,2657,2554,2758,1064,34309,23798,1994,2791,2771,2842,1181,35377
2020-02-12,충북,경남,1071,56,187,449,560,34,2357,813,42,116,251,251,30,1503
2020-02-12,충북,경북,4272,186,513,612,787,168,6538,4437,181,464,614,747,164,6607
2020-02-12,충북,광주,558,27,81,160,85,12,923,465,20,56,96,64,13,714
2020-02-12,충북,대구,1174,73,147,205,128,41,1768,1495,83,210,246,352,53,2439
2020-02-12,충북,대전,9079,343,380,146,126,696,10770,9943,414,395,175,144,753,11824
2020-02-12,충북,부산,82,16,28,105,152,3,386,87,12,17,82,157,7,362
2020-02-12,충북,서울,11210,626,1063,730,653,467,14749,11369,511,1028,722,570,470,14670
2020-02-12,충북,세종,277,7,16,7,10,13,330,341,10,16,10,12,22,411
2020-02-12,충북,울산,20,2,2,10,32,0,66,10,2,7,14,51,1,85
2020-02-12,충북,전남,276,11,51,92,225,10,665,311,16,33,100,232,2,694
2020-02-12,충북,전북,1460,108,193,247,212,43,2263,1474,102,179,243,217,47,2262
2020-02-12,충북,충남,11270,543,767,761,1287,682,15310,12388,585,798,903,1253,757,16684
2020-02-12,충북,충북,33316,1721,2165,1898,2426,1903,43429,33316,1721,2165,1898,2426,1903,43429
2020-02-13,강원,강원,63001,2142,3078,1255,2483,4242,76201,63001,2142,3078,1255,2483,4242,76201
2020-02-13,강원,경기,17173,573,1228,628,750,797,21149,19693,634,1216,644,921,887,23995
2020-02-13,강원,경남,171,2,12,20,31,5,241,98,1,4,25,11,8,147
2020-02-13,강원,경북,416,21,35,24,28,18,542,399,12,33,26,35,10,515
2020-02-13,강원,광주,80,2,19,4,7,2,114,72,2,15,10,2,3,104
2020-02-13,강원,대구,194,6,7,7,7,10,231,237,11,27,19,16,10,320
2020-02-13,강원,대전,157,3,32,1,0,5,198,164,9,30,0,1,9,213
2020-02-13,강원,부산,3,0,1,2,1,0,7,4,0,0,0,1,0,5
2020-02-13,강원,서울,678,24,266,9,14,16,1007,710,10,219,7,9,23,978
2020-02-13,강원,세종,10,0,1,0,2,1,14,9,0,2,0,2,0,13
2020-02-13,강원,울산,2,0,0,0,0,0,2,3,0,0,2,0,0,5
2020-02-13,강원,전남,46,2,1,6,14,2,71,54,2,3,4,22,0,85
2020-02-13,강원,전북,111,1,9,15,10,4,150,140,2,10,17,20,5,194
2020-02-13,강원,충남,295,3,13,25,45,14,395,407,7,14,48,63,15,554
2020-02-13,강원,충북,4522,241,306,213,276,263,5821,4686,177,287,196,246,299,5891
2020-02-13,경기,강원,19693,634,1216,644,921,887,23995,17173,573,1228,628,750,797,21149
2020-02-13,경기,경기,422448,23137,24625,19584,20748,31567,542109,422448,23137,24625,19584,20748,31567,542109
2020-02-13,경기,경남,2563,101,341,728,605,92,4430,1775,86,255,511,448,60,3135
2020-02-13,경기,경북,4092,184,525,740,583,125,6249,4024,191,490,865,584,137,6291
2020-02-13,경기,광주,819,38,147,282,163,26,1475,658,23,108,255,93,13,1150
2020-02-13,경기,대구,1958,109,240,366,230,53,2956,2789,122,236,459,447,82,4135
2020-02-13,경기,대전,1958,88,193,115,46,76,2476,1911,113,198,97,40,83,2442
2020-02-13,경기,부산,216,22,35,192,168,4,637,284,35,26,144,254,12,755
2020-02-13,경기,서울,147480,7376,9087,4679,3164,9906,181692,145748,6956,8882,4236,2810,9808,178440
2020-02-13,경기,세종,37,2,2,2,1,0,44,52,5,5,6,2,1,71
2020-02-13,경기,울산,39,2,5,19,15,1,81,45,4,13,30,79,3,174
2020-02-13,경기,전남,713,20,93,172,139,16,1153,717,26,84,143,130,27,1127
2020-02-13,경기,전북,1259,51,145,128,179,34,1796,1163,54,149,158,188,36,1748
2020-02-13,경기,충남,36394,1545,2775,2405,4050,1863,49032,35928,1521,2675,2314,3892,1847,48177
2020-02-13,경기,충북,26738,2155,2974,3068,3057,1276,39268,26091,2130,2751,2743,3242,1258,38215
2020-02-13,경남,강원,98,1,4,25,11,8,147,171,2,12,20,31,5,241
2020-02-13,경남,경기,1775,86,255,511,448,60,3135,2563,101,341,728,605,92,4430
2020-02-13,경남,경남,195832,10219,10277,7056,11636,14871,249891,195832,10219,10277,7056,11636,14871,249891
2020-02-13,경남,경북,10013,616,1016,906,1797,452,14800,12730,883,1236,1220,2525,573,19167
2020-02-13,경남,광주,1006,43,138,153,124,35,1499,993,41,147,145,95,41,1462
2020-02-13,경남,대구,13393,756,990,1005,1557,546,18247,10920,526,765,393,494,423,13521
2020-02-13,경남,대전,717,12,97,92,33,21,972,1016,32,112,110,67,40,1377
2020-02-13,경남,부산,89782,2727,2947,1771,4414,6276,107917,89315,2830,3135,1825,4888,6340,108333
2020-02-13,경남,서울,1619,32,446,280,131,51,2559,2328,61,440,195,108,65,3197
2020-02-13,경남,세종,193,1,12,6,12,9,233,262,4,23,8,8,7,312
2020-02-13,경남,울산,10035,626,702,445,556,613,12977,9686,573,716,389,576,582,12522
2020-02-13,경남,전남,5761,265,452,460,1373,269,8580,5668,280,429,410,1421,235,8443
2020-02-13,경남,전북,1129,48,120,95,188,33,1613,1134,46,108,93,176,35,1592
2020-02-13,경남,충남,1041,44,127,258,226,37,1733,1592,61,159,340,465,57,2674
2020-02-13,경남,충북,1041,55,126,283,292,28,1825,1334,64,193,474,560,37,2662
2020-02-13,경북,강원,399,12,33,26,35,10,515,416,21,35,24,28,18,542
2020-02-13,경북,경기,4024,191,490,865,584,137,6291,4092,184,525,740,583,125,6249
2020-02-13,경북,경남,12730,883,1236,1220,2525,573,19167,10013,616,1016,906,1797,452,14800
2020-02-13,경북,경북,74353,3784,4128,2906,4328,3952,93451,74353,3784,4128,2906,4328,3952,93451
2020-02-13,경북,광주,774,40,102,163,106,17,1202,733,31,94,157,66,17,1098
2020-02-13,경북,대구,73593,2866,2771,1499,3074,4038,87841,77340,3087,3229,1798,3438,4067,92959
2020-02-13,경북,대전,1652,59,117,111,73,72,2084,1671,61,106,136,65,67,2106
2020-02-13,경북,부산,4326,131,295,197,666,195,5810,4706,145,329,207,741,220,6348
2020-02-13,경북,서울,2703,104,338,410,118,85,3758,2790,94,320,242,122,85,3653
2020-02-13,경북,세종,262,6,20,21,16,4,329,266,9,17,14,15,7,328
2020-02-13,경북,울산,5115,163,342,427,991,322,7360,5176,154,321,320,1253,280,7504
2020-02-13,경북,전남,943,58,57,103,418,33,1612,902,36,55,92,502,28,1615
2020-02-13,경북,전북,1664,74,163,189,248,50,2388,1391,78,141,144,245,44,2043
2020-02-13,경북,충남,2964,149,336,530,605,96,4680,3206,121,305,431,743,110,4916
2020-02-13,경북,충북,5122,213,517,662,854,211,7579,4961,236,541,661,928,197,7524
2020-02-13,광주,강원,72,2,15,10,2,3,104,80,2,19,4,7,2,114
2020-02-13,광주,경기,658,23,108,255,93,13,1150,819,38,147,282,163,26,1475
2020-02-13,광주,경남,993,41,147,145,95,41,1462,1006,43,138,153,124,35,1499
2020-02-13,광주,경북,733,31,94,157,66,17,1098,774,40,102,163,106,17,1202
2020-02-13,광주,광주,12481,480,600,333,233,509,14636,12481,480,600,333,233,509,14636
2020-02-13,광주,대구,587,28,97,70,34,15,831,662,27,112,70,27,12,910
2020-02-13,광주,대전,408,22,19,22,16,8,495,459,25,13,47,18,15,577
2020-02-13,광주,부산,371,15,41,43,66,10,546,392,20,38,76,101,15,642
2020-02-13,광주,서울,613,16,27,65,23,18,762,702,18,20,43,20,24,827
2020-02-13,광주,세종,137,3,7,2,4,2,155,169,2,6,1,2,2,182
2020-02-13,광주,울산,44,4,11,2,2,2,65,52,1,7,5,7,0,72
2020-02-13,광주,전남,32169,948,1131,694,1498,1186,37626,30549,916,1000,624,1375,1164,35628
2020-02-13,광주,전북,7501,410,557,341,337,291,9437,7468,432,491,306,316,289,9302
2020-02-13,광주,충남,3767,102,506,441,216,99,5131,3888,113,538,490,348,89,5466
2020-02-13,광주,충북,501,20,58,91,53,9,732,574,38,79,165,89,17,962
2020-02-13,대구,강원,237,11,27,19,16,10,320,194,6,7,7,7,10,231
2020-02-13,대구,경기,2789,122,236,459,447,82,4135,1958,109,240,366,230,53,2956
2020-02-13,대구,경남,10920,526,765,393,494,423,13521,13393,756,990,1005,1557,546,18247
2020-02-13,대구,경북,77340,3087,3229,1798,3438,4067,92959,73593,2866,2771,1499,3074,4038,87841
2020-02-13,대구,광주,662,27,112,70,27,12,910,587,28,97,70,34,15,831
2020-02-13,대구,대구,60946,2220,1828,898,1114,4058,71064,60946,2220,1828,898,1114,4058,71064
2020-02-13,대구,대전,1045,40,55,82,34,37,1293,692,27,29,42,16,27,833
2020-02-13,대구,부산,610,55,107,74,148,29,1023,2923,100,224,100,213,124,3684
2020-02-13,대구,서울,2544,86,177,202,98,63,3170,1697,57,156,134,52,42,2138
2020-02-13,대구,세종,274,3,12,9,16,10,324,156,2,6,3,4,4,175
2020-02-13,대구,울산,1298,52,139,72,155,53,1769,1347,54,140,87,175,56,1859
2020-02-13,대구,전남,503,12,39,24,37,23,638,471,21,39,32,72,18,653
2020-02-13,대구,전북,385,10,38,18,25,7,483,331,13,44,20,34,11,453
2020-02-13,대구,충남,1490,70,130,189,229,57,2165,1115,47,125,143,163,33,1626
2020-02-13,대구,충북,1800,81,205,278,345,52,2761,1355,94,157,240,146,40,2032
2020-02-13,대전,강원,164,9,30,0,1,9,213,157,3,32,1,0,5,198
2020-02-13,대전,경기,1911,113,198,97,40,83,2442,1958,88,193,115,46,76,2476
2020-02-13,대전,경남,1016,32,112,110,67,40,1377,717,12,97,92,33,21,972
2020-02-13,대전,경북,1671,61,106,136,65,67,2106,1652,59,117,111,73,72,2084
2020-02-13,대전,광주,459,25,13,47,18,15,577,408,22,19,22,16,8,495
2020-02-13,대전,대구,692,27,29,42,16,27,833,1045,40,55,82,34,37,1293
2020-02-13,대전,대전,13431,417,437,930,178,990,16383,13431,417,437,930,178,990,16383
2020-02-13,대전,부산,61,2,8,19,15,1,106,79,1,8,13,22,1,124
2020-02-13,대전,서울,1723,45,196,27,11,76,2078,1691,40,193,38,13,72,2047
2020-02-13,대전,세종,3366,95,80,25,37,276,3879,3338,101,93,31,58,286,3907
2020-02-13,대전,울산,87,5,10,10,30,0,142,82,1,14,13,16,1,127
2020-02-13,대전,전남,274,6,9,27,28,5,349,263,5,12,24,16,7,327
2020-02-13,대전,전북,2874,73,97,77,49,147,3317,2828,100,85,66,44,147,3270
2020-02-13,대전,충남,15794,455,498,253,228,1239,18467,14454,434,432,226,223,1123,16892
2020-02-13,대전,충북,11021,449,443,201,151,797,13062,9971,389,376,169,134,741,11780
2020-02-13,부산,강원,4,0,0,0,1,0,5,3,0,1,2,1,0,7
2020-02-13,부산,경기,284,35,26,144,254,12,755,216,22,35,192,168,4,637
2020-02-13,부산,경남,89315,2830,3135,1825,4888,6340,108333,89782,2727,2947,1771,4414,6276,107917
2020-02-13,부산,경북,4706,145,329,207,741,220,6348,4326,131,295,197,666,195,5810
2020-02-13,부산,광주,392,20,38,76,101,15,642,371,15,41,43,66,10,546
2020-02-13,부산,대구,2923,100,224,100,213,124,3684,610,55,107,74,148,29,1023
2020-02-13,부산,대전,79,1,8,13,22,1,124,61,2,8,19,15,1,106
2020-02-13,부산,부산,46883,760,714,741,2017,3442,54557,46883,760,714,741,2017,3442,54557
2020-02-13,부산,서울,199,7,21,77,51,4,359,195,12,16,66,46,5,340
2020-02-13,부산,세종,15,1,1,2,5,1,25,10,0,0,1,3,2,16
2020-02-13,부산,울산,17555,397,475,680,2627,1195,22929,17336,428,415,408,2567,1244,22398
2020-02-13,부산,전남,1854,87,147,190,570,79,2927,1667,77,117,140,677,71,2749
2020-02-13,부산,전북,286,5,28,37,97,6,459,257,9,27,37,69,12,411
2020-02-13,부산,충남,137,14,24,73,140,3,391,146,12,24,58,220,2,462
2020-02-13,부산,충북,94,13,19,89,177,2,394,109,14,23,128,195,1,470
2020-02-13,서울,강원,710,10,219,7,9,23,978,678,24,266,9,14,16,1007
2020-02-13,서울,경기,145748,6956,8882,4236,2810,9808,178440,147480,7376,9087,4679,3164,9906,181692
2020-02-13,서울,경남,2328,61,440,195,108,65,3197,1619,32,446,280,131,51,2559
2020-02-13,서울,경북,2790,94,320,242,122,85,3653,2703,104,338,410,118,85,3758
2020-02-13,서울,광주,702,18,20,43,20,24,827,613,16,27,65,23,18,762
2020-02-13,서울,대구,1697,57,156,134,52,42,2138,2544,86,177,202,98,63,3170
2020-02-13,서울,대전,1691,40,193,38,13,72,2047,1723,45,196,27,11,76,2078
2020-02-13,서울,부산,195,12,16,66,46,5,340,199,7,21,77,51,4,359
2020-02-13,서울,서울,185,10,13,2,2,13,225,185,10,13,2,2,13,225
2020-02-13,서울,세종,37,0,0,0,0,1,38,32,0,1,1,0,1,35
2020-02-13,서울,울산,32,0,5,0,2,1,40,23,2,4,12,9,0,50
2020-02-13,서울,전남,787,11,27,42,34,32,933,730,11,28,62,40,17,888
2020-02-13,서울,전북,1157,20,39,24,24,27,1291,1056,24,36,30,22,39,1207
2020-02-13,서울,충남,24432,499,2261,774,636,965,29567,24784,595,2289,1264,1106,969,31007
2020-02-13,서울,충북,13429,518,1052,657,594,494,16744,13271,606,1110,760,690,481,16918
2020-02-13,세종,강원,9,0,2,0,2,0,13,10,0,1,0,2,1,14
2020-02-13,세종,경기,52,5,5,6,2,1,71,37,2,2,2,1,0,44
2020-02-13,세종,경남,262,4,23,8,8,7,312,193,1,12,6,12,9,233
2020-02-13,세종,경북,266,9,17,14,15,7,328,262,6,20,21,16,4,329
2020-02-13,세종,광주,169,2,6,1,2,2,182,137,3,7,2,4,2,155
2020-02-13,세종,대구,156,2,6,3,4,4,175,274,3,12,9,16,10,324
2020-02-13,세종,대전,3338,101,93,31,58,286,3907,3366,95,80,25,37,276,3879
2020-02-13,세종,부산,10,0,0,1,3,2,16,15,1,1,2,5,1,25
2020-02-13,세종,서울,32,0,1,1,0,1,35,37,0,0,0,0,1,38
2020-02-13,세종,세종,232,25,1,2,1,19,280,232,25,1,2,1,19,280
2020-02-13,세종,울산,5,0,0,1,1,0,7,5,1,1,3,6,1,17
2020-02-13,세종,전남,137,5,4,3,10,2,161,126,3,1,7,20,3,160
2020-02-13,세종,전북,653,20,23,9,25,31,761,623,15,25,14,36,15,728
2020-02-13,세종,충남,5785,147,145,82,139,295,6593,4426,141,136,96,133,232,5164
2020-02-13,세종,충북,365,10,13,24,24,21,457,319,12,20,13,10,31,405
2020-02-13,울산,강원,3,0,0,2,0,0,5,2,0,0,0,0,0,2
2020-02-13,울산,경기,45,4,13,30,79,3,174,39,2,5,19,15,1,81
2020-02-13,울산,경남,9686,573,716,389,576,582,12522,10035,626,702,445,556,613,12977
2020-02-13,울산,경북,5176,154,321,320,1253,280,7504,5115,163,342,427,991,322,7360
2020-02-13,울산,광주,52,1,7,5,7,0,72,44,4,11,2,2,2,65
2020-02-13,울산,대구,1347,54,140,87,175,56,1859,1298,52,139,72,155,53,1769
2020-02-13,울산,대전,82,1,14,13,16,1,127,87,5,10,10,30,0,142
2020-02-13,울산,부산,17336,428,415,408,2567,1244,22398,17555,397,475,680,2627,1195,22929
2020-02-13,울산,서울,23,2,4,12,9,0,50,32,0,5,0,2,1,40
2020-02-13,울산,세종,5,1,1,3,6,1,17,5,0,0,1,1,0,7
2020-02-13,울산,울산,8425,302,581,294,612,820,11034,8425,302,581,294,612,820,11034
2020-02-13,울산,전남,158,6,27,18,25,4,238,185,11,24,11,47,6,284
2020-02-13,울산,전북,40,2,9,3,8,1,63,31,1,7,6,5,2,52
2020-02-13,울산,충남,98,3,17,37,122,1,278,125,2,11,37,112,4,291
2020-02-13,울산,충북,14,3,3,14,46,2,82,24,2,1,12,39,3,81
2020-02-13,전남,강원,54,2,3,4,22,0,85,46,2,1,6,14,2,71
2020-02-13,전남,경기,717,26,84,143,130,27,1127,713,20,93,172,139,16,1153
2020-02-13,전남,경남,5668,280,429,410,1421,235,8443,5761,265,452,460,1373,269,8580
2020-02-13,전남,경북,902,36,55,92,502,28,1615,943,58,57,103,418,33,1612
2020-02-13,전남,광주,30549,916,1000,624,1375,1164,35628,32169,948,1131,694,1498,1186,37626
2020-02-13,전남,대구,471,21,39,32,72,18,653,503,12,39,24,37,23,638
2020-02-13,전남,대전,263,5,12,24,16,7,327,274,6,9,27,28,5,349
2020-02-13,전남,부산,1667,77,117,140,677,71,2749,1854,87,147,190,570,79,2927
2020-02-13,전남,서울,730,11,28,62,40,17,888,787,11,27,42,34,32,933
2020-02-13,전남,세종,126,3,1,7,20,3,160,137,5,4,3,10,2,161
2020-02-13,전남,울산,185,11,24,11,47,6,284,158,6,27,18,25,4,238
2020-02-13,전남,전남,42914,1198,1455,1401,4160,1819,52947,42914,1198,1455,1401,4160,1819,52947
2020-02-13,전남,전북,4645,292,440,468,1116,137,7098,4574,241,422,542,1068,133,6980
2020-02-13,전남,충남,4011,92,438,687,1218,110,6556,4139,82,443,511,888,114,6177
2020-02-13,전남,충북,320,19,36,81,230,11,697,358,26,46,69,238,10,747
2020-02-13,전북,강원,140,2,10,17,20,5,194,111,1,9,15,10,4,150
2020-02-13,전북,경기,1163,54,149,158,188,36,1748,1259,51,145,128,179,34,1796
2020-02-13,전북,경남,1134,46,108,93,176,35,1592,1129,48,120,95,188,33,1613
2020-02-13,전북,경북,1391,78,141,144,245,44,2043,1664,74,163,189,248,50,2388
2020-02-13,전북,광주,7468,432,491,306,316,289,9302,7501,410,557,341,337,291,9437
2020-02-13,전북,대구,331,13,44,20,34,11,453,385,10,38,18,25,7,483
2020-02-13,전북,대전,2828,100,85,66,44,147,3270,2874,73,97,77,49,147,3317
2020-02-13,전북,부산,257,9,27,37,69,12,411,286,5,28,37,97,6,459
2020-02-13,전북,서울,1056,24,36,30,22,39,1207,1157,20,39,24,24,27,1291
2020-02-13,전북,세종,623,15,25,14,36,15,728,653,20,23,9,25,31,761
2020-02-13,전북,울산,31,1,7,6,5,2,52,40,2,9,3,8,1,63
2020-02-13,전북,전남,4574,241,422,542,1068,133,6980,4645,292,440,468,1116,137,7098
2020-02-13,전북,전북,15550,584,822,767,748,593,19064,15550,584,822,767,748,593,19064
2020-02-13,전북,충남,12594,488,1452,1063,1260,427,17284,12525,501,1465,922,1258,441,17112
2020-02-13,전북,충북,1642,125,170,261,209,64,2471,1634,115,170,265,244,64,2492
2020-02-13,충남,강원,407,7,14,48,63,15,554,295,3,13,25,45,14,395
2020-02-13,충남,경기,35928,1521,2675,2314,3892,1847,48177,36394,1545,2775,2405,4050,1863,49032
2020-02-13,충남,경남,1592,61,159,340,465,57,2674,1041,44,127,258,226,37,1733
2020-02-13,충남,경북,3206,121,305,431,743,110,4916,2964,149,336,530,605,96,4680
2020-02-13,충남,광주,3888,113,538,490,348,89,5466,3767,102,506,441,216,99,5131
2020-02-13,충남,대구,1115,47,125,143,163,33,1626,1490,70,130,189,229,57,2165
2020-02-13,충남,대전,14454,434,432,226,223,1123,16892,15794,455,498,253,228,1239,18467
2020-02-13,충남,부산,146,12,24,58,220,2,462,137,14,24,73,140,3,391
2020-02-13,충남,서울,24784,595,2289,1264,1106,969,31007,24432,499,2261,774,636,965,29567
2020-02-13,충남,세종,4426,141,136,96,133,232,5164,5785,147,145,82,139,295,6593
2020-02-13,충남,울산,125,2,11,37,112,4,291,98,3,17,37,122,1,278
2020-02-13,충남,전남,4139,82,443,511,888,114,6177,4011,92,438,687,1218,110,6556
2020-02-13,충남,전북,12525,501,1465,922,1258,441,17112,12594,488,1452,1063,1260,427,17284
2020-02-13,충남,충남,94631,3368,7754,6730,9618,4563,126664,94631,3368,7754,6730,9618,4563,126664
2020-02-13,충남,충북,13611,614,796,951,1448,770,18190,12344,597,803,854,1378,699,16675
2020-02-13,충북,강원,4686,177,287,196,246,299,5891,4522,241,306,213,276,263,5821
2020-02-13,충북,경기,26091,2130,2751,2743,3242,1258,38215,26738,2155,2974,3068,3057,1276,39268
2020-02-13,충북,경남,1334,64,193,474,560,37,2662,1041,55,126,283,292,28,1825
2020-02-13,충북,경북,4961,236,541,661,928,197,7524,5122,213,517,662,854,211,7579
2020-02-13,충북,광주,574,38,79,165,89,17,962,501,20,58,91,53,9,732
2020-02-13,충북,대구,1355,94,157,240,146,40,2032,1800,81,205,278,345,52,2761
2020-02-13,충북,대전,9971,389,376,169,134,741,11780,11021,449,443,201,151,797,13062
2020-02-13,충북,부산,109,14,23,128,195,1,470,94,13,19,89,177,2,394
2020-02-13,충북,서울,13271,606,1110,760,690,481,16918,13429,518,1052,657,594,494,16744
2020-02-13,충북,세종,319,12,20,13,10,31,405,365,10,13,24,24,21,457
2020-02-13,충북,울산,24,2,1,12,39,3,81,14,3,3,14,46,2,82
2020-02-13,충북,전남,358,26,46,69,238,10,747,320,19,36,81,230,11,697
2020-02-13,충북,전북,1634,115,170,265,244,64,2492,1642,125,170,261,209,64,2471
2020-02-13,충북,충남,12344,597,803,854,1378,699,16675,13611,614,796,951,1448,770,18190
2020-02-13,충북,충북,36557,1912,2249,2109,2708,2111,47646,36557,1912,2249,2109,2708,2111,47646
2020-02-14,강원,강원,79656,2173,3100,1311,2418,5034,93692,79656,2173,3100,1311,2418,5034,93692
2020-02-14,강원,경기,22775,555,1242,654,764,1110,27100,30824,601,1199,690,886,1313,35513
2020-02-14,강원,경남,232,7,16,12,21,6,294,134,2,11,22,20,6,195
2020-02-14,강원,경북,602,23,36,19,34,30,744,582,14,26,33,37,17,709
2020-02-14,강원,광주,130,1,21,11,10,4,177,80,3,15,10,3,1,112
2020-02-14,강원,대구,296,3,10,13,8,10,340,464,4,17,20,10,15,530
2020-02-14,강원,대전,233,7,26,7,0,9,282,208,5,21,5,3,10,252
2020-02-14,강원,부산,3,0,0,0,3,2,8,1,1,2,1,0,0,5
2020-02-14,강원,서울,749,14,289,16,26,30,1124,1046,22,249,9,13,38,1377
2020-02-14,강원,세종,4,0,0,0,1,1,6,12,0,0,0,1,0,13
2020-02-14,강원,울산,2,0,0,0,0,0,2,2,0,0,0,0,0,2
2020-02-14,강원,전남,55,3,2,2,9,1,72,68,2,3,6,22,1,102
2020-02-14,강원,전북,177,4,16,14,16,5,232,217,9,9,23,17,4,279
2020-02-14,강원,충남,406,14,24,24,29,22,519,604,9,25,41,69,29,777
2020-02-14,강원,충북,5518,205,301,243,342,326,6935,6109,199,263,192,256,357,7376
2020-02-14,경기,강원,30824,601,1199,690,886,1313,35513,22775,555,1242,654,764,1110,27100
2020-02-14,경기,경기,453435,23096,24945,18951,22425,33843,576695,453435,23096,24945,18951,22425,33843,576695
2020-02-14,경기,경남,3886,84,325,743,610,140,5788,2612,81,302,584,410,100,4089
2020-02-14,경기,경북,5926,188,553,723,633,216,8239,5334,190,532,888,543,185,7672
2020-02-14,경기,광주,1246,32,169,332,164,26,1969,782,24,141,242,125,17,1331
2020-02-14,경기,대구,3059,102,215,356,219,107,4058,3281,130,241,463,439,107,4661
2020-02-14,경기,대전,2941,99,218,119,49,138,3564,2409,116,202,100,45,115,2987
2020-02-14,경기,부산,250,19,50,194,123,12,648,300,20,32,156,233,9,750
2020-02-14,경기,서울,158381,7385,8802,4510,3662,10828,193568,148536,7000,8904,4319,3171,10190,182120
2020-02-14,경기,세종,69,1,3,1,4,1,79,61,4,3,3,1,8,80
2020-02-14,경기,울산,44,1,0,13,11,2,71,40,2,6,32,72,0,152
2020-02-14,경기,전남,1101,17,89,169,152,36,1564,846,17,90,117,121,33,1224
2020-02-14,경기,전북,2016,56,164,125,185,63,2609,1539,73,146,167,169,59,2153
2020-02-14,경기,충남,42992,1567,2851,2394,4204,2244,56252,43531,1547,2708,2353,4033,2221,56393
2020-02-14,경기,충북,32637,2208,3004,3160,3269,1686,45964,31702,2180,2840,2799,3524,1577,44622
2020-02-14,경남,강원,134,2,11,22,20,6,195,232,7,16,12,21,6,294
2020-02-14,경남,경기,2612,81,302,584,410,100,4089,3886,84,325,743,610,140,5788
2020-02-14,경남,경남,209755,10003,9934,6606,13184,15762,265244,209755,10003,9934,6606,13184,15762,265244
2020-02-14,경남,경북,12228,632,975,981,1845,543,17204,15704,865,1186,1240,2573,775,22343
2020-02-14,경남,광주,1479,64,151,176,126,47,2043,1422,51,166,138,97,39,1913
2020-02-14,경남,대구,15886,768,988,980,1443,688,20753,12496,521,767,391,519,567,15261
2020-02-14,경남,대전,1075,23,109,79,38,40,1364,1383,25,113,114,69,51,1755
2020-02-14,경남,부산,97655,2620,3077,1587,4427,6868,116234,92431,2762,3125,1575,4766,6540,111199
2020-02-14,경남,서울,2321,42,498,247,133,57,3298,3033,51,489,213,112,89,3987
2020-02-14,경남,세종,259,4,13,8,6,9,299,389,3,20,11,15,12,450
2020-02-14,경남,울산,11260,626,678,450,650,644,14308,10880,575,749,398,673,614,13889
2020-02-14,경남,전남,6753,258,439,490,1321,319,9580,7584,305,496,434,1378,347,10544
2020-02-14,경남,전북,1569,47,126,90,188,58,2078,1688,45,135,106,198,44,2216
2020-02-14,경남,충남,1442,50,141,273,221,63,2190,2601,65,188,314,505,97,3770
2020-02-14,경남,충북,1323,63,132,278,288,55,2139,2143,67,201,442,605,94,3552
2020-02-14,경북,강원,582,14,26,33,37,17,709,602,23,36,19,34,30,744
2020-02-14,경북,경기,5334,190,532,888,543,185,7672,5926,188,553,723,633,216,8239
2020-02-14,경북,경남,15704,865,1186,1240,2573,775,22343,12228,632,975,981,1845,543,17204
2020-02-14,경북,경북,82913,3811,4123,2929,4927,4475,103178,82913,3811,4123,2929,4927,4475,103178
2020-02-14,경북,광주,1247,69,119,179,125,29,1768,944,52,96,133,82,32,1339
2020-02-14,경북,대구,82125,2947,2929,1649,3168,4384,97202,82109,3079,3247,1995,3506,4267,98203
2020-02-14,경북,대전,2278,70,121,106,86,108,2769,2116,52,125,134,68,97,2592
2020-02-14,경북,부산,5697,122,290,179,615,284,7187,5560,127,325,227,731,244,7214
2020-02-14,경북,서울,3169,98,330,363,150,121,4231,3877,77,340,235,116,115,4760
2020-02-14,경북,세종,359,8,19,29,23,12,450,363,14,21,13,15,20,446
2020-02-14,경북,울산,5865,174,327,433,1088,346,8233,5942,176,336,329,1362,348,8493
2020-02-14,경북,전남,1262,47,82,121,452,32,1996,1320,47,83,93,524,45,2112
2020-02-14,경북,전북,2132,84,154,209,247,66,2892,1853,79,154,134,294,54,2568
2020-02-14,경북,충남,3731,162,372,539,691,131,5626,4592,142,395,456,742,176,6503
2020-02-14,경북,충북,6441,221,520,682,906,261,9031,6258,215,531,672,998,236,8910
2020-02-14,광주,강원,80,3,15,10,3,1,112,130,1,21,11,10,4,177
2020-02-14,광주,경기,782,24,141,242,125,17,1331,1246,32,169,332,164,26,1969
2020-02-14,광주,경남,1422,51,166,138,97,39,1913,1479,64,151,176,126,47,2043
2020-02-14,광주,경북,944,52,96,133,82,32,1339,1247,69,119,179,125,29,1768
2020-02-14,광주,광주,14130,454,656,370,257,591,16458,14130,454,656,370,257,591,16458
2020-02-14,광주,대구,824,27,95,65,28,23,1062,801,27,98,60,37,18,1041
2020-02-14,광주,대전,487,25,23,33,17,15,600,580,21,27,46,19,13,706
2020-02-14,광주,부산,547,10,33,23,51,9,673,559,20,43,60,87,12,781
2020-02-14,광주,서울,640,17,30,64,18,22,791,1069,18,29,46,24,31,1217
2020-02-14,광주,세종,179,0,8,3,4,7,201,255,2,7,5,1,7,277
2020-02-14,광주,울산,67,0,3,2,2,4,78,78,1,5,3,4,3,94
2020-02-14,광주,전남,35286,980,1228,782,1788,1414,41478,36000,959,1096,687,1757,1420,41919
2020-02-14,광주,전북,8533,403,550,365,355,330,10536,9191,449,492,360,384,327,11203
2020-02-14,광주,충남,4837,116,596,399,222,137,6307,5458,119,609,522,370,160,7238
2020-02-14,광주,충북,707,22,60,120,58,18,985,847,32,102,159,99,24,1263
2020-02-14,대구,강원,464,4,17,20,10,15,530,296,3,10,13,8,10,340
2020-02-14,대구,경기,3281,130,241,463,439,107,4661,3059,102,215,356,219,107,4058
2020-02-14,대구,경남,12496,521,767,391,519,567,15261,15886,768,988,980,1443,688,20753
2020-02-14,대구,경북,82109,3079,3247,1995,3506,4267,98203,82125,2947,2929,1649,3168,4384,97202
2020-02-14,대구,광주,801,27,98,60,37,18,1041,824,27,95,65,28,23,1062
2020-02-14,대구,대구,64217,2128,1905,864,1144,4181,74439,64217,2128,1905,864,1144,4181,74439
2020-02-14,대구,대전,1179,31,58,71,37,41,1417,897,35,43,52,13,28,1068
2020-02-14,대구,부산,710,59,92,48,143,31,1083,3336,108,228,89,234,142,4137
2020-02-14,대구,서울,3020,95,205,224,108,80,3732,2258,68,152,128,52,83,2741
2020-02-14,대구,세종,331,2,8,8,6,7,362,249,3,8,5,4,6,275
2020-02-14,대구,울산,1463,69,151,74,136,65,1958,1724,52,143,74,202,76,2271
2020-02-14,대구,전남,580,15,41,34,47,20,737,744,16,39,35,67,24,925
2020-02-14,대구,전북,471,14,38,12,23,16,574,512,11,41,19,36,8,627
2020-02-14,대구,충남,1601,77,165,198,246,51,2338,1806,49,124,156,169,80,2384
2020-02-14,대구,충북,2151,74,229,292,366,75,3187,1948,78,143,225,151,64,2609
2020-02-14,대전,강원,208,5,21,5,3,10,252,233,7,26,7,0,9,282
2020-02-14,대전,경기,2409,116,202,100,45,115,2987,2941,99,218,119,49,138,3564
2020-02-14,대전,경남,1383,25,113,114,69,51,1755,1075,23,109,79,38,40,1364
2020-02-14,대전,경북,2116,52,125,134,68,97,2592,2278,70,121,106,86,108,2769
2020-02-14,대전,광주,580,21,27,46,19,13,706,487,25,23,33,17,15,600
2020-02-14,대전,대구,897,35,43,52,13,28,1068,1179,31,58,71,37,41,1417
2020-02-14,대전,대전,14563,390,418,201,232,1122,16926,14563,390,418,201,232,1122,16926
2020-02-14,대전,부산,103,5,6,14,22,5,155,79,8,8,19,24,2,140
2020-02-14,대전,서울,1949,45,202,46,13,82,2337,2307,50,208,40,10,101,2716
2020-02-14,대전,세종,3674,116,89,32,29,267,4207,3636,130,107,39,54,285,4251
2020-02-14,대전,울산,123,8,7,12,28,2,180,141,5,8,12,13,6,185
2020-02-14,대전,전남,316,14,11,23,28,12,404,398,15,10,17,19,14,473
2020-02-14,대전,전북,3469,80,115,74,48,156,3942,3405,84,97,65,54,164,3869
2020-02-14,대전,충남,16931,461,539,252,230,1274,19687,16372,426,488,208,236,1170,18900
2020-02-14,대전,충북,11612,435,460,208,156,846,13717,10943,392,403,171,165,824,12898
2020-02-14,부산,강원,1,1,2,1,0,0,5,3,0,0,0,3,2,8
2020-02-14,부산,경기,300,20,32,156,233,9,750,250,19,50,194,123,12,648
2020-02-14,부산,경남,92431,2762,3125,1575,4766,6540,111199,97655,2620,3077,1587,4427,6868,116234
2020-02-14,부산,경북,5560,127,325,227,731,244,7214,5697,122,290,179,615,284,7187
2020-02-14,부산,광주,559,20,43,60,87,12,781,547,10,33,23,51,9,673
2020-02-14,부산,대구,3336,108,228,89,234,142,4137,710,59,92,48,143,31,1083
2020-02-14,부산,대전,79,8,8,19,24,2,140,103,5,6,14,22,5,155
2020-02-14,부산,부산,48706,749,732,687,2082,3517,56473,48706,749,732,687,2082,3517,56473
2020-02-14,부산,서울,257,11,18,81,67,8,442,237,15,29,53,37,3,374
2020-02-14,부산,세종,16,1,0,6,1,3,27,28,0,0,1,2,0,31
2020-02-14,부산,울산,17746,398,475,667,2585,1292,23163,19610,438,419,405,2544,1395,24811
2020-02-14,부산,전남,2164,80,130,190,584,67,3215,2120,81,91,119,658,98,3167
2020-02-14,부산,전북,365,9,35,36,83,18,546,338,8,26,41,79,8,500
2020-02-14,부산,충남,169,11,28,91,160,8,467,189,14,24,72,200,7,506
2020-02-14,부산,충북,134,12,24,86,184,5,445,142,19,19,119,162,2,463
2020-02-14,서울,강원,1046,22,249,9,13,38,1377,749,14,289,16,26,30,1124
2020-02-14,서울,경기,148536,7000,8904,4319,3171,10190,182120,158381,7385,8802,4510,3662,10828,193568
2020-02-14,서울,경남,3033,51,489,213,112,89,3987,2321,42,498,247,133,57,3298
2020-02-14,서울,경북,3877,77,340,235,116,115,4760,3169,98,330,363,150,121,4231
2020-02-14,서울,광주,1069,18,29,46,24,31,1217,640,17,30,64,18,22,791
2020-02-14,서울,대구,2258,68,152,128,52,83,2741,3020,95,205,224,108,80,3732
2020-02-14,서울,대전,2307,50,208,40,10,101,2716,1949,45,202,46,13,82,2337
2020-02-14,서울,부산,237,15,29,53,37,3,374,257,11,18,81,67,8,442
2020-02-14,서울,서울,196,9,9,6,3,4,227,196,9,9,6,3,4,227
2020-02-14,서울,세종,56,0,0,3,0,1,60,48,2,0,0,0,1,51
2020-02-14,서울,울산,32,1,4,2,0,2,41,37,0,6,18,12,0,73
2020-02-14,서울,전남,1153,8,24,42,26,34,1287,806,11,28,63,45,29,982
2020-02-14,서울,전북,1897,21,49,27,26,67,2087,1377,22,40,30,30,47,1546
2020-02-14,서울,충남,28664,540,2378,811,715,1189,34297,29319,613,2433,1183,1138,1181,35867
2020-02-14,서울,충북,15300,519,1108,746,747,636,19056,15993,598,1104,792,803,629,19919
2020-02-14,세종,강원,12,0,0,0,1,0,13,4,0,0,0,1,1,6
2020-02-14,세종,경기,61,4,3,3,1,8,80,69,1,3,1,4,1,79
2020-02-14,세종,경남,389,3,20,11,15,12,450,259,4,13,8,6,9,299
2020-02-14,세종,경북,363,14,21,13,15,20,446,359,8,19,29,23,12,450
2020-02-14,세종,광주,255,2,7,5,1,7,277,179,0,8,3,4,7,201
2020-02-14,세종,대구,249,3,8,5,4,6,275,331,2,8,8,6,7,362
2020-02-14,세종,대전,3636,130,107,39,54,285,4251,3674,116,89,32,29,267,4207
2020-02-14,세종,부산,28,0,0,1,2,0,31,16,1,0,6,1,3,27
2020-02-14,세종,서울,48,2,0,0,0,1,51,56,0,0,3,0,1,60
2020-02-14,세종,세종,322,24,4,2,1,24,377,322,24,4,2,1,24,377
2020-02-14,세종,울산,13,0,0,1,1,0,15,22,0,1,0,1,0,24
2020-02-14,세종,전남,228,3,6,11,13,9,270,215,4,4,3,24,6,256
2020-02-14,세종,전북,852,21,26,15,53,32,999,801,12,21,26,56,38,954
2020-02-14,세종,충남,6345,170,167,110,190,362,7344,5595,152,147,104,173,308,6479
2020-02-14,세종,충북,400,7,20,22,18,31,498,318,19,12,9,17,22,397
2020-02-14,울산,강원,2,0,0,0,0,0,2,2,0,0,0,0,0,2
2020-02-14,울산,경기,40,2,6,32,72,0,152,44,1,0,13,11,2,71
2020-02-14,울산,경남,10880,575,749,398,673,614,13889,11260,626,678,450,650,644,14308
2020-02-14,울산,경북,5942,176,336,329,1362,348,8493,5865,174,327,433,1088,346,8233
2020-02-14,울산,광주,78,1,5,3,4,3,94,67,0,3,2,2,4,78
2020-02-14,울산,대구,1724,52,143,74,202,76,2271,1463,69,151,74,136,65,1958
2020-02-14,울산,대전,141,5,8,12,13,6,185,123,8,7,12,28,2,180
2020-02-14,울산,부산,19610,438,419,405,2544,1395,24811,17746,398,475,667,2585,1292,23163
2020-02-14,울산,서울,37,0,6,18,12,0,73,32,1,4,2,0,2,41
2020-02-14,울산,세종,22,0,1,0,1,0,24,13,0,0,1,1,0,15
2020-02-14,울산,울산,8638,260,544,278,604,821,11145,8638,260,544,278,604,821,11145
2020-02-14,울산,전남,229,9,24,15,26,7,310,305,12,17,21,53,2,410
2020-02-14,울산,전북,70,1,8,3,17,1,100,61,0,8,2,4,1,76
2020-02-14,울산,충남,136,6,18,46,116,5,327,169,4,17,33,126,7,356
2020-02-14,울산,충북,24,3,6,16,50,1,100,19,4,6,13,33,1,76
2020-02-14,전남,강원,68,2,3,6,22,1,102,55,3,2,2,9,1,72
2020-02-14,전남,경기,846,17,90,117,121,33,1224,1101,17,89,169,152,36,1564
2020-02-14,전남,경남,7584,305,496,434,1378,347,10544,6753,258,439,490,1321,319,9580
2020-02-14,전남,경북,1320,47,83,93,524,45,2112,1262,47,82,121,452,32,1996
2020-02-14,전남,광주,36000,959,1096,687,1757,1420,41919,35286,980,1228,782,1788,1414,41478
2020-02-14,전남,대구,744,16,39,35,67,24,925,580,15,41,34,47,20,737
2020-02-14,전남,대전,398,15,10,17,19,14,473,316,14,11,23,28,12,404
2020-02-14,전남,부산,2120,81,91,119,658,98,3167,2164,80,130,190,584,67,3215
2020-02-14,전남,서울,806,11,28,63,45,29,982,1153,8,24,42,26,34,1287
2020-02-14,전남,세종,215,4,4,3,24,6,256,228,3,6,11,13,9,270
2020-02-14,전남,울산,305,12,17,21,53,2,410,229,9,24,15,26,7,310
2020-02-14,전남,전남,50089,1295,1600,1681,4441,1937,61043,50089,1295,1600,1681,4441,1937,61043
2020-02-14,전남,전북,5910,261,491,500,1220,191,8573,5516,223,423,569,1188,166,8085
2020-02-14,전남,충남,5484,115,459,645,1028,169,7900,5957,101,454,518,977,159,8166
2020-02-14,전남,충북,536,19,31,66,271,19,942,533,15,37,106,264,16,971
2020-02-14,전북,강원,217,9,9,23,17,4,279,177,4,16,14,16,5,232
2020-02-14,전북,경기,1539,73,146,167,169,59,2153,2016,56,164,125,185,63,2609
2020-02-14,전북,경남,1688,45,135,106,198,44,2216,1569,47,126,90,188,58,2078
2020-02-14,전북,경북,1853,79,154,134,294,54,2568,2132,84,154,209,247,66,2892
2020-02-14,전북,광주,9191,449,492,360,384,327,11203,8533,403,550,365,355,330,10536
2020-02-14,전북,대구,512,11,41,19,36,8,627,471,14,38,12,23,16,574
2020-02-14,전북,대전,3405,84,97,65,54,164,3869,3469,80,115,74,48,156,3942
2020-02-14,전북,부산,338,8,26,41,79,8,500,365,9,35,36,83,18,546
2020-02-14,전북,서울,1377,22,40,30,30,47,1546,1897,21,49,27,26,67,2087
2020-02-14,전북,세종,801,12,21,26,56,38,954,852,21,26,15,53,32,999
2020-02-14,전북,울산,61,0,8,2,4,1,76,70,1,8,3,17,1,100
2020-02-14,전북,전남,5516,223,423,569,1188,166,8085,5910,261,491,500,1220,191,8573
2020-02-14,전북,전북,17298,617,885,587,866,663,20916,17298,617,885,587,866,663,20916
2020-02-14,전북,충남,16161,530,1563,1094,1352,582,21282,17506,457,1491,975,1422,651,22502
2020-02-14,전북,충북,2151,104,166,274,272,69,3036,2176,105,214,287,286,88,3156
2020-02-14,충남,강원,604,9,25,41,69,29,777,406,14,24,24,29,22,519
2020-02-14,충남,경기,43531,1547,2708,2353,4033,2221,56393,42992,1567,2851,2394,4204,2244,56252
2020-02-14,충남,경남,2601,65,188,314,505,97,3770,1442,50,141,273,221,63,2190
2020-02-14,충남,경북,4592,142,395,456,742,176,6503,3731,162,372,539,691,131,5626
2020-02-14,충남,광주,5458,119,609,522,370,160,7238,4837,116,596,399,222,137,6307
2020-02-14,충남,대구,1806,49,124,156,169,80,2384,1601,77,165,198,246,51,2338
2020-02-14,충남,대전,16372,426,488,208,236,1170,18900,16931,461,539,252,230,1274,19687
2020-02-14,충남,부산,189,14,24,72,200,7,506,169,11,28,91,160,8,467
2020-02-14,충남,서울,29319,613,2433,1183,1138,1181,35867,28664,540,2378,811,715,1189,34297
2020-02-14,충남,세종,5595,152,147,104,173,308,6479,6345,170,167,110,190,362,7344
2020-02-14,충남,울산,169,4,17,33,126,7,356,136,6,18,46,116,5,327
2020-02-14,충남,전남,5957,101,454,518,977,159,8166,5484,115,459,645,1028,169,7900
2020-02-14,충남,전북,17506,457,1491,975,1422,651,22502,16161,530,1563,1094,1352,582,21282
2020-02-14,충남,충남,111695,3560,8284,6723,10112,5334,145708,111695,3560,8284,6723,10112,5334,145708
2020-02-14,충남,충북,15179,639,879,948,1448,968,20061,13451,616,829,812,1430,805,17943
2020-02-14,충북,강원,6109,199,263,192,256,357,7376,5518,205,301,243,342,326,6935
2020-02-14,충북,경기,31702,2180,2840,2799,3524,1577,44622,32637,2208,3004,3160,3269,1686,45964
2020-02-14,충북,경남,2143,67,201,442,605,94,3552,1323,63,132,278,288,55,2139
2020-02-14,충북,경북,6258,215,531,672,998,236,8910,6441,221,520,682,906,261,9031
2020-02-14,충북,광주,847,32,102,159,99,24,1263,707,22,60,120,58,18,985
2020-02-14,충북,대구,1948,78,143,225,151,64,2609,2151,74,229,292,366,75,3187
2020-02-14,충북,대전,10943,392,403,171,165,824,12898,11612,435,460,208,156,846,13717
2020-02-14,충북,부산,142,19,19,119,162,2,463,134,12,24,86,184,5,445
2020-02-14,충북,서울,15993,598,1104,792,803,629,19919,15300,519,1108,746,747,636,19056
2020-02-14,충북,세종,318,19,12,9,17,22,397,400,7,20,22,18,31,498
2020-02-14,충북,울산,19,4,6,13,33,1,76,24,3,6,16,50,1,100
2020-02-14,충북,전남,533,15,37,106,264,16,971,536,19,31,66,271,19,942
2020-02-14,충북,전북,2176,105,214,287,286,88,3156,2151,104,166,274,272,69,3036
2020-02-14,충북,충남,13451,616,829,812,1430,805,17943,15179,639,879,948,1448,968,20061
2020-02-14,충북,충북,40085,1951,2338,2223,3217,2382,52196,40085,1951,2338,2223,3217,2382,52196
2020-02-15,강원,강원,94720,1416,2422,804,1518,4953,105833,94720,1416,2422,804,1518,4953,105833
2020-02-15,강원,경기,33200,317,974,343,344,1407,36585,43742,345,987,309,497,1676,47556
2020-02-15,강원,경남,218,3,12,5,8,9,255,169,0,7,8,7,8,199
2020-02-15,강원,경북,697,21,31,8,8,24,789,723,14,26,7,10,24,804
2020-02-15,강원,광주,96,1,19,12,3,1,132,110,0,15,7,5,5,142
2020-02-15,강원,대구,300,0,10,6,3,14,333,570,3,16,6,2,9,606
2020-02-15,강원,대전,208,1,27,2,1,7,246,295,2,26,2,0,9,334
2020-02-15,강원,부산,6,0,0,0,1,0,7,10,0,0,0,0,0,10
2020-02-15,강원,서울,1041,8,339,5,23,34,1450,1577,5,317,3,8,51,1961
2020-02-15,강원,세종,7,0,0,1,0,0,8,9,0,1,0,1,0,11
2020-02-15,강원,울산,6,1,0,0,0,0,7,2,0,0,0,0,0,2
2020-02-15,강원,전남,53,1,0,2,4,1,61,69,1,4,5,6,3,88
2020-02-15,강원,전북,166,3,6,4,5,5,189,202,6,4,18,3,10,243
2020-02-15,강원,충남,379,4,18,10,16,14,441,697,7,25,21,33,13,796
2020-02-15,강원,충북,5776,132,180,151,186,336,6761,6502,120,200,123,209,329,7483
2020-02-15,경기,강원,43742,345,987,309,497,1676,47556,33200,317,974,343,344,1407,36585
2020-02-15,경기,경기,382512,10476,12181,8305,11253,24195,448922,382512,10476,12181,8305,11253,24195,448922
2020-02-15,경기,경남,3661,50,327,473,356,142,5009,2261,32,203,276,204,80,3056
2020-02-15,경기,경북,6893,74,295,418,337,232,8249,5276,79,263,431,310,211,6570
2020-02-15,경기,광주,1233,13,128,161,83,40,1658,945,8,84,129,60,28,1254
2020-02-15,경기,대구,3041,45,167,247,130,75,3705,3340,55,160,260,176,95,4086
2020-02-15,경기,대전,3434,54,194,75,27,160,3944,2934,47,163,53,19,135,3351
2020-02-15,경기,부산,320,15,40,124,81,13,593,301,7,19,97,97,12,533
2020-02-15,경기,서울,135627,4136,5446,2597,2456,8066,158328,131389,3594,5405,2018,2014,7734,152154
2020-02-15,경기,세종,55,1,1,0,2,2,61,75,1,2,2,2,8,90
2020-02-15,경기,울산,34,1,1,8,9,1,54,48,1,3,10,36,1,99
2020-02-15,경기,전남,1257,8,83,93,97,27,1565,1066,15,73,70,50,22,1296
2020-02-15,경기,전북,2598,22,136,64,108,85,3013,2036,21,111,79,84,55,2386
2020-02-15,경기,충남,46504,657,1690,1052,1809,2149,53861,45333,629,1637,1061,1862,2011,52533
2020-02-15,경기,충북,34427,923,1444,1240,1714,1576,41324,31706,893,1364,1257,1750,1478,38448
2020-02-15,경남,강원,169,0,7,8,7,8,199,218,3,12,5,8,9,255
2020-02-15,경남,경기,2261,32,203,276,204,80,3056,3661,50,327,473,356,142,5009
2020-02-15,경남,경남,204353,5680,5954,3980,8377,13090,241434,204353,5680,5954,3980,8377,13090,241434
2020-02-15,경남,경북,16770,259,584,455,925,763,19756,19834,394,707,642,1202,872,23651
2020-02-15,경남,광주,1634,27,108,96,60,49,1974,1841,23,114,76,42,44,2140
2020-02-15,경남,대구,19244,376,773,438,585,810,22226,17176,294,592,224,221,681,19188
2020-02-15,경남,대전,1271,7,82,20,19,59,1458,1789,15,107,76,34,65,2086
2020-02-15,경남,부산,99377,1457,2165,1048,2578,6249,112874,95552,1461,2157,945,2722,5998,108835
2020-02-15,경남,서울,2160,13,495,135,61,70,2934,3275,31,582,155,84,94,4221
2020-02-15,경남,세종,234,2,7,2,2,8,255,416,3,16,4,4,20,463
2020-02-15,경남,울산,12617,327,359,166,232,703,14404,12384,349,383,149,248,677,14190
2020-02-15,경남,전남,8297,140,301,288,736,347,10109,8391,153,316,244,799,369,10272
2020-02-15,경남,전북,2256,22,92,42,121,71,2604,1937,26,92,43,115,73,2286
2020-02-15,경남,충남,1447,18,78,75,72,52,1742,2288,30,103,172,251,81,2925
2020-02-15,경남,충북,1530,20,84,120,156,68,1978,2213,37,130,258,356,85,3079
2020-02-15,경북,강원,723,14,26,7,10,24,804,697,21,31,8,8,24,789
2020-02-15,경북,경기,5276,79,263,431,310,211,6570,6893,74,295,418,337,232,8249
2020-02-15,경북,경남,19834,394,707,642,1202,872,23651,16770,259,584,455,925,763,19756
2020-02-15,경북,경북,89639,2207,2473,1511,3092,4327,103249,89639,2207,2473,1511,3092,4327,103249
2020-02-15,경북,광주,1052,20,60,82,53,32,1299,1043,17,55,77,37,36,1265
2020-02-15,경북,대구,80721,1762,1838,1006,2466,3833,91626,85675,1755,2042,1088,2367,4056,96983
2020-02-15,경북,대전,2778,27,95,50,41,107,3098,2925,24,91,77,36,131,3284
2020-02-15,경북,부산,8201,54,268,94,213,374,9204,9332,60,297,89,218,424,10420
2020-02-15,경북,서울,3585,46,337,163,77,130,4338,4732,52,342,137,67,149,5479
2020-02-15,경북,세종,362,3,17,9,8,23,422,460,4,7,11,7,29,518
2020-02-15,경북,울산,7389,72,181,252,640,411,8945,7964,70,176,145,822,433,9610
2020-02-15,경북,전남,1529,27,54,32,218,52,1912,1463,32,43,44,228,43,1853
2020-02-15,경북,전북,2125,52,109,118,158,72,2634,1887,58,104,84,136,56,2325
2020-02-15,경북,충남,4007,64,165,174,282,160,4852,4866,57,168,209,388,166,5854
2020-02-15,경북,충북,7599,123,286,288,527,318,9141,8048,147,336,327,638,344,9840
2020-02-15,광주,강원,110,0,15,7,5,5,142,96,1,19,12,3,1,132
2020-02-15,광주,경기,945,8,84,129,60,28,1254,1233,13,128,161,83,40,1658
2020-02-15,광주,경남,1841,23,114,76,42,44,2140,1634,27,108,96,60,49,1974
2020-02-15,광주,경북,1043,17,55,77,37,36,1265,1052,20,60,82,53,32,1299
2020-02-15,광주,광주,13138,327,490,227,260,500,14942,13138,327,490,227,260,500,14942
2020-02-15,광주,대구,809,12,76,60,20,23,1000,743,13,85,45,6,20,912
2020-02-15,광주,대전,687,12,8,9,8,21,745,747,6,18,37,18,24,850
2020-02-15,광주,부산,652,7,34,15,27,14,749,617,6,51,24,47,18,763
2020-02-15,광주,서울,896,13,22,50,12,27,1020,1121,12,20,39,7,27,1226
2020-02-15,광주,세종,192,1,5,1,0,5,204,263,1,6,0,1,5,276
2020-02-15,광주,울산,79,0,7,0,3,0,89,66,0,8,2,2,0,78
2020-02-15,광주,전남,39198,597,942,504,1095,1367,43703,37904,614,860,465,1175,1302,42320
2020-02-15,광주,전북,9957,236,292,161,191,333,11170,9763,273,285,175,265,312,11073
2020-02-15,광주,충남,5286,32,568,170,133,124,6313,5770,60,576,279,223,164,7072
2020-02-15,광주,충북,651,17,41,45,12,19,785,825,18,51,61,57,24,1036
2020-02-15,대구,강원,570,3,16,6,2,9,606,300,0,10,6,3,14,333
2020-02-15,대구,경기,3340,55,160,260,176,95,4086,3041,45,167,247,130,75,3705
2020-02-15,대구,경남,17176,294,592,224,221,681,19188,19244,376,773,438,585,810,22226
2020-02-15,대구,경북,85675,1755,2042,1088,2367,4056,96983,80721,1762,1838,1006,2466,3833,91626
2020-02-15,대구,광주,743,13,85,45,6,20,912,809,12,76,60,20,23,1000
2020-02-15,대구,대구,55847,1191,1139,496,960,3114,62747,55847,1191,1139,496,960,3114,62747
2020-02-15,대구,대전,1488,22,49,46,22,56,1683,1136,17,41,32,10,38,1274
2020-02-15,대구,부산,1051,21,78,36,50,35,1271,4885,52,200,48,87,199,5471
2020-02-15,대구,서울,3048,43,249,94,43,73,3550,2422,30,177,92,39,73,2833
2020-02-15,대구,세종,322,1,9,5,6,13,356,329,4,3,1,5,13,355
2020-02-15,대구,울산,2025,27,111,38,110,100,2411,2265,30,119,28,129,110,2681
2020-02-15,대구,전남,851,7,29,13,14,25,939,835,10,29,14,18,23,929
2020-02-15,대구,전북,614,6,36,9,9,12,686,542,8,34,10,8,22,624
2020-02-15,대구,충남,1786,29,70,82,86,69,2122,1628,23,65,89,96,53,1954
2020-02-15,대구,충북,2522,31,142,95,139,99,3028,2046,35,109,131,98,60,2479
2020-02-15,대전,강원,295,2,26,2,0,9,334,208,1,27,2,1,7,246
2020-02-15,대전,경기,2934,47,163,53,19,135,3351,3434,54,194,75,27,160,3944
2020-02-15,대전,경남,1789,15,107,76,34,65,2086,1271,7,82,20,19,59,1458
2020-02-15,대전,경북,2925,24,91,77,36,131,3284,2778,27,95,50,41,107,3098
2020-02-15,대전,광주,747,6,18,37,18,24,850,687,12,8,9,8,21,745
2020-02-15,대전,대구,1136,17,41,32,10,38,1274,1488,22,49,46,22,56,1683
2020-02-15,대전,대전,12236,211,254,98,267,796,13862,12236,211,254,98,267,796,13862
2020-02-15,대전,부산,114,2,5,14,6,1,142,132,2,7,10,22,1,174
2020-02-15,대전,서울,2320,30,265,18,3,109,2745,2623,21,248,29,10,116,3047
2020-02-15,대전,세종,3211,73,58,19,20,204,3585,3240,82,55,14,39,211,3641
2020-02-15,대전,울산,107,1,8,8,14,11,149,118,2,11,3,12,6,152
2020-02-15,대전,전남,500,3,9,20,20,17,569,486,4,7,8,20,15,540
2020-02-15,대전,전북,4998,49,66,54,36,215,5418,4853,66,72,28,35,191,5245
2020-02-15,대전,충남,15886,267,346,163,141,936,17739,15332,254,325,139,171,911,17132
2020-02-15,대전,충북,10577,265,314,108,77,660,12001,10049,239,312,107,85,597,11389
2020-02-15,부산,강원,10,0,0,0,0,0,10,6,0,0,0,1,0,7
2020-02-15,부산,경기,301,7,19,97,97,12,533,320,15,40,124,81,13,593
2020-02-15,부산,경남,95552,1461,2157,945,2722,5998,108835,99377,1457,2165,1048,2578,6249,112874
2020-02-15,부산,경북,9332,60,297,89,218,424,10420,8201,54,268,94,213,374,9204
2020-02-15,부산,광주,617,6,51,24,47,18,763,652,7,34,15,27,14,749
2020-02-15,부산,대구,4885,52,200,48,87,199,5471,1051,21,78,36,50,35,1271
2020-02-15,부산,대전,132,2,7,10,22,1,174,114,2,5,14,6,1,142
2020-02-15,부산,부산,55689,429,319,366,1142,3413,61358,55689,429,319,366,1142,3413,61358
2020-02-15,부산,서울,276,5,13,28,20,5,347,271,5,22,45,24,11,378
2020-02-15,부산,세종,21,1,1,2,3,1,29,34,0,2,0,1,0,37
2020-02-15,부산,울산,20998,186,255,348,1146,1290,24223,22977,194,206,203,1234,1419,26233
2020-02-15,부산,전남,2451,39,80,77,274,82,3003,2358,28,79,65,295,79,2904
2020-02-15,부산,전북,485,4,35,25,36,14,599,409,5,28,15,22,17,496
2020-02-15,부산,충남,197,2,9,33,49,10,300,223,2,12,50,89,9,385
2020-02-15,부산,충북,112,2,15,30,82,7,248,143,6,18,62,82,2,313
2020-02-15,서울,강원,1577,5,317,3,8,51,1961,1041,8,339,5,23,34,1450
2020-02-15,서울,경기,131389,3594,5405,2018,2014,7734,152154,135627,4136,5446,2597,2456,8066,158328
2020-02-15,서울,경남,3275,31,582,155,84,94,4221,2160,13,495,135,61,70,2934
2020-02-15,서울,경북,4732,52,342,137,67,149,5479,3585,46,337,163,77,130,4338
2020-02-15,서울,광주,1121,12,20,39,7,27,1226,896,13,22,50,12,27,1020
2020-02-15,서울,대구,2422,30,177,92,39,73,2833,3048,43,249,94,43,73,3550
2020-02-15,서울,대전,2623,21,248,29,10,116,3047,2320,30,265,18,3,109,2745
2020-02-15,서울,부산,271,5,22,45,24,11,378,276,5,13,28,20,5,347
2020-02-15,서울,서울,200,5,8,0,2,12,227,200,5,8,0,2,12,227
2020-02-15,서울,세종,54,0,0,0,0,0,54,46,0,0,0,0,3,49
2020-02-15,서울,울산,32,0,10,2,1,0,45,24,1,2,4,6,2,39
2020-02-15,서울,전남,1422,8,26,30,26,38,1550,1039,4,23,32,33,34,1165
2020-02-15,서울,전북,2503,12,54,12,12,75,2668,1741,9,51,10,21,52,1884
2020-02-15,서울,충남,35477,265,2230,410,377,1327,40086,33100,309,2252,552,512,1311,38036
2020-02-15,서울,충북,17850,221,1014,355,358,735,20533,16704,257,994,419,439,698,19511
2020-02-15,세종,강원,9,0,1,0,1,0,11,7,0,0,1,0,0,8
2020-02-15,세종,경기,75,1,2,2,2,8,90,55,1,1,0,2,2,61
2020-02-15,세종,경남,416,3,16,4,4,20,463,234,2,7,2,2,8,255
2020-02-15,세종,경북,460,4,7,11,7,29,518,362,3,17,9,8,23,422
2020-02-15,세종,광주,263,1,6,0,1,5,276,192,1,5,1,0,5,204
2020-02-15,세종,대구,329,4,3,1,5,13,355,322,1,9,5,6,13,356
2020-02-15,세종,대전,3240,82,55,14,39,211,3641,3211,73,58,19,20,204,3585
2020-02-15,세종,부산,34,0,2,0,1,0,37,21,1,1,2,3,1,29
2020-02-15,세종,서울,46,0,0,0,0,3,49,54,0,0,0,0,0,54
2020-02-15,세종,세종,244,19,0,1,1,14,279,244,19,0,1,1,14,279
2020-02-15,세종,울산,13,0,0,1,0,0,14,17,0,0,0,2,0,19
2020-02-15,세종,전남,244,1,3,5,4,9,266,213,2,3,0,7,5,230
2020-02-15,세종,전북,1326,8,8,7,19,38,1406,1034,3,11,6,17,35,1106
2020-02-15,세종,충남,6850,122,104,61,118,313,7568,5303,102,100,68,101,230,5904
2020-02-15,세종,충북,383,9,8,13,6,23,442,297,9,13,6,13,25,363
2020-02-15,울산,강원,2,0,0,0,0,0,2,6,1,0,0,0,0,7
2020-02-15,울산,경기,48,1,3,10,36,1,99,34,1,1,8,9,1,54
2020-02-15,울산,경남,12384,349,383,149,248,677,14190,12617,327,359,166,232,703,14404
2020-02-15,울산,경북,7964,70,176,145,822,433,9610,7389,72,181,252,640,411,8945
2020-02-15,울산,광주,66,0,8,2,2,0,78,79,0,7,0,3,0,89
2020-02-15,울산,대구,2265,30,119,28,129,110,2681,2025,27,111,38,110,100,2411
2020-02-15,울산,대전,118,2,11,3,12,6,152,107,1,8,8,14,11,149
2020-02-15,울산,부산,22977,194,206,203,1234,1419,26233,20998,186,255,348,1146,1290,24223
2020-02-15,울산,서울,24,1,2,4,6,2,39,32,0,10,2,1,0,45
2020-02-15,울산,세종,17,0,0,0,2,0,19,13,0,0,1,0,0,14
2020-02-15,울산,울산,6376,105,158,97,239,550,7525,6376,105,158,97,239,550,7525
2020-02-15,울산,전남,253,1,13,7,22,4,300,287,6,8,7,17,9,334
2020-02-15,울산,전북,84,2,6,1,10,3,106,61,0,7,1,4,0,73
2020-02-15,울산,충남,138,3,5,15,55,5,221,144,2,11,15,55,5,232
2020-02-15,울산,충북,25,2,1,7,27,1,63,27,1,0,3,24,1,56
2020-02-15,전남,강원,69,1,4,5,6,3,88,53,1,0,2,4,1,61
2020-02-15,전남,경기,1066,15,73,70,50,22,1296,1257,8,83,93,97,27,1565
2020-02-15,전남,경남,8391,153,316,244,799,369,10272,8297,140,301,288,736,347,10109
2020-02-15,전남,경북,1463,32,43,44,228,43,1853,1529,27,54,32,218,52,1912
2020-02-15,전남,광주,37904,614,860,465,1175,1302,42320,39198,597,942,504,1095,1367,43703
2020-02-15,전남,대구,835,10,29,14,18,23,929,851,7,29,13,14,25,939
2020-02-15,전남,대전,486,4,7,8,20,15,540,500,3,9,20,20,17,569
2020-02-15,전남,부산,2358,28,79,65,295,79,2904,2451,39,80,77,274,82,3003
2020-02-15,전남,서울,1039,4,23,32,33,34,1165,1422,8,26,30,26,38,1550
2020-02-15,전남,세종,213,2,3,0,7,5,230,244,1,3,5,4,9,266
2020-02-15,전남,울산,287,6,8,7,17,9,334,253,1,13,7,22,4,300
2020-02-15,전남,전남,51492,774,1239,1152,2907,1825,59389,51492,774,1239,1152,2907,1825,59389
2020-02-15,전남,전북,7615,173,372,320,748,223,9451,7450,148,310,369,722,221,9220
2020-02-15,전남,충남,5646,54,368,255,419,171,6913,6663,47,427,274,477,180,8068
2020-02-15,전남,충북,528,8,20,39,86,20,701,648,6,27,58,156,23,918
2020-02-15,전북,강원,202,6,4,18,3,10,243,166,3,6,4,5,5,189
2020-02-15,전북,경기,2036,21,111,79,84,55,2386,2598,22,136,64,108,85,3013
2020-02-15,전북,경남,1937,26,92,43,115,73,2286,2256,22,92,42,121,71,2604
2020-02-15,전북,경북,1887,58,104,84,136,56,2325,2125,52,109,118,158,72,2634
2020-02-15,전북,광주,9763,273,285,175,265,312,11073,9957,236,292,161,191,333,11170
2020-02-15,전북,대구,542,8,34,10,8,22,624,614,6,36,9,9,12,686
2020-02-15,전북,대전,4853,66,72,28,35,191,5245,4998,49,66,54,36,215,5418
2020-02-15,전북,부산,409,5,28,15,22,17,496,485,4,35,25,36,14,599
2020-02-15,전북,서울,1741,9,51,10,21,52,1884,2503,12,54,12,12,75,2668
2020-02-15,전북,세종,1034,3,11,6,17,35,1106,1326,8,8,7,19,38,1406
2020-02-15,전북,울산,61,0,7,1,4,0,73,84,2,6,1,10,3,106
2020-02-15,전북,전남,7450,148,310,369,722,221,9220,7615,173,372,320,748,223,9451
2020-02-15,전북,전북,16737,391,611,387,527,606,19259,16737,391,611,387,527,606,19259
2020-02-15,전북,충남,19452,273,1129,476,607,705,22642,21228,256,1188,535,726,744,24677
2020-02-15,전북,충북,2330,53,91,143,114,76,2807,2651,57,97,135,133,87,3160
2020-02-15,충남,강원,697,7,25,21,33,13,796,379,4,18,10,16,14,441
2020-02-15,충남,경기,45333,629,1637,1061,1862,2011,52533,46504,657,1690,1052,1809,2149,53861
2020-02-15,충남,경남,2288,30,103,172,251,81,2925,1447,18,78,75,72,52,1742
2020-02-15,충남,경북,4866,57,168,209,388,166,5854,4007,64,165,174,282,160,4852
2020-02-15,충남,광주,5770,60,576,279,223,164,7072,5286,32,568,170,133,124,6313
2020-02-15,충남,대구,1628,23,65,89,96,53,1954,1786,29,70,82,86,69,2122
2020-02-15,충남,대전,15332,254,325,139,171,911,17132,15886,267,346,163,141,936,17739
2020-02-15,충남,부산,223,2,12,50,89,9,385,197,2,9,33,49,10,300
2020-02-15,충남,서울,33100,309,2252,552,512,1311,38036,35477,265,2230,410,377,1327,40086
2020-02-15,충남,세종,5303,102,100,68,101,230,5904,6850,122,104,61,118,313,7568
2020-02-15,충남,울산,144,2,11,15,55,5,232,138,3,5,15,55,5,221
2020-02-15,충남,전남,6663,47,427,274,477,180,8068,5646,54,368,255,419,171,6913
2020-02-15,충남,전북,21228,256,1188,535,726,744,24677,19452,273,1129,476,607,705,22642
2020-02-15,충남,충남,115101,1815,5598,2877,5141,4829,135361,115101,1815,5598,2877,5141,4829,135361
2020-02-15,충남,충북,12621,320,450,422,819,651,15283,11954,319,416,380,738,628,14435
2020-02-15,충북,강원,6502,120,200,123,209,329,7483,5776,132,180,151,186,336,6761
2020-02-15,충북,경기,31706,893,1364,1257,1750,1478,38448,34427,923,1444,1240,1714,1576,41324
2020-02-15,충북,경남,2213,37,130,258,356,85,3079,1530,20,84,120,156,68,1978
2020-02-15,충북,경북,8048,147,336,327,638,344,9840,7599,123,286,288,527,318,9141
2020-02-15,충북,광주,825,18,51,61,57,24,1036,651,17,41,45,12,19,785
2020-02-15,충북,대구,2046,35,109,131,98,60,2479,2522,31,142,95,139,99,3028
2020-02-15,충북,대전,10049,239,312,107,85,597,11389,10577,265,314,108,77,660,12001
2020-02-15,충북,부산,143,6,18,62,82,2,313,112,2,15,30,82,7,248
2020-02-15,충북,서울,16704,257,994,419,439,698,19511,17850,221,1014,355,358,735,20533
2020-02-15,충북,세종,297,9,13,6,13,25,363,383,9,8,13,6,23,442
2020-02-15,충북,울산,27,1,0,3,24,1,56,25,2,1,7,27,1,63
2020-02-15,충북,전남,648,6,27,58,156,23,918,528,8,20,39,86,20,701
2020-02-15,충북,전북,2651,57,97,135,133,87,3160,2330,53,91,143,114,76,2807
2020-02-15,충북,충남,11954,319,416,380,738,628,14435,12621,320,450,422,819,651,15283
2020-02-15,충북,충북,36547,1003,1096,1054,1607,1972,43279,36547,1003,1096,1054,1607,1972,43279
2020-02-16,강원,강원,69275,577,2061,387,368,3501,76169,69275,577,2061,387,368,3501,76169
2020-02-16,강원,경기,40147,210,833,184,118,1460,42952,23161,152,790,125,198,1003,25429
2020-02-16,강원,경남,239,2,8,1,3,5,258,146,0,9,2,0,3,160
2020-02-16,강원,경북,701,10,30,6,1,28,776,551,5,22,5,5,21,609
2020-02-16,강원,광주,119,1,15,2,3,5,145,111,2,14,1,0,1,129
2020-02-16,강원,대구,381,1,4,4,1,10,401,385,3,14,3,1,13,419
2020-02-16,강원,대전,252,3,31,0,0,5,291,216,2,27,1,0,10,256
2020-02-16,강원,부산,5,0,1,0,0,1,7,6,0,0,1,0,0,7
2020-02-16,강원,서울,1261,7,381,3,3,42,1697,784,8,270,1,2,18,1083
2020-02-16,강원,세종,8,0,0,0,0,0,8,8,0,1,0,0,2,11
2020-02-16,강원,울산,2,0,0,0,0,0,2,5,0,0,0,0,0,5
2020-02-16,강원,전남,65,0,3,1,2,3,74,93,0,1,1,5,1,101
2020-02-16,강원,전북,191,0,6,1,0,8,206,189,2,4,9,4,6,214
2020-02-16,강원,충남,539,0,15,1,9,34,598,490,0,20,3,13,21,547
2020-02-16,강원,충북,4870,48,115,38,42,211,5324,4478,48,134,25,41,200,4926
2020-02-16,경기,강원,23161,152,790,125,198,1003,25429,40147,210,833,184,118,1460,42952
2020-02-16,경기,경기,254503,4628,6557,3324,2035,15817,286864,254503,4628,6557,3324,2035,15817,286864
2020-02-16,경기,경남,2712,17,222,117,53,91,3212,3065,18,181,124,79,112,3579
2020-02-16,경기,경북,4161,44,213,145,85,157,4805,6548,60,188,187,99,226,7308
2020-02-16,경기,광주,807,4,91,28,20,25,975,1202,6,82,31,27,34,1382
2020-02-16,경기,대구,2121,22,112,61,29,78,2423,3966,22,132,65,54,124,4363
2020-02-16,경기,대전,2018,18,162,21,6,103,2328,2985,24,160,20,11,164,3364
2020-02-16,경기,부산,251,4,9,37,27,8,336,536,4,12,22,41,33,648
2020-02-16,경기,서울,90358,1595,4011,1105,384,5205,102658,100964,1777,3950,1047,425,5940,114103
2020-02-16,경기,세종,36,1,1,1,0,0,39,74,1,2,0,3,1,81
2020-02-16,경기,울산,32,0,1,4,2,0,39,52,0,3,1,8,1,65
2020-02-16,경기,전남,788,8,62,19,14,25,916,1398,7,70,58,27,47,1607
2020-02-16,경기,전북,1419,4,95,26,25,57,1626,2587,13,86,45,20,84,2835
2020-02-16,경기,충남,31368,271,1216,449,443,1517,35264,36399,285,1217,389,477,1616,40383
2020-02-16,경기,충북,22752,437,832,457,467,1146,26091,28052,463,840,424,361,1333,31473
2020-02-16,경남,강원,146,0,9,2,0,3,160,239,2,8,1,3,5,258
2020-02-16,경남,경기,3065,18,181,124,79,112,3579,2712,17,222,117,53,91,3212
2020-02-16,경남,경남,157084,2073,3425,907,1031,9791,174311,157084,2073,3425,907,1031,9791,174311
2020-02-16,경남,경북,13940,136,417,126,163,644,15426,18667,206,527,227,205,836,20668
2020-02-16,경남,광주,1482,13,105,39,10,45,1694,1426,8,90,38,9,43,1614
2020-02-16,경남,대구,16601,158,575,262,312,718,18626,13721,105,525,97,48,620,15116
2020-02-16,경남,대전,1285,10,90,35,7,73,1500,1438,8,94,12,5,71,1628
2020-02-16,경남,부산,79701,593,1578,282,396,4825,87375,77055,586,1497,241,465,4892,84736
2020-02-16,경남,서울,2570,22,497,117,49,76,3331,2769,25,508,45,14,98,3459
2020-02-16,경남,세종,392,0,8,0,0,17,417,286,0,14,0,0,15,315
2020-02-16,경남,울산,11074,118,256,39,43,678,12208,10336,108,275,37,52,614,11422
2020-02-16,경남,전남,7028,78,226,100,125,298,7855,7040,83,230,93,157,279,7882
2020-02-16,경남,전북,1849,13,77,47,11,43,2040,2082,12,84,52,22,62,2314
2020-02-16,경남,충남,1812,7,59,44,39,67,2028,1761,10,57,43,52,61,1984
2020-02-16,경남,충북,1971,13,60,62,34,75,2215,1721,11,86,86,62,65,2031
2020-02-16,경북,강원,551,5,22,5,5,21,609,701,10,30,6,1,28,776
2020-02-16,경북,경기,6548,60,188,187,99,226,7308,4161,44,213,145,85,157,4805
2020-02-16,경북,경남,18667,206,527,227,205,836,20668,13940,136,417,126,163,644,15426
2020-02-16,경북,경북,73034,767,1403,589,503,3384,79680,73034,767,1403,589,503,3384,79680
2020-02-16,경북,광주,954,15,52,47,21,17,1106,1095,14,41,37,15,30,1232
2020-02-16,경북,대구,62965,517,1149,278,290,2941,68140,65616,559,1323,324,340,2966,71128
2020-02-16,경북,대전,2377,15,71,22,20,99,2604,2380,11,70,17,12,89,2579
2020-02-16,경북,부산,7956,35,209,19,81,333,8633,8492,32,243,28,96,344,9235
2020-02-16,경북,서울,4099,20,310,115,35,128,4707,3064,15,279,47,18,124,3547
2020-02-16,경북,세종,432,0,4,4,2,17,459,353,1,8,4,2,15,383
2020-02-16,경북,울산,7221,33,120,131,223,323,8051,6205,31,110,46,245,301,6938
2020-02-16,경북,전남,1303,21,41,23,85,46,1519,1380,15,33,15,134,46,1623
2020-02-16,경북,전북,1620,23,52,34,45,42,1816,1698,14,57,39,40,52,1900
2020-02-16,경북,충남,4117,30,77,52,97,156,4529,3406,23,77,61,81,130,3778
2020-02-16,경북,충북,7358,62,154,160,157,293,8184,6012,45,195,141,100,241,6734
2020-02-16,광주,강원,111,2,14,1,0,1,129,119,1,15,2,3,5,145
2020-02-16,광주,경기,1202,6,82,31,27,34,1382,807,4,91,28,20,25,975
2020-02-16,광주,경남,1426,8,90,38,9,43,1614,1482,13,105,39,10,45,1694
2020-02-16,광주,경북,1095,14,41,37,15,30,1232,954,15,52,47,21,17,1106
2020-02-16,광주,광주,8782,129,387,104,45,299,9746,8782,129,387,104,45,299,9746
2020-02-16,광주,대구,652,6,64,49,11,19,801,771,9,83,32,5,32,932
2020-02-16,광주,대전,532,4,8,2,6,17,569,577,4,7,2,4,19,613
2020-02-16,광주,부산,516,1,34,9,1,9,570,744,2,33,3,9,19,810
2020-02-16,광주,서울,1048,5,21,14,11,18,1117,699,8,9,10,6,23,755
2020-02-16,광주,세종,259,1,3,0,1,9,273,175,1,1,0,1,5,183
2020-02-16,광주,울산,92,0,9,0,1,2,104,69,0,9,1,2,1,82
2020-02-16,광주,전남,27118,235,687,197,163,936,29336,26888,236,603,232,147,977,29083
2020-02-16,광주,전북,7332,71,163,46,47,207,7866,7728,90,204,65,48,245,8380
2020-02-16,광주,충남,5177,41,457,98,91,160,6024,4407,30,481,99,39,105,5161
2020-02-16,광주,충북,732,8,33,14,7,20,814,632,5,27,31,13,12,720
2020-02-16,대구,강원,385,3,14,3,1,13,419,381,1,4,4,1,10,401
2020-02-16,대구,경기,3966,22,132,65,54,124,4363,2121,22,112,61,29,78,2423
2020-02-16,대구,경남,13721,105,525,97,48,620,15116,16601,158,575,262,312,718,18626
2020-02-16,대구,경북,65616,559,1323,324,340,2966,71128,62965,517,1149,278,290,2941,68140
2020-02-16,대구,광주,771,9,83,32,5,32,932,652,6,64,49,11,19,801
2020-02-16,대구,대구,38211,364,568,142,175,2166,41626,38211,364,568,142,175,2166,41626
2020-02-16,대구,대전,1400,8,35,10,10,61,1524,895,2,22,7,3,45,974
2020-02-16,대구,부산,838,7,53,20,34,29,981,5016,33,175,25,50,208,5507
2020-02-16,대구,서울,2918,22,186,44,17,88,3275,1930,13,146,20,6,48,2163
2020-02-16,대구,세종,399,0,10,0,2,16,427,203,0,1,0,0,7,211
2020-02-16,대구,울산,2066,14,106,11,47,96,2340,1752,6,101,10,58,76,2003
2020-02-16,대구,전남,796,5,43,4,19,25,892,800,6,45,15,23,28,917
2020-02-16,대구,전북,483,3,36,2,1,21,546,552,5,31,5,2,14,609
2020-02-16,대구,충남,1955,11,35,31,47,83,2162,1081,12,23,24,21,31,1192
2020-02-16,대구,충북,2901,16,117,56,66,116,3272,1692,15,65,43,18,59,1892
2020-02-16,대전,강원,216,2,27,1,0,10,256,252,3,31,0,0,5,291
2020-02-16,대전,경기,2985,24,160,20,11,164,3364,2018,18,162,21,6,103,2328
2020-02-16,대전,경남,1438,8,94,12,5,71,1628,1285,10,90,35,7,73,1500
2020-02-16,대전,경북,2380,11,70,17,12,89,2579,2377,15,71,22,20,99,2604
2020-02-16,대전,광주,577,4,7,2,4,19,613,532,4,8,2,6,17,569
2020-02-16,대전,대구,895,2,22,7,3,45,974,1400,8,35,10,10,61,1524
2020-02-16,대전,대전,7926,49,119,63,13,485,8655,7926,49,119,63,13,485,8655
2020-02-16,대전,부산,110,1,2,1,2,1,117,163,0,2,2,2,4,173
2020-02-16,대전,서울,2242,12,238,7,2,85,2586,1761,14,241,4,1,86,2107
2020-02-16,대전,세종,2178,28,27,3,4,140,2380,1809,20,31,7,4,115,1986
2020-02-16,대전,울산,163,1,7,1,7,8,187,132,1,7,0,4,4,148
2020-02-16,대전,전남,431,1,6,4,4,12,458,457,4,5,0,6,12,484
2020-02-16,대전,전북,3406,18,51,6,5,120,3606,3819,26,55,19,10,141,4070
2020-02-16,대전,충남,10470,70,222,79,48,612,11501,9734,80,227,69,54,558,10722
2020-02-16,대전,충북,7812,113,245,39,21,478,8708,6756,82,217,42,14,428,7539
2020-02-16,부산,강원,6,0,0,1,0,0,7,5,0,1,0,0,1,7
2020-02-16,부산,경기,536,4,12,22,41,33,648,251,4,9,37,27,8,336
2020-02-16,부산,경남,77055,586,1497,241,465,4892,84736,79701,593,1578,282,396,4825,87375
2020-02-16,부산,경북,8492,32,243,28,96,344,9235,7956,35,209,19,81,333,8633
2020-02-16,부산,광주,744,2,33,3,9,19,810,516,1,34,9,1,9,570
2020-02-16,부산,대구,5016,33,175,25,50,208,5507,838,7,53,20,34,29,981
2020-02-16,부산,대전,163,0,2,2,2,4,173,110,1,2,1,2,1,117
2020-02-16,부산,부산,51141,129,170,100,249,2840,54629,51141,129,170,100,249,2840,54629
2020-02-16,부산,서울,358,2,9,18,9,17,413,264,7,10,9,8,7,305
2020-02-16,부산,세종,58,0,1,0,1,1,61,34,0,0,0,0,1,35
2020-02-16,부산,울산,20449,72,130,86,298,1206,22241,18717,74,74,47,313,1157,20382
2020-02-16,부산,전남,2597,14,86,25,114,105,2941,2061,17,89,62,119,67,2415
2020-02-16,부산,전북,522,2,33,2,15,17,591,454,1,35,9,16,9,524
2020-02-16,부산,충남,295,3,5,6,12,8,329,171,2,4,5,13,7,202
2020-02-16,부산,충북,309,3,10,8,28,12,370,149,2,4,21,14,7,197
2020-02-16,서울,강원,784,8,270,1,2,18,1083,1261,7,381,3,3,42,1697
2020-02-16,서울,경기,100964,1777,3950,1047,425,5940,114103,90358,1595,4011,1105,384,5205,102658
2020-02-16,서울,경남,2769,25,508,45,14,98,3459,2570,22,497,117,49,76,3331
2020-02-16,서울,경북,3064,15,279,47,18,124,3547,4099,20,310,115,35,128,4707
2020-02-16,서울,광주,699,8,9,10,6,23,755,1048,5,21,14,11,18,1117
2020-02-16,서울,대구,1930,13,146,20,6,48,2163,2918,22,186,44,17,88,3275
2020-02-16,서울,대전,1761,14,241,4,1,86,2107,2242,12,238,7,2,85,2586
2020-02-16,서울,부산,264,7,10,9,8,7,305,358,2,9,18,9,17,413
2020-02-16,서울,서울,153,1,13,7,0,6,180,153,1,13,7,0,6,180
2020-02-16,서울,세종,28,1,0,0,0,0,29,35,0,1,0,0,2,38
2020-02-16,서울,울산,27,0,4,2,0,0,33,21,1,3,2,2,1,30
2020-02-16,서울,전남,821,6,25,7,24,23,906,1458,9,27,53,52,41,1640
2020-02-16,서울,전북,1260,4,30,4,6,35,1339,2215,10,48,12,9,79,2373
2020-02-16,서울,충남,27713,144,2028,169,167,1058,31279,31475,170,1993,471,259,1150,35518
2020-02-16,서울,충북,13566,107,810,180,107,554,15324,14256,121,825,185,92,595,16074
2020-02-16,세종,강원,8,0,1,0,0,2,11,8,0,0,0,0,0,8
2020-02-16,세종,경기,74,1,2,0,3,1,81,36,1,1,1,0,0,39
2020-02-16,세종,경남,286,0,14,0,0,15,315,392,0,8,0,0,17,417
2020-02-16,세종,경북,353,1,8,4,2,15,383,432,0,4,4,2,17,459
2020-02-16,세종,광주,175,1,1,0,1,5,183,259,1,3,0,1,9,273
2020-02-16,세종,대구,203,0,1,0,0,7,211,399,0,10,0,2,16,427
2020-02-16,세종,대전,1809,20,31,7,4,115,1986,2178,28,27,3,4,140,2380
2020-02-16,세종,부산,34,0,0,0,0,1,35,58,0,1,0,1,1,61
2020-02-16,세종,서울,35,0,1,0,0,2,38,28,1,0,0,0,0,29
2020-02-16,세종,세종,180,4,0,13,0,8,205,180,4,0,13,0,8,205
2020-02-16,세종,울산,14,0,2,0,0,2,18,7,0,0,0,1,1,9
2020-02-16,세종,전남,202,1,3,0,5,5,216,307,1,1,1,3,10,323
2020-02-16,세종,전북,788,0,9,0,9,21,827,1054,4,1,2,9,31,1101
2020-02-16,세종,충남,4456,41,76,39,26,202,4840,4183,33,91,44,22,158,4531
2020-02-16,세종,충북,241,3,6,3,1,12,266,251,8,5,4,1,19,288
2020-02-16,울산,강원,5,0,0,0,0,0,5,2,0,0,0,0,0,2
2020-02-16,울산,경기,52,0,3,1,8,1,65,32,0,1,4,2,0,39
2020-02-16,울산,경남,10336,108,275,37,52,614,11422,11074,118,256,39,43,678,12208
2020-02-16,울산,경북,6205,31,110,46,245,301,6938,7221,33,120,131,223,323,8051
2020-02-16,울산,광주,69,0,9,1,2,1,82,92,0,9,0,1,2,104
2020-02-16,울산,대구,1752,6,101,10,58,76,2003,2066,14,106,11,47,96,2340
2020-02-16,울산,대전,132,1,7,0,4,4,148,163,1,7,1,7,8,187
2020-02-16,울산,부산,18717,74,74,47,313,1157,20382,20449,72,130,86,298,1206,22241
2020-02-16,울산,서울,21,1,3,2,2,1,30,27,0,4,2,0,0,33
2020-02-16,울산,세종,7,0,0,0,1,1,9,14,0,2,0,0,2,18
2020-02-16,울산,울산,5061,23,113,21,72,382,5672,5061,23,113,21,72,382,5672
2020-02-16,울산,전남,254,0,7,1,5,9,276,292,0,7,5,4,10,318
2020-02-16,울산,전북,50,0,6,0,8,2,66,66,0,6,0,1,3,76
2020-02-16,울산,충남,162,1,4,4,32,9,212,137,2,4,4,28,3,178
2020-02-16,울산,충북,34,1,1,1,6,1,44,30,0,0,1,8,3,42
2020-02-16,전남,강원,93,0,1,1,5,1,101,65,0,3,1,2,3,74
2020-02-16,전남,경기,1398,7,70,58,27,47,1607,788,8,62,19,14,25,916
2020-02-16,전남,경남,7040,83,230,93,157,279,7882,7028,78,226,100,125,298,7855
2020-02-16,전남,경북,1380,15,33,15,134,46,1623,1303,21,41,23,85,46,1519
2020-02-16,전남,광주,26888,236,603,232,147,977,29083,27118,235,687,197,163,936,29336
2020-02-16,전남,대구,800,6,45,15,23,28,917,796,5,43,4,19,25,892
2020-02-16,전남,대전,457,4,5,0,6,12,484,431,1,6,4,4,12,458
2020-02-16,전남,부산,2061,17,89,62,119,67,2415,2597,14,86,25,114,105,2941
2020-02-16,전남,서울,1458,9,27,53,52,41,1640,821,6,25,7,24,23,906
2020-02-16,전남,세종,307,1,1,1,3,10,323,202,1,3,0,5,5,216
2020-02-16,전남,울산,292,0,7,5,4,10,318,254,0,7,1,5,9,276
2020-02-16,전남,전남,39578,350,741,592,711,1389,43361,39578,350,741,592,711,1389,43361
2020-02-16,전남,전북,6030,79,162,163,263,162,6859,5287,71,169,144,260,170,6101
2020-02-16,전남,충남,7166,42,324,335,422,198,8487,4669,26,333,85,207,148,5468
2020-02-16,전남,충북,623,5,12,35,20,20,715,475,2,22,23,42,25,589
2020-02-16,전북,강원,189,2,4,9,4,6,214,191,0,6,1,0,8,206
2020-02-16,전북,경기,2587,13,86,45,20,84,2835,1419,4,95,26,25,57,1626
2020-02-16,전북,경남,2082,12,84,52,22,62,2314,1849,13,77,47,11,43,2040
2020-02-16,전북,경북,1698,14,57,39,40,52,1900,1620,23,52,34,45,42,1816
2020-02-16,전북,광주,7728,90,204,65,48,245,8380,7332,71,163,46,47,207,7866
2020-02-16,전북,대구,552,5,31,5,2,14,609,483,3,36,2,1,21,546
2020-02-16,전북,대전,3819,26,55,19,10,141,4070,3406,18,51,6,5,120,3606
2020-02-16,전북,부산,454,1,35,9,16,9,524,522,2,33,2,15,17,591
2020-02-16,전북,서울,2215,10,48,12,9,79,2373,1260,4,30,4,6,35,1339
2020-02-16,전북,세종,1054,4,1,2,9,31,1101,788,0,9,0,9,21,827
2020-02-16,전북,울산,66,0,6,0,1,3,76,50,0,6,0,8,2,66
2020-02-16,전북,전남,5287,71,169,144,260,170,6101,6030,79,162,163,263,162,6859
2020-02-16,전북,전북,11863,137,371,362,79,433,13245,11863,137,371,362,79,433,13245
2020-02-16,전북,충남,18013,118,904,258,296,645,20234,13633,126,937,155,189,478,15518
2020-02-16,전북,충북,2508,29,63,110,54,108,2872,1774,42,70,83,40,62,2071
2020-02-16,충남,강원,490,0,20,3,13,21,547,539,0,15,1,9,34,598
2020-02-16,충남,경기,36399,285,1217,389,477,1616,40383,31368,271,1216,449,443,1517,35264
2020-02-16,충남,경남,1761,10,57,43,52,61,1984,1812,7,59,44,39,67,2028
2020-02-16,충남,경북,3406,23,77,61,81,130,3778,4117,30,77,52,97,156,4529
2020-02-16,충남,광주,4407,30,481,99,39,105,5161,5177,41,457,98,91,160,6024
2020-02-16,충남,대구,1081,12,23,24,21,31,1192,1955,11,35,31,47,83,2162
2020-02-16,충남,대전,9734,80,227,69,54,558,10722,10470,70,222,79,48,612,11501
2020-02-16,충남,부산,171,2,4,5,13,7,202,295,3,5,6,12,8,329
2020-02-16,충남,서울,31475,170,1993,471,259,1150,35518,27713,144,2028,169,167,1058,31279
2020-02-16,충남,세종,4183,33,91,44,22,158,4531,4456,41,76,39,26,202,4840
2020-02-16,충남,울산,137,2,4,4,28,3,178,162,1,4,4,32,9,212
2020-02-16,충남,전남,4669,26,333,85,207,148,5468,7166,42,324,335,422,198,8487
2020-02-16,충남,전북,13633,126,937,155,189,478,15518,18013,118,904,258,296,645,20234
2020-02-16,충남,충남,87568,844,4282,1643,1868,3515,99720,87568,844,4282,1643,1868,3515,99720
2020-02-16,충남,충북,9004,133,265,208,238,466,10314,8385,129,268,196,242,410,9630
2020-02-16,충북,강원,4478,48,134,25,41,200,4926,4870,48,115,38,42,211,5324
2020-02-16,충북,경기,28052,463,840,424,361,1333,31473,22752,437,832,457,467,1146,26091
2020-02-16,충북,경남,1721,11,86,86,62,65,2031,1971,13,60,62,34,75,2215
2020-02-16,충북,경북,6012,45,195,141,100,241,6734,7358,62,154,160,157,293,8184
2020-02-16,충북,광주,632,5,27,31,13,12,720,732,8,33,14,7,20,814
2020-02-16,충북,대구,1692,15,65,43,18,59,1892,2901,16,117,56,66,116,3272
2020-02-16,충북,대전,6756,82,217,42,14,428,7539,7812,113,245,39,21,478,8708
2020-02-16,충북,부산,149,2,4,21,14,7,197,309,3,10,8,28,12,370
2020-02-16,충북,서울,14256,121,825,185,92,595,16074,13566,107,810,180,107,554,15324
2020-02-16,충북,세종,251,8,5,4,1,19,288,241,3,6,3,1,12,266
2020-02-16,충북,울산,30,0,0,1,8,3,42,34,1,1,1,6,1,44
2020-02-16,충북,전남,475,2,22,23,42,25,589,623,5,12,35,20,20,715
2020-02-16,충북,전북,1774,42,70,83,40,62,2071,2508,29,63,110,54,108,2872
2020-02-16,충북,충남,8385,129,268,196,242,410,9630,9004,133,265,208,238,466,10314
2020-02-16,충북,충북,26788,435,606,494,429,1310,30062,26788,435,606,494,429,1310,30062
2020-02-17,강원,강원,59699,1822,2799,1150,1868,4161,71499,59699,1822,2799,1150,1868,4161,71499
2020-02-17,강원,경기,18619,501,1181,556,619,839,22315,17249,537,1184,522,720,814,21026
2020-02-17,강원,경남,192,4,11,9,26,6,248,117,2,9,22,10,3,163
2020-02-17,강원,경북,421,18,40,17,15,21,532,406,22,37,16,24,20,525
2020-02-17,강원,광주,73,1,17,7,8,3,109,77,0,11,6,6,1,101
2020-02-17,강원,대구,256,6,10,5,10,9,296,297,5,16,18,14,16,366
2020-02-17,강원,대전,147,4,28,3,1,4,187,175,5,27,2,1,11,221
2020-02-17,강원,부산,2,1,0,1,0,0,4,2,0,0,1,0,0,3
2020-02-17,강원,서울,624,12,250,11,26,28,951,672,14,212,13,12,32,955
2020-02-17,강원,세종,7,0,0,1,0,1,9,9,0,0,1,0,0,10
2020-02-17,강원,울산,2,0,0,0,3,0,5,2,0,0,0,0,0,2
2020-02-17,강원,전남,27,0,1,2,6,4,40,50,0,2,4,12,0,68
2020-02-17,강원,전북,168,4,7,17,17,7,220,131,3,12,6,16,3,171
2020-02-17,강원,충남,368,6,9,13,24,13,433,423,4,19,21,57,15,539
2020-02-17,강원,충북,4337,173,239,173,276,250,5448,4467,161,239,146,230,256,5499
2020-02-17,경기,강원,17249,537,1184,522,720,814,21026,18619,501,1181,556,619,839,22315
2020-02-17,경기,경기,386060,20957,22155,16010,19190,29045,493417,386060,20957,22155,16010,19190,29045,493417
2020-02-17,경기,경남,2500,71,276,420,370,86,3723,1839,50,221,356,313,87,2866
2020-02-17,경기,경북,3943,157,506,592,497,137,5832,3541,158,459,744,463,120,5485
2020-02-17,경기,광주,614,20,149,231,112,23,1149,599,14,120,221,103,26,1083
2020-02-17,경기,대구,1811,96,209,241,168,58,2583,2610,93,209,323,379,89,3703
2020-02-17,경기,대전,1682,75,216,65,30,75,2143,2113,88,183,72,51,96,2603
2020-02-17,경기,부산,203,11,27,72,90,7,410,260,9,30,83,158,11,551
2020-02-17,경기,서울,125817,6471,7954,3562,2531,8375,154710,133057,6189,8211,3872,2319,8797,162445
2020-02-17,경기,세종,38,4,1,1,2,3,49,45,3,5,1,4,4,62
2020-02-17,경기,울산,29,3,4,5,16,4,61,47,1,8,21,69,2,148
2020-02-17,경기,전남,561,17,92,103,91,15,879,445,16,62,96,67,13,699
2020-02-17,경기,전북,1137,38,157,84,191,34,1641,1139,49,147,137,201,46,1719
2020-02-17,경기,충남,31225,1373,2572,2008,3632,1552,42362,28143,1312,2364,1837,3439,1431,38526
2020-02-17,경기,충북,24900,2039,2766,2620,2819,1205,36349,22765,1975,2602,2436,2863,1108,33749
2020-02-17,경남,강원,117,2,9,22,10,3,163,192,4,11,9,26,6,248
2020-02-17,경남,경기,1839,50,221,356,313,87,2866,2500,71,276,420,370,86,3723
2020-02-17,경남,경남,189727,9686,9749,6172,11828,14510,241672,189727,9686,9749,6172,11828,14510,241672
2020-02-17,경남,경북,10167,586,906,831,1786,484,14760,12172,835,1071,1037,2292,583,17990
2020-02-17,경남,광주,894,35,133,149,99,22,1332,964,28,144,116,83,28,1363
2020-02-17,경남,대구,13127,755,897,930,1482,564,17755,11218,517,704,391,421,493,13744
2020-02-17,경남,대전,595,21,97,64,28,27,832,956,23,100,60,47,53,1239
2020-02-17,경남,부산,86480,2547,2777,1655,4373,6110,103942,88305,2649,3046,1780,4969,6328,107077
2020-02-17,경남,서울,1637,28,427,206,118,50,2466,2276,38,448,91,47,69,2969
2020-02-17,경남,세종,168,2,8,9,5,6,198,245,6,17,12,16,9,305
2020-02-17,경남,울산,10150,586,665,450,680,642,13173,9482,564,706,397,649,580,12378
2020-02-17,경남,전남,5825,226,448,410,1322,260,8491,5291,233,394,336,1353,225,7832
2020-02-17,경남,전북,1195,35,99,150,104,26,1609,1113,36,111,158,94,39,1551
2020-02-17,경남,충남,1100,40,103,223,202,35,1703,1324,54,148,211,314,57,2108
2020-02-17,경남,충북,1068,43,130,228,261,38,1768,1125,57,163,334,459,36,2174
2020-02-17,경북,강원,406,22,37,16,24,20,525,421,18,40,17,15,21,532
2020-02-17,경북,경기,3541,158,459,744,463,120,5485,3943,157,506,592,497,137,5832
2020-02-17,경북,경남,12172,835,1071,1037,2292,583,17990,10167,586,906,831,1786,484,14760
2020-02-17,경북,경북,70915,3617,4002,2657,4331,3791,89313,70915,3617,4002,2657,4331,3791,89313
2020-02-17,경북,광주,644,31,103,142,90,21,1031,655,21,89,112,46,27,950
2020-02-17,경북,대구,69948,2748,2660,1360,3127,3791,83634,76533,2956,3024,1717,3721,4031,91982
2020-02-17,경북,대전,1518,41,115,84,66,54,1878,1739,29,102,91,61,65,2087
2020-02-17,경북,부산,4222,100,305,155,578,190,5550,5206,116,310,190,683,252,6757
2020-02-17,경북,서울,2258,76,338,275,104,85,3136,2515,65,299,156,64,89,3188
2020-02-17,경북,세종,243,7,19,18,15,6,308,258,9,23,18,11,10,329
2020-02-17,경북,울산,4904,158,330,420,1114,298,7224,4830,151,316,356,1365,267,7285
2020-02-17,경북,전남,911,32,64,119,402,30,1558,838,34,65,72,443,28,1480
2020-02-17,경북,전북,1490,61,158,164,258,46,2177,1262,80,140,155,309,36,1982
2020-02-17,경북,충남,2798,121,339,465,575,119,4417,2716,128,312,343,607,107,4213
2020-02-17,경북,충북,4385,205,472,641,806,176,6685,4387,207,528,559,879,178,6738
2020-02-17,광주,강원,77,0,11,6,6,1,101,73,1,17,7,8,3,109
2020-02-17,광주,경기,599,14,120,221,103,26,1083,614,20,149,231,112,23,1149
2020-02-17,광주,경남,964,28,144,116,83,28,1363,894,35,133,149,99,22,1332
2020-02-17,광주,경북,655,21,89,112,46,27,950,644,31,103,142,90,21,1031
2020-02-17,광주,광주,10342,345,551,381,160,413,12192,10342,345,551,381,160,413,12192
2020-02-17,광주,대구,462,16,81,63,18,11,651,524,17,81,51,29,10,712
2020-02-17,광주,대전,324,11,15,11,10,8,379,434,10,14,14,11,13,496
2020-02-17,광주,부산,356,9,37,27,59,7,495,376,18,29,50,75,11,559
2020-02-17,광주,서울,443,15,20,50,18,14,560,579,22,27,23,13,18,682
2020-02-17,광주,세종,123,1,10,1,3,3,141,135,2,5,6,2,1,151
2020-02-17,광주,울산,51,1,10,2,2,0,66,38,2,7,5,4,0,56
2020-02-17,광주,전남,24776,770,1055,661,1380,904,29546,21721,723,942,564,1169,845,25964
2020-02-17,광주,전북,5727,325,444,283,259,169,7207,5305,356,424,262,251,163,6761
2020-02-17,광주,충남,3090,99,500,357,217,76,4339,3041,97,506,380,234,77,4335
2020-02-17,광주,충북,449,17,51,100,71,12,700,460,23,74,119,56,13,745
2020-02-17,대구,강원,297,5,16,18,14,16,366,256,6,10,5,10,9,296
2020-02-17,대구,경기,2610,93,209,323,379,89,3703,1811,96,209,241,168,58,2583
2020-02-17,대구,경남,11218,517,704,391,421,493,13744,13127,755,897,930,1482,564,17755
2020-02-17,대구,경북,76533,2956,3024,1717,3721,4031,91982,69948,2748,2660,1360,3127,3791,83634
2020-02-17,대구,광주,524,17,81,51,29,10,712,462,16,81,63,18,11,651
2020-02-17,대구,대구,60318,2060,1715,917,1253,3965,70228,60318,2060,1715,917,1253,3965,70228
2020-02-17,대구,대전,898,35,46,62,28,42,1111,589,18,25,22,18,21,693
2020-02-17,대구,부산,685,56,92,45,137,23,1038,3327,110,202,82,204,126,4051
2020-02-17,대구,서울,2202,51,174,152,66,79,2724,1539,36,123,57,28,46,1829
2020-02-17,대구,세종,263,4,10,8,7,13,305,176,2,3,3,3,5,192
2020-02-17,대구,울산,1506,63,129,78,154,58,1988,1295,55,130,74,171,59,1784
2020-02-17,대구,전남,550,16,36,23,45,14,684,430,13,34,19,44,11,551
2020-02-17,대구,전북,358,7,32,8,20,10,435,279,13,35,17,17,9,370
2020-02-17,대구,충남,1592,64,134,184,231,53,2258,956,49,101,133,144,25,1408
2020-02-17,대구,충북,1779,84,184,246,322,61,2676,1079,73,139,148,106,28,1573
2020-02-17,대전,강원,175,5,27,2,1,11,221,147,4,28,3,1,4,187
2020-02-17,대전,경기,2113,88,183,72,51,96,2603,1682,75,216,65,30,75,2143
2020-02-17,대전,경남,956,23,100,60,47,53,1239,595,21,97,64,28,27,832
2020-02-17,대전,경북,1739,29,102,91,61,65,2087,1518,41,115,84,66,54,1878
2020-02-17,대전,광주,434,10,14,14,11,13,496,324,11,15,11,10,8,379
2020-02-17,대전,대구,589,18,25,22,18,21,693,898,35,46,62,28,42,1111
2020-02-17,대전,대전,12118,347,350,192,199,901,14107,12118,347,350,192,199,901,14107
2020-02-17,대전,부산,68,2,8,8,19,4,109,79,5,5,13,10,4,116
2020-02-17,대전,서울,1580,29,193,25,12,68,1907,1442,46,184,25,11,61,1769
2020-02-17,대전,세종,3185,83,69,24,12,275,3648,3096,78,78,34,40,253,3579
2020-02-17,대전,울산,92,3,13,13,20,5,146,68,4,9,8,18,3,110
2020-02-17,대전,전남,222,7,5,10,17,4,265,97,4,8,4,6,2,121
2020-02-17,대전,전북,2704,61,87,47,38,103,3040,2432,71,84,55,42,88,2772
2020-02-17,대전,충남,15019,412,510,228,197,1057,17423,12695,386,438,230,189,925,14863
2020-02-17,대전,충북,9945,406,432,171,136,713,11803,8386,340,358,163,106,668,10021
2020-02-17,부산,강원,2,0,0,1,0,0,3,2,1,0,1,0,0,4
2020-02-17,부산,경기,260,9,30,83,158,11,551,203,11,27,72,90,7,410
2020-02-17,부산,경남,88305,2649,3046,1780,4969,6328,107077,86480,2547,2777,1655,4373,6110,103942
2020-02-17,부산,경북,5206,116,310,190,683,252,6757,4222,100,305,155,578,190,5550
2020-02-17,부산,광주,376,18,29,50,75,11,559,356,9,37,27,59,7,495
2020-02-17,부산,대구,3327,110,202,82,204,126,4051,685,56,92,45,137,23,1038
2020-02-17,부산,대전,79,5,5,13,10,4,116,68,2,8,8,19,4,109
2020-02-17,부산,부산,44441,643,632,535,2065,3159,51475,44441,643,632,535,2065,3159,51475
2020-02-17,부산,서울,222,7,11,58,30,4,332,170,6,11,27,23,4,241
2020-02-17,부산,세종,17,0,1,0,4,0,22,24,0,1,2,2,0,29
2020-02-17,부산,울산,17917,357,483,625,2497,1314,23193,16092,375,398,370,2497,1216,20948
2020-02-17,부산,전남,2077,77,118,159,500,84,3015,1592,52,94,105,614,57,2514
2020-02-17,부산,전북,324,6,27,27,73,8,465,256,9,31,30,56,6,388
2020-02-17,부산,충남,205,12,19,49,117,6,408,109,8,22,43,122,6,310
2020-02-17,부산,충북,121,8,21,60,141,5,356,84,11,21,79,140,5,340
2020-02-17,서울,강원,672,14,212,13,12,32,955,624,12,250,11,26,28,951
2020-02-17,서울,경기,133057,6189,8211,3872,2319,8797,162445,125817,6471,7954,3562,2531,8375,154710
2020-02-17,서울,경남,2276,38,448,91,47,69,2969,1637,28,427,206,118,50,2466
2020-02-17,서울,경북,2515,65,299,156,64,89,3188,2258,76,338,275,104,85,3136
2020-02-17,서울,광주,579,22,27,23,13,18,682,443,15,20,50,18,14,560
2020-02-17,서울,대구,1539,36,123,57,28,46,1829,2202,51,174,152,66,79,2724
2020-02-17,서울,대전,1442,46,184,25,11,61,1769,1580,29,193,25,12,68,1907
2020-02-17,서울,부산,170,6,11,27,23,4,241,222,7,11,58,30,4,332
2020-02-17,서울,서울,188,8,16,7,1,9,229,188,8,16,7,1,9,229
2020-02-17,서울,세종,32,0,0,2,0,1,35,30,1,1,2,0,2,36
2020-02-17,서울,울산,26,0,2,1,2,1,32,23,0,3,3,10,2,41
2020-02-17,서울,전남,627,9,20,22,27,23,728,463,7,22,31,46,14,583
2020-02-17,서울,전북,1036,12,36,20,29,29,1162,935,17,46,26,24,29,1077
2020-02-17,서울,충남,21545,453,2138,619,605,856,26216,18453,487,2128,879,922,754,23623
2020-02-17,서울,충북,12316,463,1048,640,537,499,15503,10189,558,1013,643,619,431,13453
2020-02-17,세종,강원,9,0,0,1,0,0,10,7,0,0,1,0,1,9
2020-02-17,세종,경기,45,3,5,1,4,4,62,38,4,1,1,2,3,49
2020-02-17,세종,경남,245,6,17,12,16,9,305,168,2,8,9,5,6,198
2020-02-17,세종,경북,258,9,23,18,11,10,329,243,7,19,18,15,6,308
2020-02-17,세종,광주,135,2,5,6,2,1,151,123,1,10,1,3,3,141
2020-02-17,세종,대구,176,2,3,3,3,5,192,263,4,10,8,7,13,305
2020-02-17,세종,대전,3096,78,78,34,40,253,3579,3185,83,69,24,12,275,3648
2020-02-17,세종,부산,24,0,1,2,2,0,29,17,0,1,0,4,0,22
2020-02-17,세종,서울,30,1,1,2,0,2,36,32,0,0,2,0,1,35
2020-02-17,세종,세종,222,21,3,24,0,14,284,222,21,3,24,0,14,284
2020-02-17,세종,울산,9,0,0,1,2,1,13,7,0,0,0,6,0,13
2020-02-17,세종,전남,92,0,5,4,6,1,108,82,2,3,4,11,1,103
2020-02-17,세종,전북,617,20,22,12,30,28,729,571,15,23,16,39,12,676
2020-02-17,세종,충남,5347,149,143,105,117,275,6136,3421,117,154,116,103,177,4088
2020-02-17,세종,충북,301,7,21,14,14,20,377,266,14,14,15,12,21,342
2020-02-17,울산,강원,2,0,0,0,0,0,2,2,0,0,0,3,0,5
2020-02-17,울산,경기,47,1,8,21,69,2,148,29,3,4,5,16,4,61
2020-02-17,울산,경남,9482,564,706,397,649,580,12378,10150,586,665,450,680,642,13173
2020-02-17,울산,경북,4830,151,316,356,1365,267,7285,4904,158,330,420,1114,298,7224
2020-02-17,울산,광주,38,2,7,5,4,0,56,51,1,10,2,2,0,66
2020-02-17,울산,대구,1295,55,130,74,171,59,1784,1506,63,129,78,154,58,1988
2020-02-17,울산,대전,68,4,9,8,18,3,110,92,3,13,13,20,5,146
2020-02-17,울산,부산,16092,375,398,370,2497,1216,20948,17917,357,483,625,2497,1314,23193
2020-02-17,울산,서울,23,0,3,3,10,2,41,26,0,2,1,2,1,32
2020-02-17,울산,세종,7,0,0,0,6,0,13,9,0,0,1,2,1,13
2020-02-17,울산,울산,8026,287,509,307,593,725,10447,8026,287,509,307,593,725,10447
2020-02-17,울산,전남,205,10,20,10,26,5,276,162,17,29,9,39,4,260
2020-02-17,울산,전북,48,0,7,2,19,0,76,33,0,6,5,3,3,50
2020-02-17,울산,충남,146,3,12,38,131,3,333,125,3,14,25,100,1,268
2020-02-17,울산,충북,26,1,5,21,49,1,103,20,1,2,16,35,2,76
2020-02-17,전남,강원,50,0,2,4,12,0,68,27,0,1,2,6,4,40
2020-02-17,전남,경기,445,16,62,96,67,13,699,561,17,92,103,91,15,879
2020-02-17,전남,경남,5291,233,394,336,1353,225,7832,5825,226,448,410,1322,260,8491
2020-02-17,전남,경북,838,34,65,72,443,28,1480,911,32,64,119,402,30,1558
2020-02-17,전남,광주,21721,723,942,564,1169,845,25964,24776,770,1055,661,1380,904,29546
2020-02-17,전남,대구,430,13,34,19,44,11,551,550,16,36,23,45,14,684
2020-02-17,전남,대전,97,4,8,4,6,2,121,222,7,5,10,17,4,265
2020-02-17,전남,부산,1592,52,94,105,614,57,2514,2077,77,118,159,500,84,3015
2020-02-17,전남,서울,463,7,22,31,46,14,583,627,9,20,22,27,23,728
2020-02-17,전남,세종,82,2,3,4,11,1,103,92,0,5,4,6,1,108
2020-02-17,전남,울산,162,17,29,9,39,4,260,205,10,20,10,26,5,276
2020-02-17,전남,전남,36628,1072,1343,1412,3285,1372,45112,36628,1072,1343,1412,3285,1372,45112
2020-02-17,전남,전북,4484,248,498,580,1476,127,7413,4238,206,415,552,1173,125,6709
2020-02-17,전남,충남,1972,26,260,346,633,59,3296,2215,47,269,232,561,67,3391
2020-02-17,전남,충북,193,10,23,64,152,7,449,225,9,27,47,143,9,460
2020-02-17,전북,강원,131,3,12,6,16,3,171,168,4,7,17,17,7,220
2020-02-17,전북,경기,1139,49,147,137,201,46,1719,1137,38,157,84,191,34,1641
2020-02-17,전북,경남,1113,36,111,158,94,39,1551,1195,35,99,150,104,26,1609
2020-02-17,전북,경북,1262,80,140,155,309,36,1982,1490,61,158,164,258,46,2177
2020-02-17,전북,광주,5305,356,424,262,251,163,6761,5727,325,444,283,259,169,7207
2020-02-17,전북,대구,279,13,35,17,17,9,370,358,7,32,8,20,10,435
2020-02-17,전북,대전,2432,71,84,55,42,88,2772,2704,61,87,47,38,103,3040
2020-02-17,전북,부산,256,9,31,30,56,6,388,324,6,27,27,73,8,465
2020-02-17,전북,서울,935,17,46,26,24,29,1077,1036,12,36,20,29,29,1162
2020-02-17,전북,세종,571,15,23,16,39,12,676,617,20,22,12,30,28,729
2020-02-17,전북,울산,33,0,6,5,3,3,50,48,0,7,2,19,0,76
2020-02-17,전북,전남,4238,206,415,552,1173,125,6709,4484,248,498,580,1476,127,7413
2020-02-17,전북,전북,13696,529,830,1092,725,451,17323,13696,529,830,1092,725,451,17323
2020-02-17,전북,충남,10774,393,1444,966,1543,360,15480,10971,409,1481,824,1443,359,15487
2020-02-17,전북,충북,1576,85,137,247,241,56,2342,1478,103,195,249,259,59,2343
2020-02-17,충남,강원,423,4,19,21,57,15,539,368,6,9,13,24,13,433
2020-02-17,충남,경기,28143,1312,2364,1837,3439,1431,38526,31225,1373,2572,2008,3632,1552,42362
2020-02-17,충남,경남,1324,54,148,211,314,57,2108,1100,40,103,223,202,35,1703
2020-02-17,충남,경북,2716,128,312,343,607,107,4213,2798,121,339,465,575,119,4417
2020-02-17,충남,광주,3041,97,506,380,234,77,4335,3090,99,500,357,217,76,4339
2020-02-17,충남,대구,956,49,101,133,144,25,1408,1592,64,134,184,231,53,2258
2020-02-17,충남,대전,12695,386,438,230,189,925,14863,15019,412,510,228,197,1057,17423
2020-02-17,충남,부산,109,8,22,43,122,6,310,205,12,19,49,117,6,408
2020-02-17,충남,서울,18453,487,2128,879,922,754,23623,21545,453,2138,619,605,856,26216
2020-02-17,충남,세종,3421,117,154,116,103,177,4088,5347,149,143,105,117,275,6136
2020-02-17,충남,울산,125,3,14,25,100,1,268,146,3,12,38,131,3,333
2020-02-17,충남,전남,2215,47,269,232,561,67,3391,1972,26,260,346,633,59,3296
2020-02-17,충남,전북,10971,409,1481,824,1443,359,15487,10774,393,1444,966,1543,360,15480
2020-02-17,충남,충남,78638,3083,7034,5752,8277,3666,106450,78638,3083,7034,5752,8277,3666,106450
2020-02-17,충남,충북,11755,609,812,849,1188,651,15864,10994,585,791,814,1273,612,15069
2020-02-17,충북,강원,4467,161,239,146,230,256,5499,4337,173,239,173,276,250,5448
2020-02-17,충북,경기,22765,1975,2602,2436,2863,1108,33749,24900,2039,2766,2620,2819,1205,36349
2020-02-17,충북,경남,1125,57,163,334,459,36,2174,1068,43,130,228,261,38,1768
2020-02-17,충북,경북,4387,207,528,559,879,178,6738,4385,205,472,641,806,176,6685
2020-02-17,충북,광주,460,23,74,119,56,13,745,449,17,51,100,71,12,700
2020-02-17,충북,대구,1079,73,139,148,106,28,1573,1779,84,184,246,322,61,2676
2020-02-17,충북,대전,8386,340,358,163,106,668,10021,9945,406,432,171,136,713,11803
2020-02-17,충북,부산,84,11,21,79,140,5,340,121,8,21,60,141,5,356
2020-02-17,충북,서울,10189,558,1013,643,619,431,13453,12316,463,1048,640,537,499,15503
2020-02-17,충북,세종,266,14,14,15,12,21,342,301,7,21,14,14,20,377
2020-02-17,충북,울산,20,1,2,16,35,2,76,26,1,5,21,49,1,103
2020-02-17,충북,전남,225,9,27,47,143,9,460,193,10,23,64,152,7,449
2020-02-17,충북,전북,1478,103,195,249,259,59,2343,1576,85,137,247,241,56,2342
2020-02-17,충북,충남,10994,585,791,814,1273,612,15069,11755,609,812,849,1188,651,15864
2020-02-17,충북,충북,31358,1629,2143,2009,2343,1827,41309,31358,1629,2143,2009,2343,1827,41309
2020-02-18,강원,강원,60358,2194,3004,1288,2007,4183,73034,60358,2194,3004,1288,2007,4183,73034
2020-02-18,강원,경기,16240,578,1187,631,677,787,20100,16957,610,1145,679,799,821,21011
2020-02-18,강원,경남,166,4,14,15,17,6,222,90,2,5,29,9,6,141
2020-02-18,강원,경북,418,15,38,18,20,11,520,377,12,26,24,32,12,483
2020-02-18,강원,광주,69,0,17,12,6,1,105,70,3,15,10,5,1,104
2020-02-18,강원,대구,205,3,7,21,4,3,243,287,7,17,15,10,5,341
2020-02-18,강원,대전,151,2,26,3,1,7,190,141,2,27,6,2,5,183
2020-02-18,강원,부산,6,1,0,2,2,0,11,1,0,0,2,0,0,3
2020-02-18,강원,서울,551,21,236,10,14,13,845,640,18,203,19,9,19,908
2020-02-18,강원,세종,1,1,1,3,0,0,6,4,1,0,1,2,0,8
2020-02-18,강원,울산,2,0,0,0,0,0,2,5,0,0,0,1,0,6
2020-02-18,강원,전남,21,0,1,1,10,0,33,18,1,3,1,7,1,31
2020-02-18,강원,전북,129,0,13,15,10,4,171,115,5,10,15,33,6,184
2020-02-18,강원,충남,300,7,21,25,52,11,416,358,8,20,46,72,13,517
2020-02-18,강원,충북,4521,216,277,218,323,285,5840,4515,197,282,220,270,276,5760
2020-02-18,경기,강원,16957,610,1145,679,799,821,21011,16240,578,1187,631,677,787,20100
2020-02-18,경기,경기,405398,23092,24303,18214,21455,30926,523388,405398,23092,24303,18214,21455,30926,523388
2020-02-18,경기,경남,2293,108,339,841,630,75,4286,1621,76,269,563,406,52,2987
2020-02-18,경기,경북,3653,226,524,770,633,118,5924,3331,231,496,919,591,98,5666
2020-02-18,경기,광주,634,39,156,288,147,20,1284,539,25,135,232,103,8,1042
2020-02-18,경기,대구,1828,107,226,424,248,48,2881,2380,126,254,472,424,76,3732
2020-02-18,경기,대전,1816,95,209,129,60,70,2379,1743,122,201,101,45,88,2300
2020-02-18,경기,부산,150,23,48,197,150,6,574,214,23,37,182,258,5,719
2020-02-18,경기,서울,140025,7197,8463,4612,3508,9696,173501,141014,6907,8735,4280,3069,9651,173656
2020-02-18,경기,세종,40,1,3,2,1,1,48,49,2,4,5,6,0,66
2020-02-18,경기,울산,28,4,7,19,19,2,79,33,2,11,35,94,1,176
2020-02-18,경기,전남,531,21,94,166,136,12,960,488,18,78,102,102,11,799
2020-02-18,경기,전북,1182,47,172,137,210,29,1777,1179,50,154,182,207,37,1809
2020-02-18,경기,충남,32350,1509,2744,2339,4217,1627,44786,31497,1440,2661,2296,3958,1561,43413
2020-02-18,경기,충북,24629,2144,2802,3025,3073,1223,36896,23907,2084,2751,2781,3108,1144,35775
2020-02-18,경남,강원,90,2,5,29,9,6,141,166,4,14,15,17,6,222
2020-02-18,경남,경기,1621,76,269,563,406,52,2987,2293,108,339,841,630,75,4286
2020-02-18,경남,경남,190394,10112,10245,7046,12709,14692,245198,190394,10112,10245,7046,12709,14692,245198
2020-02-18,경남,경북,9366,630,979,905,1835,417,14132,11790,864,1170,1269,2670,532,18295
2020-02-18,경남,광주,844,39,133,166,110,15,1307,903,35,123,142,93,31,1327
2020-02-18,경남,대구,12308,743,1024,1050,1511,511,17147,10230,554,741,452,473,441,12891
2020-02-18,경남,대전,625,26,104,74,35,22,886,862,31,117,132,73,35,1250
2020-02-18,경남,부산,86552,2671,2985,1761,4750,6218,104937,85111,2780,3104,1777,5066,6108,103946
2020-02-18,경남,서울,1366,41,435,302,137,36,2317,2161,66,455,213,118,56,3069
2020-02-18,경남,세종,154,1,8,14,9,1,187,217,1,19,14,13,5,269
2020-02-18,경남,울산,9675,649,713,453,801,616,12907,9173,606,740,408,707,590,12224
2020-02-18,경남,전남,5365,276,449,507,1399,246,8242,5358,288,426,399,1358,227,8056
2020-02-18,경남,전북,1236,41,120,118,158,45,1718,1217,47,101,100,183,36,1684
2020-02-18,경남,충남,891,48,141,247,242,36,1605,1232,60,168,344,582,39,2425
2020-02-18,경남,충북,937,44,149,307,264,29,1730,1154,84,220,526,685,38,2707
2020-02-18,경북,강원,377,12,26,24,32,12,483,418,15,38,18,20,11,520
2020-02-18,경북,경기,3331,231,496,919,591,98,5666,3653,226,524,770,633,118,5924
2020-02-18,경북,경남,11790,864,1170,1269,2670,532,18295,9366,630,979,905,1835,417,14132
2020-02-18,경북,경북,70291,3801,4252,2901,4749,3892,89886,70291,3801,4252,2901,4749,3892,89886
2020-02-18,경북,광주,668,43,126,193,112,17,1159,621,43,93,148,55,11,971
2020-02-18,경북,대구,70526,2875,2917,1539,3247,3930,85034,74057,3034,3360,1912,3793,4011,90167
2020-02-18,경북,대전,1492,63,128,98,73,61,1915,1526,60,110,127,60,54,1937
2020-02-18,경북,부산,3905,110,304,198,622,205,5344,4494,125,345,203,734,242,6143
2020-02-18,경북,서울,2183,120,324,395,165,65,3252,2609,82,330,262,131,62,3476
2020-02-18,경북,세종,223,6,11,20,15,1,276,233,7,11,9,19,8,287
2020-02-18,경북,울산,4914,174,361,434,1148,265,7296,4760,166,353,353,1362,247,7241
2020-02-18,경북,전남,736,32,80,91,254,23,1216,704,28,79,82,302,27,1222
2020-02-18,경북,전북,1521,82,172,192,401,50,2418,1391,77,163,153,467,42,2293
2020-02-18,경북,충남,2608,150,336,529,595,81,4299,2890,125,348,438,840,97,4738
2020-02-18,경북,충북,4462,235,537,736,1005,171,7146,4350,252,559,698,1042,162,7063
2020-02-18,광주,강원,70,3,15,10,5,1,104,69,0,17,12,6,1,105
2020-02-18,광주,경기,539,25,135,232,103,8,1042,634,39,156,288,147,20,1284
2020-02-18,광주,경남,903,35,123,142,93,31,1327,844,39,133,166,110,15,1307
2020-02-18,광주,경북,621,43,93,148,55,11,971,668,43,126,193,112,17,1159
2020-02-18,광주,광주,11291,476,582,354,206,448,13357,11291,476,582,354,206,448,13357
2020-02-18,광주,대구,497,29,100,71,34,15,746,550,27,98,75,29,13,792
2020-02-18,광주,대전,356,16,13,19,15,10,429,426,18,17,36,13,7,517
2020-02-18,광주,부산,314,9,48,38,55,6,470,360,16,50,82,96,12,616
2020-02-18,광주,서울,446,17,25,81,21,15,605,587,24,22,57,16,21,727
2020-02-18,광주,세종,95,1,10,1,0,0,107,101,3,6,5,0,2,117
2020-02-18,광주,울산,44,1,8,2,2,1,58,40,2,9,7,12,1,71
2020-02-18,광주,전남,27085,902,1120,693,1337,991,32128,25601,876,977,615,1129,976,30174
2020-02-18,광주,전북,6347,440,517,357,284,220,8165,6581,462,444,329,297,227,8340
2020-02-18,광주,충남,3026,98,513,439,257,81,4414,3111,130,516,569,338,90,4754
2020-02-18,광주,충북,447,25,65,103,54,14,708,526,30,87,158,88,16,905
2020-02-18,대구,강원,287,7,17,15,10,5,341,205,3,7,21,4,3,243
2020-02-18,대구,경기,2380,126,254,472,424,76,3732,1828,107,226,424,248,48,2881
2020-02-18,대구,경남,10230,554,741,452,473,441,12891,12308,743,1024,1050,1511,511,17147
2020-02-18,대구,경북,74057,3034,3360,1912,3793,4011,90167,70526,2875,2917,1539,3247,3930,85034
2020-02-18,대구,광주,550,27,98,75,29,13,792,497,29,100,71,34,15,746
2020-02-18,대구,대구,59070,2143,1844,1029,1067,3966,69119,59070,2143,1844,1029,1067,3966,69119
2020-02-18,대구,대전,827,50,64,77,39,34,1091,641,37,43,53,21,29,824
2020-02-18,대구,부산,512,59,99,58,123,18,869,2827,118,235,84,229,118,3611
2020-02-18,대구,서울,2081,76,192,271,103,61,2784,1553,57,150,140,52,53,2005
2020-02-18,대구,세종,209,4,11,5,9,6,244,147,3,2,6,4,8,170
2020-02-18,대구,울산,1290,59,138,71,169,49,1776,1244,56,138,82,209,51,1780
2020-02-18,대구,전남,408,8,45,27,44,16,548,389,13,49,32,69,11,563
2020-02-18,대구,전북,333,15,43,18,24,8,441,290,16,41,20,25,9,401
2020-02-18,대구,충남,1286,67,143,211,226,35,1968,934,60,118,187,160,25,1484
2020-02-18,대구,충북,1586,96,216,250,373,49,2570,1145,81,159,279,164,31,1859
2020-02-18,대전,강원,141,2,27,6,2,5,183,151,2,26,3,1,7,190
2020-02-18,대전,경기,1743,122,201,101,45,88,2300,1816,95,209,129,60,70,2379
2020-02-18,대전,경남,862,31,117,132,73,35,1250,625,26,104,74,35,22,886
2020-02-18,대전,경북,1526,60,110,127,60,54,1937,1492,63,128,98,73,61,1915
2020-02-18,대전,광주,426,18,17,36,13,7,517,356,16,13,19,15,10,429
2020-02-18,대전,대구,641,37,43,53,21,29,824,827,50,64,77,39,34,1091
2020-02-18,대전,대전,12960,365,387,286,212,1016,15226,12960,365,387,286,212,1016,15226
2020-02-18,대전,부산,57,5,7,13,14,1,97,59,3,10,16,21,3,112
2020-02-18,대전,서울,1580,38,190,43,6,67,1924,1636,56,188,31,9,81,2001
2020-02-18,대전,세종,3067,114,75,24,22,251,3553,3194,109,74,41,44,279,3741
2020-02-18,대전,울산,94,3,10,21,20,3,151,71,2,10,12,26,3,124
2020-02-18,대전,전남,120,1,1,8,5,4,139,98,1,7,9,6,4,125
2020-02-18,대전,전북,3107,77,98,116,58,122,3578,3161,83,92,79,50,116,3581
2020-02-18,대전,충남,14908,463,529,214,220,1147,17481,13599,432,460,223,202,1044,15960
2020-02-18,대전,충북,10501,448,436,192,148,809,12534,9399,374,391,162,121,724,11171
2020-02-18,부산,강원,1,0,0,2,0,0,3,6,1,0,2,2,0,11
2020-02-18,부산,경기,214,23,37,182,258,5,719,150,23,48,197,150,6,574
2020-02-18,부산,경남,85111,2780,3104,1777,5066,6108,103946,86552,2671,2985,1761,4750,6218,104937
2020-02-18,부산,경북,4494,125,345,203,734,242,6143,3905,110,304,198,622,205,5344
2020-02-18,부산,광주,360,16,50,82,96,12,616,314,9,48,38,55,6,470
2020-02-18,부산,대구,2827,118,235,84,229,118,3611,512,59,99,58,123,18,869
2020-02-18,부산,대전,59,3,10,16,21,3,112,57,5,7,13,14,1,97
2020-02-18,부산,부산,43410,775,670,620,2203,3185,50863,43410,775,670,620,2203,3185,50863
2020-02-18,부산,서울,152,16,22,75,74,3,342,115,13,16,75,39,3,261
2020-02-18,부산,세종,14,1,1,3,4,1,24,12,0,2,1,1,0,16
2020-02-18,부산,울산,16255,352,466,671,2614,1160,21518,16215,393,435,420,2559,1133,21155
2020-02-18,부산,전남,1833,94,141,195,509,54,2826,1504,98,128,141,534,63,2468
2020-02-18,부산,전북,286,9,29,41,89,4,458,225,6,31,56,84,4,406
2020-02-18,부산,충남,115,10,25,77,165,3,395,102,11,28,103,172,3,419
2020-02-18,부산,충북,96,10,23,96,188,2,415,65,9,34,126,163,1,398
2020-02-18,서울,강원,640,18,203,19,9,19,908,551,21,236,10,14,13,845
2020-02-18,서울,경기,141014,6907,8735,4280,3069,9651,173656,140025,7197,8463,4612,3508,9696,173501
2020-02-18,서울,경남,2161,66,455,213,118,56,3069,1366,41,435,302,137,36,2317
2020-02-18,서울,경북,2609,82,330,262,131,62,3476,2183,120,324,395,165,65,3252
2020-02-18,서울,광주,587,24,22,57,16,21,727,446,17,25,81,21,15,605
2020-02-18,서울,대구,1553,57,150,140,52,53,2005,2081,76,192,271,103,61,2784
2020-02-18,서울,대전,1636,56,188,31,9,81,2001,1580,38,190,43,6,67,1924
2020-02-18,서울,부산,115,13,16,75,39,3,261,152,16,22,75,74,3,342
2020-02-18,서울,서울,181,5,10,2,0,13,211,181,5,10,2,0,13,211
2020-02-18,서울,세종,40,0,0,0,0,2,42,33,0,1,1,0,0,35
2020-02-18,서울,울산,24,1,4,4,4,1,38,28,1,9,18,29,2,87
2020-02-18,서울,전남,592,11,16,33,29,18,699,559,14,25,78,36,9,721
2020-02-18,서울,전북,1248,23,43,26,37,37,1414,1026,30,55,35,37,24,1207
2020-02-18,서울,충남,21376,561,2174,813,708,832,26464,20465,603,2177,1250,1109,770,26374
2020-02-18,서울,충북,11948,506,1126,790,668,461,15499,11312,642,1133,827,738,406,15058
2020-02-18,세종,강원,4,1,0,1,2,0,8,1,1,1,3,0,0,6
2020-02-18,세종,경기,49,2,4,5,6,0,66,40,1,3,2,1,1,48
2020-02-18,세종,경남,217,1,19,14,13,5,269,154,1,8,14,9,1,187
2020-02-18,세종,경북,233,7,11,9,19,8,287,223,6,11,20,15,1,276
2020-02-18,세종,광주,101,3,6,5,0,2,117,95,1,10,1,0,0,107
2020-02-18,세종,대구,147,3,2,6,4,8,170,209,4,11,5,9,6,244
2020-02-18,세종,대전,3194,109,74,41,44,279,3741,3067,114,75,24,22,251,3553
2020-02-18,세종,부산,12,0,2,1,1,0,16,14,1,1,3,4,1,24
2020-02-18,세종,서울,33,0,1,1,0,0,35,40,0,0,0,0,2,42
2020-02-18,세종,세종,229,25,6,6,0,12,278,229,25,6,6,0,12,278
2020-02-18,세종,울산,10,0,1,2,2,0,15,7,0,0,3,4,0,14
2020-02-18,세종,전남,89,1,4,4,4,2,104,77,3,3,2,5,1,91
2020-02-18,세종,전북,638,17,25,20,42,17,759,570,18,24,28,40,18,698
2020-02-18,세종,충남,5287,157,153,111,154,305,6167,3824,130,162,100,146,208,4570
2020-02-18,세종,충북,301,14,21,20,14,20,390,275,14,23,15,11,23,361
2020-02-18,울산,강원,5,0,0,0,1,0,6,2,0,0,0,0,0,2
2020-02-18,울산,경기,33,2,11,35,94,1,176,28,4,7,19,19,2,79
2020-02-18,울산,경남,9173,606,740,408,707,590,12224,9675,649,713,453,801,616,12907
2020-02-18,울산,경북,4760,166,353,353,1362,247,7241,4914,174,361,434,1148,265,7296
2020-02-18,울산,광주,40,2,9,7,12,1,71,44,1,8,2,2,1,58
2020-02-18,울산,대구,1244,56,138,82,209,51,1780,1290,59,138,71,169,49,1776
2020-02-18,울산,대전,71,2,10,12,26,3,124,94,3,10,21,20,3,151
2020-02-18,울산,부산,16215,393,435,420,2559,1133,21155,16255,352,466,671,2614,1160,21518
2020-02-18,울산,서울,28,1,9,18,29,2,87,24,1,4,4,4,1,38
2020-02-18,울산,세종,7,0,0,3,4,0,14,10,0,1,2,2,0,15
2020-02-18,울산,울산,8077,290,529,317,613,772,10598,8077,290,529,317,613,772,10598
2020-02-18,울산,전남,177,15,12,9,38,4,255,160,17,22,11,54,3,267
2020-02-18,울산,전북,22,2,6,2,26,1,59,40,0,6,7,4,2,59
2020-02-18,울산,충남,97,4,15,37,128,4,285,95,6,15,50,117,6,289
2020-02-18,울산,충북,26,2,8,25,48,0,109,21,6,7,18,38,0,90
2020-02-18,전남,강원,18,1,3,1,7,1,31,21,0,1,1,10,0,33
2020-02-18,전남,경기,488,18,78,102,102,11,799,531,21,94,166,136,12,960
2020-02-18,전남,경남,5358,288,426,399,1358,227,8056,5365,276,449,507,1399,246,8242
2020-02-18,전남,경북,704,28,79,82,302,27,1222,736,32,80,91,254,23,1216
2020-02-18,전남,광주,25601,876,977,615,1129,976,30174,27085,902,1120,693,1337,991,32128
2020-02-18,전남,대구,389,13,49,32,69,11,563,408,8,45,27,44,16,548
2020-02-18,전남,대전,98,1,7,9,6,4,125,120,1,1,8,5,4,139
2020-02-18,전남,부산,1504,98,128,141,534,63,2468,1833,94,141,195,509,54,2826
2020-02-18,전남,서울,559,14,25,78,36,9,721,592,11,16,33,29,18,699
2020-02-18,전남,세종,77,3,3,2,5,1,91,89,1,4,4,4,2,104
2020-02-18,전남,울산,160,17,22,11,54,3,267,177,15,12,9,38,4,255
2020-02-18,전남,전남,38765,1213,1555,1565,3712,1518,48328,38765,1213,1555,1565,3712,1518,48328
2020-02-18,전남,전북,5369,303,683,790,2556,153,9854,4745,213,562,669,1757,128,8074
2020-02-18,전남,충남,1391,45,219,412,308,38,2413,1880,58,270,288,386,63,2945
2020-02-18,전남,충북,124,10,16,45,88,3,286,139,12,29,53,134,4,371
2020-02-18,전북,강원,115,5,10,15,33,6,184,129,0,13,15,10,4,171
2020-02-18,전북,경기,1179,50,154,182,207,37,1809,1182,47,172,137,210,29,1777
2020-02-18,전북,경남,1217,47,101,100,183,36,1684,1236,41,120,118,158,45,1718
2020-02-18,전북,경북,1391,77,163,153,467,42,2293,1521,82,172,192,401,50,2418
2020-02-18,전북,광주,6581,462,444,329,297,227,8340,6347,440,517,357,284,220,8165
2020-02-18,전북,대구,290,16,41,20,25,9,401,333,15,43,18,24,8,441
2020-02-18,전북,대전,3161,83,92,79,50,116,3581,3107,77,98,116,58,122,3578
2020-02-18,전북,부산,225,6,31,56,84,4,406,286,9,29,41,89,4,458
2020-02-18,전북,서울,1026,30,55,35,37,24,1207,1248,23,43,26,37,37,1414
2020-02-18,전북,세종,570,18,24,28,40,18,698,638,17,25,20,42,17,759
2020-02-18,전북,울산,40,0,6,7,4,2,59,22,2,6,2,26,1,59
2020-02-18,전북,전남,4745,213,562,669,1757,128,8074,5369,303,683,790,2556,153,9854
2020-02-18,전북,전북,15137,567,944,832,1328,493,19301,15137,567,944,832,1328,493,19301
2020-02-18,전북,충남,12335,516,1694,1291,2247,376,18459,12174,513,1583,1100,1835,388,17593
2020-02-18,전북,충북,1815,108,177,323,428,54,2905,1734,101,230,276,348,38,2727
2020-02-18,충남,강원,358,8,20,46,72,13,517,300,7,21,25,52,11,416
2020-02-18,충남,경기,31497,1440,2661,2296,3958,1561,43413,32350,1509,2744,2339,4217,1627,44786
2020-02-18,충남,경남,1232,60,168,344,582,39,2425,891,48,141,247,242,36,1605
2020-02-18,충남,경북,2890,125,348,438,840,97,4738,2608,150,336,529,595,81,4299
2020-02-18,충남,광주,3111,130,516,569,338,90,4754,3026,98,513,439,257,81,4414
2020-02-18,충남,대구,934,60,118,187,160,25,1484,1286,67,143,211,226,35,1968
2020-02-18,충남,대전,13599,432,460,223,202,1044,15960,14908,463,529,214,220,1147,17481
2020-02-18,충남,부산,102,11,28,103,172,3,419,115,10,25,77,165,3,395
2020-02-18,충남,서울,20465,603,2177,1250,1109,770,26374,21376,561,2174,813,708,832,26464
2020-02-18,충남,세종,3824,130,162,100,146,208,4570,5287,157,153,111,154,305,6167
2020-02-18,충남,울산,95,6,15,50,117,6,289,97,4,15,37,128,4,285
2020-02-18,충남,전남,1880,58,270,288,386,63,2945,1391,45,219,412,308,38,2413
2020-02-18,충남,전북,12174,513,1583,1100,1835,388,17593,12335,516,1694,1291,2247,376,18459
2020-02-18,충남,충남,83954,3388,7816,6877,9547,3978,115560,83954,3388,7816,6877,9547,3978,115560
2020-02-18,충남,충북,12885,689,899,1013,1424,748,17658,11057,646,835,902,1422,617,15479
2020-02-18,충북,강원,4515,197,282,220,270,276,5760,4521,216,277,218,323,285,5840
2020-02-18,충북,경기,23907,2084,2751,2781,3108,1144,35775,24629,2144,2802,3025,3073,1223,36896
2020-02-18,충북,경남,1154,84,220,526,685,38,2707,937,44,149,307,264,29,1730
2020-02-18,충북,경북,4350,252,559,698,1042,162,7063,4462,235,537,736,1005,171,7146
2020-02-18,충북,광주,526,30,87,158,88,16,905,447,25,65,103,54,14,708
2020-02-18,충북,대구,1145,81,159,279,164,31,1859,1586,96,216,250,373,49,2570
2020-02-18,충북,대전,9399,374,391,162,121,724,11171,10501,448,436,192,148,809,12534
2020-02-18,충북,부산,65,9,34,126,163,1,398,96,10,23,96,188,2,415
2020-02-18,충북,서울,11312,642,1133,827,738,406,15058,11948,506,1126,790,668,461,15499
2020-02-18,충북,세종,275,14,23,15,11,23,361,301,14,21,20,14,20,390
2020-02-18,충북,울산,21,6,7,18,38,0,90,26,2,8,25,48,0,109
2020-02-18,충북,전남,139,12,29,53,134,4,371,124,10,16,45,88,3,286
2020-02-18,충북,전북,1734,101,230,276,348,38,2727,1815,108,177,323,428,54,2905
2020-02-18,충북,충남,11057,646,835,902,1422,617,15479,12885,689,899,1013,1424,748,17658
2020-02-18,충북,충북,34699,1945,2287,2073,2730,2002,45736,34699,1945,2287,2073,2730,2002,45736
2020-02-19,강원,강원,63682,2097,3005,1208,2049,4298,76339,63682,2097,3005,1208,2049,4298,76339
2020-02-19,강원,경기,17109,564,1212,644,693,854,21076,18556,623,1201,679,825,939,22823
2020-02-19,강원,경남,110,2,14,15,19,1,161,89,1,6,19,11,3,129
2020-02-19,강원,경북,412,21,36,15,31,13,528,426,10,26,31,35,11,539
2020-02-19,강원,광주,63,2,19,11,12,0,107,67,1,11,18,8,3,108
2020-02-19,강원,대구,176,2,13,6,6,7,210,266,10,22,20,11,3,332
2020-02-19,강원,대전,135,3,31,6,0,5,180,158,3,29,2,2,6,200
2020-02-19,강원,부산,4,0,0,2,3,0,9,3,0,0,0,2,1,6
2020-02-19,강원,서울,549,10,242,7,22,23,853,646,14,197,15,10,24,906
2020-02-19,강원,세종,5,0,1,0,0,1,7,12,1,0,1,1,0,15
2020-02-19,강원,울산,3,0,1,0,0,0,4,1,0,0,0,0,0,1
2020-02-19,강원,전남,38,1,1,3,9,1,53,17,0,3,4,3,0,27
2020-02-19,강원,전북,107,4,16,8,10,2,147,173,7,13,18,26,3,240
2020-02-19,강원,충남,308,10,20,26,50,13,427,405,8,18,43,73,11,558
2020-02-19,강원,충북,4587,239,318,243,330,256,5973,4632,195,314,204,318,260,5923
2020-02-19,경기,강원,18556,623,1201,679,825,939,22823,17109,564,1212,644,693,854,21076
2020-02-19,경기,경기,423532,22885,24243,18865,22746,32269,544540,423532,22885,24243,18865,22746,32269,544540
2020-02-19,경기,경남,2379,106,341,731,565,77,4199,1750,69,247,523,410,51,3050
2020-02-19,경기,경북,3595,194,478,724,608,117,5716,3687,208,481,873,569,131,5949
2020-02-19,경기,광주,759,33,182,321,164,19,1478,615,30,159,246,109,15,1174
2020-02-19,경기,대구,1836,89,209,371,235,39,2779,2660,124,229,458,442,73,3986
2020-02-19,경기,대전,1876,107,208,116,49,85,2441,1873,111,192,96,49,92,2413
2020-02-19,경기,부산,203,22,43,212,144,5,629,219,22,32,143,246,8,670
2020-02-19,경기,서울,147406,7517,8849,4685,3658,10040,182155,145712,7018,8886,4448,3272,9894,179230
2020-02-19,경기,세종,36,2,2,5,2,0,47,56,5,5,6,1,2,75
2020-02-19,경기,울산,46,2,1,20,19,1,89,48,4,5,31,73,0,161
2020-02-19,경기,전남,632,19,113,168,155,22,1109,554,19,81,112,84,18,868
2020-02-19,경기,전북,1303,49,160,125,178,32,1847,1354,42,172,179,247,39,2033
2020-02-19,경기,충남,35464,1487,2793,2362,4364,1752,48222,34750,1432,2745,2276,4055,1644,46902
2020-02-19,경기,충북,26176,2238,2918,3110,3225,1260,38927,25803,2168,2863,2750,3461,1232,38277
2020-02-19,경남,강원,89,1,6,19,11,3,129,110,2,14,15,19,1,161
2020-02-19,경남,경기,1750,69,247,523,410,51,3050,2379,106,341,731,565,77,4199
2020-02-19,경남,경남,193931,9865,10063,7534,13013,14804,249210,193931,9865,10063,7534,13013,14804,249210
2020-02-19,경남,경북,9530,606,957,997,1905,418,14413,12453,866,1151,1248,2620,530,18868
2020-02-19,경남,광주,993,58,134,185,139,25,1534,978,52,157,145,102,25,1459
2020-02-19,경남,대구,12397,750,968,981,1514,523,17133,10175,507,742,415,486,433,12758
2020-02-19,경남,대전,668,16,103,85,37,37,946,928,21,108,118,67,47,1289
2020-02-19,경남,부산,87539,2637,2952,1838,4571,6263,105800,86371,2763,3120,1868,4857,6213,105192
2020-02-19,경남,서울,1584,26,424,289,133,42,2498,2219,58,448,188,115,61,3089
2020-02-19,경남,세종,165,2,14,9,1,5,196,262,2,24,15,16,4,323
2020-02-19,경남,울산,9639,640,724,446,723,618,12790,9162,572,749,400,698,581,12162
2020-02-19,경남,전남,5787,261,473,511,1430,244,8706,5826,282,435,449,1348,235,8575
2020-02-19,경남,전북,1266,40,135,93,153,33,1720,1236,41,138,102,159,46,1722
2020-02-19,경남,충남,990,52,126,275,218,27,1688,1474,60,168,339,461,49,2551
2020-02-19,경남,충북,902,48,129,278,280,19,1656,1304,64,191,495,591,37,2682
2020-02-19,경북,강원,426,10,26,31,35,11,539,412,21,36,15,31,13,528
2020-02-19,경북,경기,3687,208,481,873,569,131,5949,3595,194,478,724,608,117,5716
2020-02-19,경북,경남,12453,866,1151,1248,2620,530,18868,9530,606,957,997,1905,418,14413
2020-02-19,경북,경북,70508,3879,4259,2816,4813,3785,90060,70508,3879,4259,2816,4813,3785,90060
2020-02-19,경북,광주,738,58,123,160,136,18,1233,688,53,106,163,71,15,1096
2020-02-19,경북,대구,68162,2878,2861,1551,3116,3743,82311,72235,3083,3238,1905,3580,3799,87840
2020-02-19,경북,대전,1676,57,133,116,90,60,2132,1691,56,122,135,68,63,2135
2020-02-19,경북,부산,4015,109,301,200,650,196,5471,4263,123,326,215,731,196,5854
2020-02-19,경북,서울,2364,96,335,384,161,61,3401,2537,84,300,222,115,73,3331
2020-02-19,경북,세종,304,6,12,19,16,11,368,273,12,14,22,8,12,341
2020-02-19,경북,울산,4949,183,343,399,1100,297,7271,4867,171,354,337,1332,263,7324
2020-02-19,경북,전남,874,36,81,119,457,27,1594,788,38,76,77,338,24,1341
2020-02-19,경북,전북,1771,79,172,203,263,56,2544,1623,92,166,162,454,43,2540
2020-02-19,경북,충남,2974,147,359,541,601,100,4722,3094,140,340,481,750,105,4910
2020-02-19,경북,충북,4829,243,491,685,1015,177,7440,4834,235,545,663,1060,182,7519
2020-02-19,광주,강원,67,1,11,18,8,3,108,63,2,19,11,12,0,107
2020-02-19,광주,경기,615,30,159,246,109,15,1174,759,33,182,321,164,19,1478
2020-02-19,광주,경남,978,52,157,145,102,25,1459,993,58,134,185,139,25,1534
2020-02-19,광주,경북,688,53,106,163,71,15,1096,738,58,123,160,136,18,1233
2020-02-19,광주,광주,12615,438,640,343,242,547,14825,12615,438,640,343,242,547,14825
2020-02-19,광주,대구,492,29,89,83,27,8,728,572,33,105,86,32,11,839
2020-02-19,광주,대전,445,19,13,17,20,22,536,471,25,19,26,15,17,573
2020-02-19,광주,부산,401,16,35,33,86,10,581,426,20,50,57,111,7,671
2020-02-19,광주,서울,516,17,28,66,26,17,670,696,18,25,55,21,14,829
2020-02-19,광주,세종,143,3,9,2,2,7,166,167,4,7,2,1,6,187
2020-02-19,광주,울산,40,0,7,1,2,1,51,45,0,8,5,6,0,64
2020-02-19,광주,전남,32684,939,1168,713,1899,1326,38729,31568,924,1011,627,1860,1274,37264
2020-02-19,광주,전북,7686,435,575,350,360,283,9689,7842,448,465,334,391,303,9783
2020-02-19,광주,충남,3475,126,515,511,245,103,4975,3591,150,538,590,336,91,5296
2020-02-19,광주,충북,552,23,79,93,62,14,823,580,28,108,167,93,13,989
2020-02-19,대구,강원,266,10,22,20,11,3,332,176,2,13,6,6,7,210
2020-02-19,대구,경기,2660,124,229,458,442,73,3986,1836,89,209,371,235,39,2779
2020-02-19,대구,경남,10175,507,742,415,486,433,12758,12397,750,968,981,1514,523,17133
2020-02-19,대구,경북,72235,3083,3238,1905,3580,3799,87840,68162,2878,2861,1551,3116,3743,82311
2020-02-19,대구,광주,572,33,105,86,32,11,839,492,29,89,83,27,8,728
2020-02-19,대구,대구,57148,2214,1852,869,1005,3861,66949,57148,2214,1852,869,1005,3861,66949
2020-02-19,대구,대전,906,33,54,74,30,41,1138,611,23,31,54,17,22,758
2020-02-19,대구,부산,589,63,116,59,127,16,970,2633,104,240,92,224,105,3398
2020-02-19,대구,서울,2330,83,181,220,85,79,2978,1494,61,134,120,47,42,1898
2020-02-19,대구,세종,242,3,12,6,14,15,292,131,3,7,3,15,4,163
2020-02-19,대구,울산,1212,50,137,77,166,38,1680,1157,44,133,69,196,52,1651
2020-02-19,대구,전남,507,12,45,23,40,10,637,430,18,44,34,65,9,600
2020-02-19,대구,전북,360,13,37,23,20,9,462,341,12,34,38,30,5,460
2020-02-19,대구,충남,1449,81,133,201,233,47,2144,1017,63,117,167,164,23,1551
2020-02-19,대구,충북,1607,81,199,250,366,50,2553,1203,81,138,222,143,30,1817
2020-02-19,대전,강원,158,3,29,2,2,6,200,135,3,31,6,0,5,180
2020-02-19,대전,경기,1873,111,192,96,49,92,2413,1876,107,208,116,49,85,2441
2020-02-19,대전,경남,928,21,108,118,67,47,1289,668,16,103,85,37,37,946
2020-02-19,대전,경북,1691,56,122,135,68,63,2135,1676,57,133,116,90,60,2132
2020-02-19,대전,광주,471,25,19,26,15,17,573,445,19,13,17,20,22,536
2020-02-19,대전,대구,611,23,31,54,17,22,758,906,33,54,74,30,41,1138
2020-02-19,대전,대전,13639,363,429,198,165,1022,15816,13639,363,429,198,165,1022,15816
2020-02-19,대전,부산,63,6,11,16,19,2,117,60,3,8,19,17,4,111
2020-02-19,대전,서울,1629,38,192,40,15,68,1982,1653,40,190,28,12,68,1991
2020-02-19,대전,세종,3435,109,92,45,27,303,4011,3387,105,89,49,32,292,3954
2020-02-19,대전,울산,82,5,10,25,30,3,155,99,5,12,11,24,2,153
2020-02-19,대전,전남,234,5,8,24,23,8,302,98,3,6,9,5,1,122
2020-02-19,대전,전북,3288,75,85,70,40,142,3700,3408,86,103,86,51,145,3879
2020-02-19,대전,충남,16027,477,521,241,217,1197,18680,14512,468,471,246,218,1117,17032
2020-02-19,대전,충북,10673,461,436,208,157,793,12728,9837,410,405,176,161,769,11758
2020-02-19,부산,강원,3,0,0,0,2,1,6,4,0,0,2,3,0,9
2020-02-19,부산,경기,219,22,32,143,246,8,670,203,22,43,212,144,5,629
2020-02-19,부산,경남,86371,2763,3120,1868,4857,6213,105192,87539,2637,2952,1838,4571,6263,105800
2020-02-19,부산,경북,4263,123,326,215,731,196,5854,4015,109,301,200,650,196,5471
2020-02-19,부산,광주,426,20,50,57,111,7,671,401,16,35,33,86,10,581
2020-02-19,부산,대구,2633,104,240,92,224,105,3398,589,63,116,59,127,16,970
2020-02-19,부산,대전,60,3,8,19,17,4,111,63,6,11,16,19,2,117
2020-02-19,부산,부산,44094,715,662,609,2090,3272,51442,44094,715,662,609,2090,3272,51442
2020-02-19,부산,서울,185,13,11,69,64,7,349,153,13,24,78,35,5,308
2020-02-19,부산,세종,11,0,2,3,4,0,20,20,1,3,1,1,0,26
2020-02-19,부산,울산,16453,365,454,639,2696,1134,21741,16609,392,392,401,2537,1194,21525
2020-02-19,부산,전남,1792,81,150,191,615,70,2899,1660,57,133,154,611,60,2675
2020-02-19,부산,전북,264,11,35,37,85,9,441,253,8,32,43,69,7,412
2020-02-19,부산,충남,145,13,28,81,137,5,409,103,15,26,82,174,3,403
2020-02-19,부산,충북,103,4,21,78,200,2,408,91,12,30,110,171,2,416
2020-02-19,서울,강원,646,14,197,15,10,24,906,549,10,242,7,22,23,853
2020-02-19,서울,경기,145712,7018,8886,4448,3272,9894,179230,147406,7517,8849,4685,3658,10040,182155
2020-02-19,서울,경남,2219,58,448,188,115,61,3089,1584,26,424,289,133,42,2498
2020-02-19,서울,경북,2537,84,300,222,115,73,3331,2364,96,335,384,161,61,3401
2020-02-19,서울,광주,696,18,25,55,21,14,829,516,17,28,66,26,17,670
2020-02-19,서울,대구,1494,61,134,120,47,42,1898,2330,83,181,220,85,79,2978
2020-02-19,서울,대전,1653,40,190,28,12,68,1991,1629,38,192,40,15,68,1982
2020-02-19,서울,부산,153,13,24,78,35,5,308,185,13,11,69,64,7,349
2020-02-19,서울,서울,215,12,10,3,3,6,249,215,12,10,3,3,6,249
2020-02-19,서울,세종,26,0,1,2,0,1,30,33,0,0,1,0,0,34
2020-02-19,서울,울산,28,0,3,3,2,0,36,21,1,7,7,18,1,55
2020-02-19,서울,전남,816,8,24,53,46,24,971,617,10,30,59,42,23,781
2020-02-19,서울,전북,1288,33,53,19,25,48,1466,1164,25,54,45,47,39,1374
2020-02-19,서울,충남,23481,521,2200,784,662,980,28628,23560,613,2217,1236,1135,880,29641
2020-02-19,서울,충북,12685,513,1093,731,688,514,16224,12461,655,1140,790,826,494,16366
2020-02-19,세종,강원,12,1,0,1,1,0,15,5,0,1,0,0,1,7
2020-02-19,세종,경기,56,5,5,6,1,2,75,36,2,2,5,2,0,47
2020-02-19,세종,경남,262,2,24,15,16,4,323,165,2,14,9,1,5,196
2020-02-19,세종,경북,273,12,14,22,8,12,341,304,6,12,19,16,11,368
2020-02-19,세종,광주,167,4,7,2,1,6,187,143,3,9,2,2,7,166
2020-02-19,세종,대구,131,3,7,3,15,4,163,242,3,12,6,14,15,292
2020-02-19,세종,대전,3387,105,89,49,32,292,3954,3435,109,92,45,27,303,4011
2020-02-19,세종,부산,20,1,3,1,1,0,26,11,0,2,3,4,0,20
2020-02-19,세종,서울,33,0,0,1,0,0,34,26,0,1,2,0,1,30
2020-02-19,세종,세종,250,22,3,0,1,25,301,250,22,3,0,1,25,301
2020-02-19,세종,울산,8,0,1,3,6,0,18,6,0,1,1,5,1,14
2020-02-19,세종,전남,127,2,6,11,10,7,163,104,1,2,4,9,6,126
2020-02-19,세종,전북,647,17,17,16,40,23,760,672,12,25,12,51,24,796
2020-02-19,세종,충남,5745,152,151,99,180,324,6651,4331,143,149,94,159,207,5083
2020-02-19,세종,충북,356,20,14,20,17,20,447,295,18,14,11,18,29,385
2020-02-19,울산,강원,1,0,0,0,0,0,1,3,0,1,0,0,0,4
2020-02-19,울산,경기,48,4,5,31,73,0,161,46,2,1,20,19,1,89
2020-02-19,울산,경남,9162,572,749,400,698,581,12162,9639,640,724,446,723,618,12790
2020-02-19,울산,경북,4867,171,354,337,1332,263,7324,4949,183,343,399,1100,297,7271
2020-02-19,울산,광주,45,0,8,5,6,0,64,40,0,7,1,2,1,51
2020-02-19,울산,대구,1157,44,133,69,196,52,1651,1212,50,137,77,166,38,1680
2020-02-19,울산,대전,99,5,12,11,24,2,153,82,5,10,25,30,3,155
2020-02-19,울산,부산,16609,392,392,401,2537,1194,21525,16453,365,454,639,2696,1134,21741
2020-02-19,울산,서울,21,1,7,7,18,1,55,28,0,3,3,2,0,36
2020-02-19,울산,세종,6,0,1,1,5,1,14,8,0,1,3,6,0,18
2020-02-19,울산,울산,8133,296,537,273,621,765,10625,8133,296,537,273,621,765,10625
2020-02-19,울산,전남,177,17,16,23,32,8,273,169,13,14,13,40,5,254
2020-02-19,울산,전북,30,0,7,2,14,3,56,37,0,6,4,4,1,52
2020-02-19,울산,충남,117,2,13,41,154,2,329,127,6,9,40,109,2,293
2020-02-19,울산,충북,20,4,5,23,48,1,101,18,2,0,13,35,0,68
2020-02-19,전남,강원,17,0,3,4,3,0,27,38,1,1,3,9,1,53
2020-02-19,전남,경기,554,19,81,112,84,18,868,632,19,113,168,155,22,1109
2020-02-19,전남,경남,5826,282,435,449,1348,235,8575,5787,261,473,511,1430,244,8706
2020-02-19,전남,경북,788,38,76,77,338,24,1341,874,36,81,119,457,27,1594
2020-02-19,전남,광주,31568,924,1011,627,1860,1274,37264,32684,939,1168,713,1899,1326,38729
2020-02-19,전남,대구,430,18,44,34,65,9,600,507,12,45,23,40,10,637
2020-02-19,전남,대전,98,3,6,9,5,1,122,234,5,8,24,23,8,302
2020-02-19,전남,부산,1660,57,133,154,611,60,2675,1792,81,150,191,615,70,2899
2020-02-19,전남,서울,617,10,30,59,42,23,781,816,8,24,53,46,24,971
2020-02-19,전남,세종,104,1,2,4,9,6,126,127,2,6,11,10,7,163
2020-02-19,전남,울산,169,13,14,13,40,5,254,177,17,16,23,32,8,273
2020-02-19,전남,전남,44208,1435,1701,1842,4524,1922,55632,44208,1435,1701,1842,4524,1922,55632
2020-02-19,전남,전북,6682,315,732,867,2709,190,11495,4577,206,479,573,1241,126,7202
2020-02-19,전남,충남,1636,61,222,468,268,41,2696,3749,107,471,541,1137,103,6108
2020-02-19,전남,충북,150,11,14,35,79,1,290,336,17,52,103,259,5,772
2020-02-19,전북,강원,173,7,13,18,26,3,240,107,4,16,8,10,2,147
2020-02-19,전북,경기,1354,42,172,179,247,39,2033,1303,49,160,125,178,32,1847
2020-02-19,전북,경남,1236,41,138,102,159,46,1722,1266,40,135,93,153,33,1720
2020-02-19,전북,경북,1623,92,166,162,454,43,2540,1771,79,172,203,263,56,2544
2020-02-19,전북,광주,7842,448,465,334,391,303,9783,7686,435,575,350,360,283,9689
2020-02-19,전북,대구,341,12,34,38,30,5,460,360,13,37,23,20,9,462
2020-02-19,전북,대전,3408,86,103,86,51,145,3879,3288,75,85,70,40,142,3700
2020-02-19,전북,부산,253,8,32,43,69,7,412,264,11,35,37,85,9,441
2020-02-19,전북,서울,1164,25,54,45,47,39,1374,1288,33,53,19,25,48,1466
2020-02-19,전북,세종,672,12,25,12,51,24,796,647,17,17,16,40,23,760
2020-02-19,전북,울산,37,0,6,4,4,1,52,30,0,7,2,14,3,56
2020-02-19,전북,전남,4577,206,479,573,1241,126,7202,6682,315,732,867,2709,190,11495
2020-02-19,전북,전북,16573,592,880,679,1080,630,20434,16573,592,880,679,1080,630,20434
2020-02-19,전북,충남,14263,562,1680,1341,2325,427,20598,12523,480,1443,921,1429,424,17220
2020-02-19,전북,충북,1990,122,194,326,451,60,3143,1835,133,201,293,262,50,2774
2020-02-19,충남,강원,405,8,18,43,73,11,558,308,10,20,26,50,13,427
2020-02-19,충남,경기,34750,1432,2745,2276,4055,1644,46902,35464,1487,2793,2362,4364,1752,48222
2020-02-19,충남,경남,1474,60,168,339,461,49,2551,990,52,126,275,218,27,1688
2020-02-19,충남,경북,3094,140,340,481,750,105,4910,2974,147,359,541,601,100,4722
2020-02-19,충남,광주,3591,150,538,590,336,91,5296,3475,126,515,511,245,103,4975
2020-02-19,충남,대구,1017,63,117,167,164,23,1551,1449,81,133,201,233,47,2144
2020-02-19,충남,대전,14512,468,471,246,218,1117,17032,16027,477,521,241,217,1197,18680
2020-02-19,충남,부산,103,15,26,82,174,3,403,145,13,28,81,137,5,409
2020-02-19,충남,서울,23560,613,2217,1236,1135,880,29641,23481,521,2200,784,662,980,28628
2020-02-19,충남,세종,4331,143,149,94,159,207,5083,5745,152,151,99,180,324,6651
2020-02-19,충남,울산,127,6,9,40,109,2,293,117,2,13,41,154,2,329
2020-02-19,충남,전남,3749,107,471,541,1137,103,6108,1636,61,222,468,268,41,2696
2020-02-19,충남,전북,12523,480,1443,921,1429,424,17220,14263,562,1680,1341,2325,427,20598
2020-02-19,충남,충남,92179,3526,7728,7050,9984,4453,124920,92179,3526,7728,7050,9984,4453,124920
2020-02-19,충남,충북,13635,644,873,1008,1285,777,18222,12227,618,917,862,1360,698,16682
2020-02-19,충북,강원,4632,195,314,204,318,260,5923,4587,239,318,243,330,256,5973
2020-02-19,충북,경기,25803,2168,2863,2750,3461,1232,38277,26176,2238,2918,3110,3225,1260,38927
2020-02-19,충북,경남,1304,64,191,495,591,37,2682,902,48,129,278,280,19,1656
2020-02-19,충북,경북,4834,235,545,663,1060,182,7519,4829,243,491,685,1015,177,7440
2020-02-19,충북,광주,580,28,108,167,93,13,989,552,23,79,93,62,14,823
2020-02-19,충북,대구,1203,81,138,222,143,30,1817,1607,81,199,250,366,50,2553
2020-02-19,충북,대전,9837,410,405,176,161,769,11758,10673,461,436,208,157,793,12728
2020-02-19,충북,부산,91,12,30,110,171,2,416,103,4,21,78,200,2,408
2020-02-19,충북,서울,12461,655,1140,790,826,494,16366,12685,513,1093,731,688,514,16224
2020-02-19,충북,세종,295,18,14,11,18,29,385,356,20,14,20,17,20,447
2020-02-19,충북,울산,18,2,0,13,35,0,68,20,4,5,23,48,1,101
2020-02-19,충북,전남,336,17,52,103,259,5,772,150,11,14,35,79,1,290
2020-02-19,충북,전북,1835,133,201,293,262,50,2774,1990,122,194,326,451,60,3143
2020-02-19,충북,충남,12227,618,917,862,1360,698,16682,13635,644,873,1008,1285,777,18222
2020-02-19,충북,충북,36402,2038,2293,1994,3027,2091,47845,36402,2038,2293,1994,3027,2091,47845
2020-02-20,강원,강원,65332,2266,3031,1330,2413,4379,78751,65332,2266,3031,1330,2413,4379,78751
2020-02-20,강원,경기,18723,585,1209,649,764,894,22824,20630,649,1169,676,888,971,24983
2020-02-20,강원,경남,142,5,18,8,24,3,200,94,0,6,22,12,1,135
2020-02-20,강원,경북,406,20,33,18,28,13,518,444,13,26,28,35,17,563
2020-02-20,강원,광주,77,2,18,5,6,3,111,85,2,15,8,9,1,120
2020-02-20,강원,대구,171,3,14,7,10,1,206,272,2,20,26,12,13,345
2020-02-20,강원,대전,173,4,26,2,3,4,212,191,6,27,4,1,7,236
2020-02-20,강원,부산,4,0,0,0,1,0,5,4,0,1,2,1,1,9
2020-02-20,강원,서울,718,12,238,12,11,26,1017,789,13,194,16,8,32,1052
2020-02-20,강원,세종,7,0,0,0,1,0,8,8,0,0,0,3,0,11
2020-02-20,강원,울산,0,0,0,0,0,0,0,0,0,0,1,1,0,2
2020-02-20,강원,전남,44,1,1,0,12,3,61,35,1,4,3,6,1,50
2020-02-20,강원,전북,159,1,7,14,17,3,201,187,9,12,16,33,7,264
2020-02-20,강원,충남,310,6,14,22,43,13,408,456,12,19,33,60,11,591
2020-02-20,강원,충북,4749,227,325,247,352,250,6150,4936,194,308,233,321,278,6270
2020-02-20,경기,강원,20630,649,1169,676,888,971,24983,18723,585,1209,649,764,894,22824
2020-02-20,경기,경기,428283,23185,24668,19322,23802,32323,551583,428283,23185,24668,19322,23802,32323,551583
2020-02-20,경기,경남,2604,100,344,771,571,69,4459,1965,66,270,530,385,54,3270
2020-02-20,경기,경북,3656,172,542,736,622,101,5829,3730,204,466,928,604,111,6043
2020-02-20,경기,광주,765,40,165,279,152,17,1418,703,34,138,248,110,17,1250
2020-02-20,경기,대구,1745,108,217,394,235,54,2753,2659,123,209,487,381,72,3931
2020-02-20,경기,대전,1945,89,203,112,52,76,2477,2057,110,192,92,47,79,2577
2020-02-20,경기,부산,233,26,56,213,178,3,709,242,27,35,161,258,13,736
2020-02-20,경기,서울,146816,7261,8649,4591,3585,9791,180693,145455,6908,8798,4393,3131,9757,178442
2020-02-20,경기,세종,38,2,5,5,4,0,54,60,6,3,3,3,1,76
2020-02-20,경기,울산,33,3,4,10,15,2,67,40,2,2,42,70,1,157
2020-02-20,경기,전남,725,18,120,163,156,28,1210,667,15,89,155,83,24,1033
2020-02-20,경기,전북,1245,56,173,115,175,31,1795,1431,55,170,185,231,38,2110
2020-02-20,경기,충남,37207,1518,2771,2375,4418,1840,50129,37315,1453,2707,2254,4214,1825,49768
2020-02-20,경기,충북,27074,2174,2931,3174,3269,1323,39945,26996,2092,2896,2774,3482,1228,39468
2020-02-20,경남,강원,94,0,6,22,12,1,135,142,5,18,8,24,3,200
2020-02-20,경남,경기,1965,66,270,530,385,54,3270,2604,100,344,771,571,69,4459
2020-02-20,경남,경남,194231,10217,10313,7403,13760,14785,250709,194231,10217,10313,7403,13760,14785,250709
2020-02-20,경남,경북,9018,614,1067,903,1920,413,13935,12077,833,1195,1204,2553,537,18399
2020-02-20,경남,광주,1132,53,155,172,121,24,1657,1093,48,143,142,95,21,1542
2020-02-20,경남,대구,11760,737,944,1049,1566,419,16475,9538,494,715,379,476,406,12008
2020-02-20,경남,대전,837,22,103,74,43,34,1113,1093,20,111,112,66,48,1450
2020-02-20,경남,부산,88331,2735,3012,1849,4594,6242,106763,86562,2799,3056,1875,4901,6083,105276
2020-02-20,경남,서울,1872,50,441,271,142,44,2820,2353,58,445,210,128,59,3253
2020-02-20,경남,세종,185,5,7,9,8,7,221,244,8,19,7,19,13,310
2020-02-20,경남,울산,9791,583,641,452,689,584,12740,9446,552,713,414,672,542,12339
2020-02-20,경남,전남,5796,247,477,517,1446,250,8733,6000,294,492,437,1323,246,8792
2020-02-20,경남,전북,1281,49,143,109,178,51,1811,1249,45,141,111,168,42,1756
2020-02-20,경남,충남,1102,56,151,262,219,36,1826,1727,58,167,334,553,52,2891
2020-02-20,경남,충북,1069,44,130,286,288,32,1849,1424,84,200,493,640,36,2877
2020-02-20,경북,강원,444,13,26,28,35,17,563,406,20,33,18,28,13,518
2020-02-20,경북,경기,3730,204,466,928,604,111,6043,3656,172,542,736,622,101,5829
2020-02-20,경북,경남,12077,833,1195,1204,2553,537,18399,9018,614,1067,903,1920,413,13935
2020-02-20,경북,경북,67087,3866,4139,2867,4651,3613,86223,67087,3866,4139,2867,4651,3613,86223
2020-02-20,경북,광주,847,52,128,178,115,24,1344,688,40,87,193,76,25,1109
2020-02-20,경북,대구,63491,2890,2773,1631,3176,3480,77441,68158,3126,3253,1979,3622,3670,83808
2020-02-20,경북,대전,1719,53,129,114,62,53,2130,1619,65,109,117,74,63,2047
2020-02-20,경북,부산,3939,136,306,173,707,178,5439,4082,127,327,211,791,179,5717
2020-02-20,경북,서울,2468,120,315,419,151,84,3557,2534,100,308,244,116,81,3383
2020-02-20,경북,세종,277,6,23,21,18,7,352,286,7,17,17,10,11,348
2020-02-20,경북,울산,4839,153,345,426,1091,265,7119,4715,173,335,332,1282,266,7103
2020-02-20,경북,전남,986,59,66,132,452,27,1722,789,26,63,86,311,20,1295
2020-02-20,경북,전북,1755,84,186,177,249,55,2506,1543,95,192,169,471,62,2532
2020-02-20,경북,충남,3094,149,380,554,640,108,4925,3186,149,355,500,772,114,5076
2020-02-20,경북,충북,4804,235,491,689,1045,152,7416,4488,237,508,684,1079,160,7156
2020-02-20,광주,강원,85,2,15,8,9,1,120,77,2,18,5,6,3,111
2020-02-20,광주,경기,703,34,138,248,110,17,1250,765,40,165,279,152,17,1418
2020-02-20,광주,경남,1093,48,143,142,95,21,1542,1132,53,155,172,121,24,1657
2020-02-20,광주,경북,688,40,87,193,76,25,1109,847,52,128,178,115,24,1344
2020-02-20,광주,광주,13446,512,663,364,272,536,15793,13446,512,663,364,272,536,15793
2020-02-20,광주,대구,491,30,95,78,31,8,733,613,30,106,65,26,18,858
2020-02-20,광주,대전,435,22,14,15,11,22,519,448,20,13,23,16,11,531
2020-02-20,광주,부산,403,17,47,40,69,9,585,452,20,48,59,102,12,693
2020-02-20,광주,서울,627,18,19,77,30,13,784,747,25,17,51,22,25,887
2020-02-20,광주,세종,135,1,7,4,2,2,151,166,2,7,3,1,3,182
2020-02-20,광주,울산,49,2,7,4,0,1,63,40,1,6,8,8,0,63
2020-02-20,광주,전남,33715,1008,1217,740,1845,1353,39878,32173,969,1053,691,1786,1286,37958
2020-02-20,광주,전북,7937,439,526,345,399,305,9951,8067,467,489,335,378,310,10046
2020-02-20,광주,충남,3941,106,523,454,245,104,5373,3983,128,534,561,334,100,5640
2020-02-20,광주,충북,538,23,68,86,65,10,790,600,34,111,177,87,11,1020
2020-02-20,대구,강원,272,2,20,26,12,13,345,171,3,14,7,10,1,206
2020-02-20,대구,경기,2659,123,209,487,381,72,3931,1745,108,217,394,235,54,2753
2020-02-20,대구,경남,9538,494,715,379,476,406,12008,11760,737,944,1049,1566,419,16475
2020-02-20,대구,경북,68158,3126,3253,1979,3622,3670,83808,63491,2890,2773,1631,3176,3480,77441
2020-02-20,대구,광주,613,30,106,65,26,18,858,491,30,95,78,31,8,733
2020-02-20,대구,대구,54019,2154,1776,856,1164,3522,63491,54019,2154,1776,856,1164,3522,63491
2020-02-20,대구,대전,875,42,51,78,38,38,1122,561,28,40,51,18,17,715
2020-02-20,대구,부산,560,46,108,68,158,14,954,2520,109,227,101,204,110,3271
2020-02-20,대구,서울,2444,88,188,221,100,66,3107,1459,65,142,119,50,40,1875
2020-02-20,대구,세종,242,9,11,9,11,9,291,155,3,3,3,2,5,171
2020-02-20,대구,울산,1168,49,133,84,151,53,1638,1081,41,135,83,192,41,1573
2020-02-20,대구,전남,491,8,46,26,39,10,620,438,15,44,38,55,14,604
2020-02-20,대구,전북,368,15,47,26,18,8,482,335,9,43,24,27,12,450
2020-02-20,대구,충남,1463,73,143,201,254,42,2176,1058,56,101,164,160,39,1578
2020-02-20,대구,충북,1649,120,220,252,386,65,2692,1078,94,152,215,148,30,1717
2020-02-20,대전,강원,191,6,27,4,1,7,236,173,4,26,2,3,4,212
2020-02-20,대전,경기,2057,110,192,92,47,79,2577,1945,89,203,112,52,76,2477
2020-02-20,대전,경남,1093,20,111,112,66,48,1450,837,22,103,74,43,34,1113
2020-02-20,대전,경북,1619,65,109,117,74,63,2047,1719,53,129,114,62,53,2130
2020-02-20,대전,광주,448,20,13,23,16,11,531,435,22,14,15,11,22,519
2020-02-20,대전,대구,561,28,40,51,18,17,715,875,42,51,78,38,38,1122
2020-02-20,대전,대전,13659,369,403,308,167,1063,15969,13659,369,403,308,167,1063,15969
2020-02-20,대전,부산,65,3,8,13,16,1,106,79,6,13,14,18,0,130
2020-02-20,대전,서울,1694,36,183,28,4,82,2027,1752,41,186,35,10,79,2103
2020-02-20,대전,세종,3448,136,76,47,32,294,4033,3426,122,83,42,38,276,3987
2020-02-20,대전,울산,87,2,11,19,25,3,147,97,1,13,8,22,2,143
2020-02-20,대전,전남,269,5,7,26,23,12,342,124,6,7,10,7,2,156
2020-02-20,대전,전북,3292,79,93,73,56,149,3742,3354,84,85,77,57,146,3803
2020-02-20,대전,충남,16134,456,497,245,308,1210,18850,14630,444,479,224,275,1107,17159
2020-02-20,대전,충북,11086,432,431,184,163,831,13127,9993,376,416,164,161,770,11880
2020-02-20,부산,강원,4,0,1,2,1,1,9,4,0,0,0,1,0,5
2020-02-20,부산,경기,242,27,35,161,258,13,736,233,26,56,213,178,3,709
2020-02-20,부산,경남,86562,2799,3056,1875,4901,6083,105276,88331,2735,3012,1849,4594,6242,106763
2020-02-20,부산,경북,4082,127,327,211,791,179,5717,3939,136,306,173,707,178,5439
2020-02-20,부산,광주,452,20,48,59,102,12,693,403,17,47,40,69,9,585
2020-02-20,부산,대구,2520,109,227,101,204,110,3271,560,46,108,68,158,14,954
2020-02-20,부산,대전,79,6,13,14,18,0,130,65,3,8,13,16,1,106
2020-02-20,부산,부산,44314,754,624,735,2352,3192,51971,44314,754,624,735,2352,3192,51971
2020-02-20,부산,서울,198,22,23,84,58,3,388,167,17,22,77,46,5,334
2020-02-20,부산,세종,14,1,2,2,6,1,26,10,1,0,1,4,0,16
2020-02-20,부산,울산,16455,391,521,665,2742,1167,21941,16554,383,424,387,2632,1123,21503
2020-02-20,부산,전남,1875,78,137,207,622,69,2988,1774,70,103,166,641,60,2814
2020-02-20,부산,전북,330,11,25,42,88,9,505,289,8,24,45,81,8,455
2020-02-20,부산,충남,152,12,22,85,166,4,441,147,16,27,76,192,5,463
2020-02-20,부산,충북,110,17,28,124,213,1,493,110,12,22,108,183,3,438
2020-02-20,서울,강원,789,13,194,16,8,32,1052,718,12,238,12,11,26,1017
2020-02-20,서울,경기,145455,6908,8798,4393,3131,9757,178442,146816,7261,8649,4591,3585,9791,180693
2020-02-20,서울,경남,2353,58,445,210,128,59,3253,1872,50,441,271,142,44,2820
2020-02-20,서울,경북,2534,100,308,244,116,81,3383,2468,120,315,419,151,84,3557
2020-02-20,서울,광주,747,25,17,51,22,25,887,627,18,19,77,30,13,784
2020-02-20,서울,대구,1459,65,142,119,50,40,1875,2444,88,188,221,100,66,3107
2020-02-20,서울,대전,1752,41,186,35,10,79,2103,1694,36,183,28,4,82,2027
2020-02-20,서울,부산,167,17,22,77,46,5,334,198,22,23,84,58,3,388
2020-02-20,서울,서울,183,3,8,3,4,8,209,183,3,8,3,4,8,209
2020-02-20,서울,세종,41,1,0,0,0,0,42,38,5,0,0,0,4,47
2020-02-20,서울,울산,30,1,3,2,3,1,40,31,0,4,9,15,0,59
2020-02-20,서울,전남,811,10,29,50,51,23,974,716,10,24,81,62,24,917
2020-02-20,서울,전북,1320,18,40,18,26,40,1462,1272,38,44,31,43,41,1469
2020-02-20,서울,충남,24326,531,2235,801,714,995,29602,24675,621,2199,1278,1144,984,30901
2020-02-20,서울,충북,13290,532,1127,761,722,559,16991,13296,672,1158,773,812,549,17260
2020-02-20,세종,강원,8,0,0,0,3,0,11,7,0,0,0,1,0,8
2020-02-20,세종,경기,60,6,3,3,3,1,76,38,2,5,5,4,0,54
2020-02-20,세종,경남,244,8,19,7,19,13,310,185,5,7,9,8,7,221
2020-02-20,세종,경북,286,7,17,17,10,11,348,277,6,23,21,18,7,352
2020-02-20,세종,광주,166,2,7,3,1,3,182,135,1,7,4,2,2,151
2020-02-20,세종,대구,155,3,3,3,2,5,171,242,9,11,9,11,9,291
2020-02-20,세종,대전,3426,122,83,42,38,276,3987,3448,136,76,47,32,294,4033
2020-02-20,세종,부산,10,1,0,1,4,0,16,14,1,2,2,6,1,26
2020-02-20,세종,서울,38,5,0,0,0,4,47,41,1,0,0,0,0,42
2020-02-20,세종,세종,261,26,2,4,0,22,315,261,26,2,4,0,22,315
2020-02-20,세종,울산,5,0,0,0,3,0,8,4,1,0,2,1,0,8
2020-02-20,세종,전남,160,3,7,7,15,2,194,106,1,3,5,7,3,125
2020-02-20,세종,전북,694,18,27,16,41,24,820,715,13,23,17,56,28,852
2020-02-20,세종,충남,5985,176,164,115,142,311,6893,4415,149,158,114,145,225,5206
2020-02-20,세종,충북,388,15,20,19,16,29,487,308,18,23,18,13,24,404
2020-02-20,울산,강원,0,0,0,1,1,0,2,0,0,0,0,0,0,0
2020-02-20,울산,경기,40,2,2,42,70,1,157,33,3,4,10,15,2,67
2020-02-20,울산,경남,9446,552,713,414,672,542,12339,9791,583,641,452,689,584,12740
2020-02-20,울산,경북,4715,173,335,332,1282,266,7103,4839,153,345,426,1091,265,7119
2020-02-20,울산,광주,40,1,6,8,8,0,63,49,2,7,4,0,1,63
2020-02-20,울산,대구,1081,41,135,83,192,41,1573,1168,49,133,84,151,53,1638
2020-02-20,울산,대전,97,1,13,8,22,2,143,87,2,11,19,25,3,147
2020-02-20,울산,부산,16554,383,424,387,2632,1123,21503,16455,391,521,665,2742,1167,21941
2020-02-20,울산,서울,31,0,4,9,15,0,59,30,1,3,2,3,1,40
2020-02-20,울산,세종,4,1,0,2,1,0,8,5,0,0,0,3,0,8
2020-02-20,울산,울산,8113,328,524,299,594,744,10602,8113,328,524,299,594,744,10602
2020-02-20,울산,전남,176,15,17,12,31,6,257,187,16,23,17,31,11,285
2020-02-20,울산,전북,44,0,8,1,15,1,69,50,3,8,2,10,2,75
2020-02-20,울산,충남,117,4,24,44,114,2,305,142,5,13,43,128,1,332
2020-02-20,울산,충북,22,2,7,17,49,0,97,22,0,5,10,40,1,78
2020-02-20,전남,강원,35,1,4,3,6,1,50,44,1,1,0,12,3,61
2020-02-20,전남,경기,667,15,89,155,83,24,1033,725,18,120,163,156,28,1210
2020-02-20,전남,경남,6000,294,492,437,1323,246,8792,5796,247,477,517,1446,250,8733
2020-02-20,전남,경북,789,26,63,86,311,20,1295,986,59,66,132,452,27,1722
2020-02-20,전남,광주,32173,969,1053,691,1786,1286,37958,33715,1008,1217,740,1845,1353,39878
2020-02-20,전남,대구,438,15,44,38,55,14,604,491,8,46,26,39,10,620
2020-02-20,전남,대전,124,6,7,10,7,2,156,269,5,7,26,23,12,342
2020-02-20,전남,부산,1774,70,103,166,641,60,2814,1875,78,137,207,622,69,2988
2020-02-20,전남,서울,716,10,24,81,62,24,917,811,10,29,50,51,23,974
2020-02-20,전남,세종,106,1,3,5,7,3,125,160,3,7,7,15,2,194
2020-02-20,전남,울산,187,16,23,17,31,11,285,176,15,17,12,31,6,257
2020-02-20,전남,전남,45284,1306,1717,2021,4758,1858,56944,45284,1306,1717,2021,4758,1858,56944
2020-02-20,전남,전북,7062,322,714,883,2839,184,12004,4543,253,494,592,1328,140,7350
2020-02-20,전남,충남,1809,53,235,480,291,49,2917,4102,98,470,559,1107,111,6447
2020-02-20,전남,충북,147,13,13,34,81,1,289,380,20,42,91,285,12,830
2020-02-20,전북,강원,187,9,12,16,33,7,264,159,1,7,14,17,3,201
2020-02-20,전북,경기,1431,55,170,185,231,38,2110,1245,56,173,115,175,31,1795
2020-02-20,전북,경남,1249,45,141,111,168,42,1756,1281,49,143,109,178,51,1811
2020-02-20,전북,경북,1543,95,192,169,471,62,2532,1755,84,186,177,249,55,2506
2020-02-20,전북,광주,8067,467,489,335,378,310,10046,7937,439,526,345,399,305,9951
2020-02-20,전북,대구,335,9,43,24,27,12,450,368,15,47,26,18,8,482
2020-02-20,전북,대전,3354,84,85,77,57,146,3803,3292,79,93,73,56,149,3742
2020-02-20,전북,부산,289,8,24,45,81,8,455,330,11,25,42,88,9,505
2020-02-20,전북,서울,1272,38,44,31,43,41,1469,1320,18,40,18,26,40,1462
2020-02-20,전북,세종,715,13,23,17,56,28,852,694,18,27,16,41,24,820
2020-02-20,전북,울산,50,3,8,2,10,2,75,44,0,8,1,15,1,69
2020-02-20,전북,전남,4543,253,494,592,1328,140,7350,7062,322,714,883,2839,184,12004
2020-02-20,전북,전북,17147,658,929,598,1049,665,21046,17147,658,929,598,1049,665,21046
2020-02-20,전북,충남,15383,563,1681,1345,2376,520,21868,13003,476,1487,991,1435,427,17819
2020-02-20,전북,충북,2026,124,175,349,457,59,3190,1812,113,199,256,245,51,2676
2020-02-20,충남,강원,456,12,19,33,60,11,591,310,6,14,22,43,13,408
2020-02-20,충남,경기,37315,1453,2707,2254,4214,1825,49768,37207,1518,2771,2375,4418,1840,50129
2020-02-20,충남,경남,1727,58,167,334,553,52,2891,1102,56,151,262,219,36,1826
2020-02-20,충남,경북,3186,149,355,500,772,114,5076,3094,149,380,554,640,108,4925
2020-02-20,충남,광주,3983,128,534,561,334,100,5640,3941,106,523,454,245,104,5373
2020-02-20,충남,대구,1058,56,101,164,160,39,1578,1463,73,143,201,254,42,2176
2020-02-20,충남,대전,14630,444,479,224,275,1107,17159,16134,456,497,245,308,1210,18850
2020-02-20,충남,부산,147,16,27,76,192,5,463,152,12,22,85,166,4,441
2020-02-20,충남,서울,24675,621,2199,1278,1144,984,30901,24326,531,2235,801,714,995,29602
2020-02-20,충남,세종,4415,149,158,114,145,225,5206,5985,176,164,115,142,311,6893
2020-02-20,충남,울산,142,5,13,43,128,1,332,117,4,24,44,114,2,305
2020-02-20,충남,전남,4102,98,470,559,1107,111,6447,1809,53,235,480,291,49,2917
2020-02-20,충남,전북,13003,476,1487,991,1435,427,17819,15383,563,1681,1345,2376,520,21868
2020-02-20,충남,충남,96960,3580,7902,7046,10038,4547,130073,96960,3580,7902,7046,10038,4547,130073
2020-02-20,충남,충북,13995,660,889,969,1340,788,18641,12677,612,849,888,1427,713,17166
2020-02-20,충북,강원,4936,194,308,233,321,278,6270,4749,227,325,247,352,250,6150
2020-02-20,충북,경기,26996,2092,2896,2774,3482,1228,39468,27074,2174,2931,3174,3269,1323,39945
2020-02-20,충북,경남,1424,84,200,493,640,36,2877,1069,44,130,286,288,32,1849
2020-02-20,충북,경북,4488,237,508,684,1079,160,7156,4804,235,491,689,1045,152,7416
2020-02-20,충북,광주,600,34,111,177,87,11,1020,538,23,68,86,65,10,790
2020-02-20,충북,대구,1078,94,152,215,148,30,1717,1649,120,220,252,386,65,2692
2020-02-20,충북,대전,9993,376,416,164,161,770,11880,11086,432,431,184,163,831,13127
2020-02-20,충북,부산,110,12,22,108,183,3,438,110,17,28,124,213,1,493
2020-02-20,충북,서울,13296,672,1158,773,812,549,17260,13290,532,1127,761,722,559,16991
2020-02-20,충북,세종,308,18,23,18,13,24,404,388,15,20,19,16,29,487
2020-02-20,충북,울산,22,0,5,10,40,1,78,22,2,7,17,49,0,97
2020-02-20,충북,전남,380,20,42,91,285,12,830,147,13,13,34,81,1,289
2020-02-20,충북,전북,1812,113,199,256,245,51,2676,2026,124,175,349,457,59,3190
2020-02-20,충북,충남,12677,612,849,888,1427,713,17166,13995,660,889,969,1340,788,18641
2020-02-20,충북,충북,37582,1982,2284,2104,2933,2191,49076,37582,1982,2284,2104,2933,2191,49076
2020-02-21,강원,강원,76164,2242,3127,1311,2233,4879,89956,76164,2242,3127,1311,2233,4879,89956
2020-02-21,강원,경기,21975,613,1265,618,707,1100,26278,29423,624,1180,722,915,1293,34157
2020-02-21,강원,경남,208,3,13,15,28,12,279,151,2,9,20,5,3,190
2020-02-21,강원,경북,466,30,42,18,23,24,603,517,12,28,27,32,18,634
2020-02-21,강원,광주,119,4,19,5,9,3,159,100,3,13,10,9,2,137
2020-02-21,강원,대구,196,5,11,15,7,4,238,407,9,22,19,22,11,490
2020-02-21,강원,대전,189,2,29,5,3,7,235,230,1,30,6,0,9,276
2020-02-21,강원,부산,4,0,1,1,1,0,7,3,0,1,1,1,0,6
2020-02-21,강원,서울,706,11,282,10,20,26,1055,964,20,256,15,10,33,1298
2020-02-21,강원,세종,9,0,0,2,1,0,12,15,0,0,2,1,0,18
2020-02-21,강원,울산,1,0,0,0,0,0,1,2,0,0,0,0,0,2
2020-02-21,강원,전남,73,2,0,3,11,0,89,33,2,4,5,5,1,50
2020-02-21,강원,전북,172,1,11,11,14,5,214,215,5,9,20,23,7,279
2020-02-21,강원,충남,400,15,23,14,38,19,509,659,12,20,40,55,32,818
2020-02-21,강원,충북,5231,230,275,200,339,337,6612,5807,181,287,182,294,325,7076
2020-02-21,경기,강원,29423,624,1180,722,915,1293,34157,21975,613,1265,618,707,1100,26278
2020-02-21,경기,경기,441004,22830,24236,18533,22500,32768,561871,441004,22830,24236,18533,22500,32768,561871
2020-02-21,경기,경남,3499,98,344,786,580,132,5439,2713,59,291,529,394,101,4087
2020-02-21,경기,경북,4431,189,530,711,569,131,6561,4977,188,498,863,538,160,7224
2020-02-21,경기,광주,1247,34,172,316,146,37,1952,928,28,137,243,91,26,1453
2020-02-21,경기,대구,1914,113,239,348,259,54,2927,3551,126,228,432,411,130,4878
2020-02-21,경기,대전,2823,97,215,103,51,118,3407,2235,91,196,88,63,97,2770
2020-02-21,경기,부산,272,17,52,215,144,14,714,302,27,34,156,249,11,779
2020-02-21,경기,서울,150815,7255,8664,4450,3418,10243,184845,144752,6981,8790,4196,3058,9907,177684
2020-02-21,경기,세종,68,3,3,4,0,3,81,70,4,5,4,3,3,89
2020-02-21,경기,울산,43,2,0,11,20,2,78,53,3,10,32,67,4,169
2020-02-21,경기,전남,1150,18,106,177,158,49,1658,845,19,90,102,73,22,1151
2020-02-21,경기,전북,1862,43,184,116,183,58,2446,1697,46,161,192,225,64,2385
2020-02-21,경기,충남,41220,1463,2803,2331,4208,2143,54168,43475,1506,2715,2251,3981,2240,56168
2020-02-21,경기,충북,30700,2187,2950,3123,3270,1496,43726,30578,2098,2763,2751,3630,1511,43331
2020-02-21,경남,강원,151,2,9,20,5,3,190,208,3,13,15,28,12,279
2020-02-21,경남,경기,2713,59,291,529,394,101,4087,3499,98,344,786,580,132,5439
2020-02-21,경남,경남,199552,9952,10181,7754,13784,14959,256182,199552,9952,10181,7754,13784,14959,256182
2020-02-21,경남,경북,9718,579,973,937,1866,457,14530,13668,805,1185,1239,2611,633,20141
2020-02-21,경남,광주,1406,60,137,171,143,47,1964,1256,53,160,159,91,32,1751
2020-02-21,경남,대구,12451,738,907,1096,1449,471,17112,9818,524,711,403,453,450,12359
2020-02-21,경남,대전,1066,19,103,70,48,56,1362,1282,30,106,112,72,64,1666
2020-02-21,경남,부산,92470,2729,3061,1735,4687,6378,111060,88458,2787,3111,1775,4946,6237,107314
2020-02-21,경남,서울,2230,42,486,261,134,69,3222,2815,61,486,178,112,81,3733
2020-02-21,경남,세종,257,3,17,11,13,9,310,395,0,22,8,14,13,452
2020-02-21,경남,울산,10686,622,664,441,612,670,13695,10197,561,703,418,650,628,13157
2020-02-21,경남,전남,6433,269,461,526,1411,287,9387,7071,312,490,423,1320,292,9908
2020-02-21,경남,전북,1457,38,133,112,167,38,1945,1453,32,122,96,167,45,1915
2020-02-21,경남,충남,1379,56,139,240,245,46,2105,2438,69,156,327,556,85,3631
2020-02-21,경남,충북,1385,53,132,275,276,36,2157,1977,73,183,468,609,66,3376
2020-02-21,경북,강원,517,12,28,27,32,18,634,466,30,42,18,23,24,603
2020-02-21,경북,경기,4977,188,498,863,538,160,7224,4431,189,530,711,569,131,6561
2020-02-21,경북,경남,13668,805,1185,1239,2611,633,20141,9718,579,973,937,1866,457,14530
2020-02-21,경북,경북,68284,3877,4054,2834,4923,3679,87651,68284,3877,4054,2834,4923,3679,87651
2020-02-21,경북,광주,1102,45,121,172,126,23,1589,759,36,103,159,71,19,1147
2020-02-21,경북,대구,63452,2890,2818,1540,3352,3374,77426,66393,3017,3201,1973,3766,3515,81865
2020-02-21,경북,대전,2091,57,106,123,77,94,2548,1767,48,125,108,64,88,2200
2020-02-21,경북,부산,5058,101,293,200,656,230,6538,4500,106,313,240,777,190,6126
2020-02-21,경북,서울,3024,117,367,363,144,114,4129,2799,90,332,204,109,97,3631
2020-02-21,경북,세종,322,3,24,21,24,17,411,307,6,11,19,16,17,376
2020-02-21,경북,울산,5176,156,340,403,1047,287,7409,5167,148,326,339,1269,285,7534
2020-02-21,경북,전남,1108,49,72,110,416,36,1791,839,44,65,74,334,29,1385
2020-02-21,경북,전북,1811,66,191,181,237,75,2561,1701,92,180,154,451,66,2644
2020-02-21,경북,충남,3384,155,349,565,576,126,5155,3744,141,348,447,759,159,5598
2020-02-21,경북,충북,5547,236,502,666,1085,234,8270,5020,248,524,630,1135,202,7759
2020-02-21,광주,강원,100,3,13,10,9,2,137,119,4,19,5,9,3,159
2020-02-21,광주,경기,928,28,137,243,91,26,1453,1247,34,172,316,146,37,1952
2020-02-21,광주,경남,1256,53,160,159,91,32,1751,1406,60,137,171,143,47,1964
2020-02-21,광주,경북,759,36,103,159,71,19,1147,1102,45,121,172,126,23,1589
2020-02-21,광주,광주,13405,483,664,453,276,581,15862,13405,483,664,453,276,581,15862
2020-02-21,광주,대구,519,29,84,68,28,13,741,591,24,94,63,30,12,814
2020-02-21,광주,대전,506,15,15,14,15,16,581,574,18,19,21,19,18,669
2020-02-21,광주,부산,498,8,35,29,52,19,641,549,14,45,68,100,9,785
2020-02-21,광주,서울,854,17,23,72,23,28,1017,1051,20,25,36,25,32,1189
2020-02-21,광주,세종,188,0,9,6,1,4,208,284,1,7,2,1,8,303
2020-02-21,광주,울산,59,1,6,0,3,2,71,70,2,8,8,2,0,90
2020-02-21,광주,전남,34203,1014,1206,754,1820,1355,40352,34560,984,1056,700,1802,1370,40472
2020-02-21,광주,전북,8267,449,512,361,344,297,10230,8988,474,482,352,343,297,10936
2020-02-21,광주,충남,4831,115,560,471,252,122,6351,5448,116,565,578,338,157,7202
2020-02-21,광주,충북,633,14,63,95,58,14,877,879,27,92,167,94,19,1278
2020-02-21,대구,강원,407,9,22,19,22,11,490,196,5,11,15,7,4,238
2020-02-21,대구,경기,3551,126,228,432,411,130,4878,1914,113,239,348,259,54,2927
2020-02-21,대구,경남,9818,524,711,403,453,450,12359,12451,738,907,1096,1449,471,17112
2020-02-21,대구,경북,66393,3017,3201,1973,3766,3515,81865,63452,2890,2818,1540,3352,3374,77426
2020-02-21,대구,광주,591,24,94,63,30,12,814,519,29,84,68,28,13,741
2020-02-21,대구,대구,52395,2106,1798,823,1322,3485,61929,52395,2106,1798,823,1322,3485,61929
2020-02-21,대구,대전,1124,29,60,69,46,42,1370,599,22,34,59,18,23,755
2020-02-21,대구,부산,648,58,94,74,134,25,1033,2633,98,226,86,237,100,3380
2020-02-21,대구,서울,2972,82,193,225,99,91,3662,1521,59,141,120,64,30,1935
2020-02-21,대구,세종,293,5,15,10,4,13,340,151,3,6,3,7,6,176
2020-02-21,대구,울산,1153,58,128,75,172,53,1639,1143,43,132,76,183,40,1617
2020-02-21,대구,전남,447,10,43,21,41,11,573,422,20,37,33,60,7,579
2020-02-21,대구,전북,369,13,35,15,29,14,475,347,18,38,19,22,9,453
2020-02-21,대구,충남,1399,71,137,208,239,42,2096,1110,55,111,169,170,47,1662
2020-02-21,대구,충북,1853,103,212,257,382,68,2875,1164,86,147,209,117,40,1763
2020-02-21,대전,강원,230,1,30,6,0,9,276,189,2,29,5,3,7,235
2020-02-21,대전,경기,2235,91,196,88,63,97,2770,2823,97,215,103,51,118,3407
2020-02-21,대전,경남,1282,30,106,112,72,64,1666,1066,19,103,70,48,56,1362
2020-02-21,대전,경북,1767,48,125,108,64,88,2200,2091,57,106,123,77,94,2548
2020-02-21,대전,광주,574,18,19,21,19,18,669,506,15,15,14,15,16,581
2020-02-21,대전,대구,599,22,34,59,18,23,755,1124,29,60,69,46,42,1370
2020-02-21,대전,대전,14046,405,394,185,125,1110,16265,14046,405,394,185,125,1110,16265
2020-02-21,대전,부산,88,2,16,13,15,2,136,118,4,8,9,29,4,172
2020-02-21,대전,서울,1890,60,196,31,10,94,2281,2120,53,197,27,10,89,2496
2020-02-21,대전,세종,3488,114,86,25,34,269,4016,3552,104,92,25,40,290,4103
2020-02-21,대전,울산,124,3,12,20,23,7,189,176,5,13,16,22,7,239
2020-02-21,대전,전남,318,9,6,19,24,12,388,203,3,4,6,8,7,231
2020-02-21,대전,전북,3162,84,104,67,35,157,3609,3546,89,92,77,58,144,4006
2020-02-21,대전,충남,16358,478,522,343,289,1184,19174,15681,455,476,338,289,1123,18362
2020-02-21,대전,충북,11327,437,413,203,170,821,13371,10596,400,427,162,136,787,12508
2020-02-21,부산,강원,3,0,1,1,1,0,6,4,0,1,1,1,0,7
2020-02-21,부산,경기,302,27,34,156,249,11,779,272,17,52,215,144,14,714
2020-02-21,부산,경남,88458,2787,3111,1775,4946,6237,107314,92470,2729,3061,1735,4687,6378,111060
2020-02-21,부산,경북,4500,106,313,240,777,190,6126,5058,101,293,200,656,230,6538
2020-02-21,부산,광주,549,14,45,68,100,9,785,498,8,35,29,52,19,641
2020-02-21,부산,대구,2633,98,226,86,237,100,3380,648,58,94,74,134,25,1033
2020-02-21,부산,대전,118,4,8,9,29,4,172,88,2,16,13,15,2,136
2020-02-21,부산,부산,45050,747,742,989,2257,3253,53038,45050,747,742,989,2257,3253,53038
2020-02-21,부산,서울,250,15,22,80,54,6,427,218,12,24,68,43,8,373
2020-02-21,부산,세종,28,0,0,4,1,1,34,31,0,2,0,3,0,36
2020-02-21,부산,울산,16488,386,492,622,2595,1157,21740,18303,380,459,387,2463,1276,23268
2020-02-21,부산,전남,2332,78,125,186,591,77,3389,2026,80,105,144,552,89,2996
2020-02-21,부산,전북,415,8,29,37,81,12,582,317,6,28,33,51,17,452
2020-02-21,부산,충남,150,18,19,91,158,1,437,199,13,30,70,228,8,548
2020-02-21,부산,충북,133,12,22,85,210,10,472,132,19,21,106,161,4,443
2020-02-21,서울,강원,964,20,256,15,10,33,1298,706,11,282,10,20,26,1055
2020-02-21,서울,경기,144752,6981,8790,4196,3058,9907,177684,150815,7255,8664,4450,3418,10243,184845
2020-02-21,서울,경남,2815,61,486,178,112,81,3733,2230,42,486,261,134,69,3222
2020-02-21,서울,경북,2799,90,332,204,109,97,3631,3024,117,367,363,144,114,4129
2020-02-21,서울,광주,1051,20,25,36,25,32,1189,854,17,23,72,23,28,1017
2020-02-21,서울,대구,1521,59,141,120,64,30,1935,2972,82,193,225,99,91,3662
2020-02-21,서울,대전,2120,53,197,27,10,89,2496,1890,60,196,31,10,94,2281
2020-02-21,서울,부산,218,12,24,68,43,8,373,250,15,22,80,54,6,427
2020-02-21,서울,서울,219,3,14,1,2,23,262,219,3,14,1,2,23,262
2020-02-21,서울,세종,40,0,2,1,0,0,43,38,0,0,0,0,0,38
2020-02-21,서울,울산,27,0,5,4,0,1,37,31,1,2,8,14,1,57
2020-02-21,서울,전남,1152,10,21,31,55,32,1301,874,15,28,61,39,26,1043
2020-02-21,서울,전북,1714,17,33,28,16,43,1851,1588,27,46,37,60,42,1800
2020-02-21,서울,충남,27705,522,2329,744,633,1190,33123,28570,589,2339,1158,1106,1136,34898
2020-02-21,서울,충북,14415,509,1120,720,677,595,18036,14785,591,1127,768,792,627,18690
2020-02-21,세종,강원,15,0,0,2,1,0,18,9,0,0,2,1,0,12
2020-02-21,세종,경기,70,4,5,4,3,3,89,68,3,3,4,0,3,81
2020-02-21,세종,경남,395,0,22,8,14,13,452,257,3,17,11,13,9,310
2020-02-21,세종,경북,307,6,11,19,16,17,376,322,3,24,21,24,17,411
2020-02-21,세종,광주,284,1,7,2,1,8,303,188,0,9,6,1,4,208
2020-02-21,세종,대구,151,3,6,3,7,6,176,293,5,15,10,4,13,340
2020-02-21,세종,대전,3552,104,92,25,40,290,4103,3488,114,86,25,34,269,4016
2020-02-21,세종,부산,31,0,2,0,3,0,36,28,0,0,4,1,1,34
2020-02-21,세종,서울,38,0,0,0,0,0,38,40,0,2,1,0,0,43
2020-02-21,세종,세종,266,30,4,1,2,18,321,266,30,4,1,2,18,321
2020-02-21,세종,울산,10,0,0,3,4,1,18,16,0,2,1,6,0,25
2020-02-21,세종,전남,228,2,11,7,16,5,269,154,2,2,12,5,5,180
2020-02-21,세종,전북,762,18,31,12,59,29,911,855,12,27,19,68,39,1020
2020-02-21,세종,충남,6144,148,170,90,181,315,7048,5221,141,154,98,171,249,6034
2020-02-21,세종,충북,349,14,19,18,12,25,437,316,12,14,16,15,21,394
2020-02-21,울산,강원,2,0,0,0,0,0,2,1,0,0,0,0,0,1
2020-02-21,울산,경기,53,3,10,32,67,4,169,43,2,0,11,20,2,78
2020-02-21,울산,경남,10197,561,703,418,650,628,13157,10686,622,664,441,612,670,13695
2020-02-21,울산,경북,5167,148,326,339,1269,285,7534,5176,156,340,403,1047,287,7409
2020-02-21,울산,광주,70,2,8,8,2,0,90,59,1,6,0,3,2,71
2020-02-21,울산,대구,1143,43,132,76,183,40,1617,1153,58,128,75,172,53,1639
2020-02-21,울산,대전,176,5,13,16,22,7,239,124,3,12,20,23,7,189
2020-02-21,울산,부산,18303,380,459,387,2463,1276,23268,16488,386,492,622,2595,1157,21740
2020-02-21,울산,서울,31,1,2,8,14,1,57,27,0,5,4,0,1,37
2020-02-21,울산,세종,16,0,2,1,6,0,25,10,0,0,3,4,1,18
2020-02-21,울산,울산,8161,283,556,326,588,735,10649,8161,283,556,326,588,735,10649
2020-02-21,울산,전남,243,15,17,13,24,6,318,230,11,17,13,41,9,321
2020-02-21,울산,전북,53,0,7,2,14,1,77,60,3,7,1,3,0,74
2020-02-21,울산,충남,146,6,19,38,102,4,315,201,5,9,40,125,3,383
2020-02-21,울산,충북,28,3,6,13,34,2,86,14,0,2,15,40,0,71
2020-02-21,전남,강원,33,2,4,5,5,1,50,73,2,0,3,11,0,89
2020-02-21,전남,경기,845,19,90,102,73,22,1151,1150,18,106,177,158,49,1658
2020-02-21,전남,경남,7071,312,490,423,1320,292,9908,6433,269,461,526,1411,287,9387
2020-02-21,전남,경북,839,44,65,74,334,29,1385,1108,49,72,110,416,36,1791
2020-02-21,전남,광주,34560,984,1056,700,1802,1370,40472,34203,1014,1206,754,1820,1355,40352
2020-02-21,전남,대구,422,20,37,33,60,7,579,447,10,43,21,41,11,573
2020-02-21,전남,대전,203,3,4,6,8,7,231,318,9,6,19,24,12,388
2020-02-21,전남,부산,2026,80,105,144,552,89,2996,2332,78,125,186,591,77,3389
2020-02-21,전남,서울,874,15,28,61,39,26,1043,1152,10,21,31,55,32,1301
2020-02-21,전남,세종,154,2,2,12,5,5,180,228,2,11,7,16,5,269
2020-02-21,전남,울산,230,11,17,13,41,9,321,243,15,17,13,24,6,318
2020-02-21,전남,전남,48671,1390,1761,1678,4810,1938,60248,48671,1390,1761,1678,4810,1938,60248
2020-02-21,전남,전북,8904,332,699,743,2648,266,13592,5146,249,463,545,1360,150,7913
2020-02-21,전남,충남,2250,47,241,446,289,65,3338,5795,94,462,500,1052,161,8064
2020-02-21,전남,충북,206,6,16,32,59,4,323,472,15,31,93,236,11,858
2020-02-21,전북,강원,215,5,9,20,23,7,279,172,1,11,11,14,5,214
2020-02-21,전북,경기,1697,46,161,192,225,64,2385,1862,43,184,116,183,58,2446
2020-02-21,전북,경남,1453,32,122,96,167,45,1915,1457,38,133,112,167,38,1945
2020-02-21,전북,경북,1701,92,180,154,451,66,2644,1811,66,191,181,237,75,2561
2020-02-21,전북,광주,8988,474,482,352,343,297,10936,8267,449,512,361,344,297,10230
2020-02-21,전북,대구,347,18,38,19,22,9,453,369,13,35,15,29,14,475
2020-02-21,전북,대전,3546,89,92,77,58,144,4006,3162,84,104,67,35,157,3609
2020-02-21,전북,부산,317,6,28,33,51,17,452,415,8,29,37,81,12,582
2020-02-21,전북,서울,1588,27,46,37,60,42,1800,1714,17,33,28,16,43,1851
2020-02-21,전북,세종,855,12,27,19,68,39,1020,762,18,31,12,59,29,911
2020-02-21,전북,울산,60,3,7,1,3,0,74,53,0,7,2,14,1,77
2020-02-21,전북,전남,5146,249,463,545,1360,150,7913,8904,332,699,743,2648,266,13592
2020-02-21,전북,전북,16598,641,960,705,1198,609,20711,16598,641,960,705,1198,609,20711
2020-02-21,전북,충남,18347,553,1712,1330,2239,601,24782,16085,504,1452,981,1437,561,21020
2020-02-21,전북,충북,2347,119,190,372,422,91,3541,2088,115,177,263,237,69,2949
2020-02-21,충남,강원,659,12,20,40,55,32,818,400,15,23,14,38,19,509
2020-02-21,충남,경기,43475,1506,2715,2251,3981,2240,56168,41220,1463,2803,2331,4208,2143,54168
2020-02-21,충남,경남,2438,69,156,327,556,85,3631,1379,56,139,240,245,46,2105
2020-02-21,충남,경북,3744,141,348,447,759,159,5598,3384,155,349,565,576,126,5155
2020-02-21,충남,광주,5448,116,565,578,338,157,7202,4831,115,560,471,252,122,6351
2020-02-21,충남,대구,1110,55,111,169,170,47,1662,1399,71,137,208,239,42,2096
2020-02-21,충남,대전,15681,455,476,338,289,1123,18362,16358,478,522,343,289,1184,19174
2020-02-21,충남,부산,199,13,30,70,228,8,548,150,18,19,91,158,1,437
2020-02-21,충남,서울,28570,589,2339,1158,1106,1136,34898,27705,522,2329,744,633,1190,33123
2020-02-21,충남,세종,5221,141,154,98,171,249,6034,6144,148,170,90,181,315,7048
2020-02-21,충남,울산,201,5,9,40,125,3,383,146,6,19,38,102,4,315
2020-02-21,충남,전남,5795,94,462,500,1052,161,8064,2250,47,241,446,289,65,3338
2020-02-21,충남,전북,16085,504,1452,981,1437,561,21020,18347,553,1712,1330,2239,601,24782
2020-02-21,충남,충남,108517,3543,7910,6868,10254,5116,142208,108517,3543,7910,6868,10254,5116,142208
2020-02-21,충남,충북,14563,649,864,934,1408,875,19293,12941,608,816,827,1417,774,17383
2020-02-21,충북,강원,5807,181,287,182,294,325,7076,5231,230,275,200,339,337,6612
2020-02-21,충북,경기,30578,2098,2763,2751,3630,1511,43331,30700,2187,2950,3123,3270,1496,43726
2020-02-21,충북,경남,1977,73,183,468,609,66,3376,1385,53,132,275,276,36,2157
2020-02-21,충북,경북,5020,248,524,630,1135,202,7759,5547,236,502,666,1085,234,8270
2020-02-21,충북,광주,879,27,92,167,94,19,1278,633,14,63,95,58,14,877
2020-02-21,충북,대구,1164,86,147,209,117,40,1763,1853,103,212,257,382,68,2875
2020-02-21,충북,대전,10596,400,427,162,136,787,12508,11327,437,413,203,170,821,13371
2020-02-21,충북,부산,132,19,21,106,161,4,443,133,12,22,85,210,10,472
2020-02-21,충북,서울,14785,591,1127,768,792,627,18690,14415,509,1120,720,677,595,18036
2020-02-21,충북,세종,316,12,14,16,15,21,394,349,14,19,18,12,25,437
2020-02-21,충북,울산,14,0,2,15,40,0,71,28,3,6,13,34,2,86
2020-02-21,충북,전남,472,15,31,93,236,11,858,206,6,16,32,59,4,323
2020-02-21,충북,전북,2088,115,177,263,237,69,2949,2347,119,190,372,422,91,3541
2020-02-21,충북,충남,12941,608,816,827,1417,774,17383,14563,649,864,934,1408,875,19293
2020-02-21,충북,충북,37948,1902,2246,2230,2987,2240,49553,37948,1902,2246,2230,2987,2240,49553
2020-02-22,강원,강원,78907,1455,2416,803,1768,4076,89425,78907,1455,2416,803,1768,4076,89425
2020-02-22,강원,경기,27552,308,949,347,352,1180,30688,37670,343,931,374,482,1495,41295
2020-02-22,강원,경남,167,1,10,4,2,6,190,127,0,3,7,2,7,146
2020-02-22,강원,경북,423,15,24,7,15,12,496,514,14,23,14,11,15,591
2020-02-22,강원,광주,94,3,17,3,6,0,123,92,0,16,3,2,4,117
2020-02-22,강원,대구,173,1,6,4,0,4,188,355,5,17,7,5,7,396
2020-02-22,강원,대전,200,5,28,1,0,11,245,254,2,30,4,1,14,305
2020-02-22,강원,부산,8,0,1,0,2,0,11,10,0,0,0,0,0,10
2020-02-22,강원,서울,873,11,282,3,20,41,1230,1444,11,264,4,5,53,1781
2020-02-22,강원,세종,8,0,0,1,1,0,10,16,0,0,0,1,1,18
2020-02-22,강원,울산,5,0,0,0,0,1,6,0,0,0,0,0,0,0
2020-02-22,강원,전남,38,1,0,0,7,0,46,24,0,2,2,9,1,38
2020-02-22,강원,전북,155,2,9,10,4,10,190,237,3,10,10,8,5,273
2020-02-22,강원,충남,404,2,16,6,21,14,463,601,5,22,23,40,12,703
2020-02-22,강원,충북,4619,145,179,97,209,234,5483,5338,124,165,88,188,250,6153
2020-02-22,경기,강원,37670,343,931,374,482,1495,41295,27552,308,949,347,352,1180,30688
2020-02-22,경기,경기,338496,10100,11767,9388,11417,21619,402787,338496,10100,11767,9388,11417,21619,402787
2020-02-22,경기,경남,3013,55,295,458,323,119,4263,2177,28,212,274,177,65,2933
2020-02-22,경기,경북,3855,75,263,433,299,148,5073,3691,78,243,437,318,115,4882
2020-02-22,경기,광주,1163,20,139,168,84,38,1612,896,14,105,101,35,24,1175
2020-02-22,경기,대구,1333,43,154,258,135,44,1967,2438,58,163,229,178,83,3149
2020-02-22,경기,대전,2894,50,168,75,32,132,3351,2503,51,166,46,22,118,2906
2020-02-22,경기,부산,308,9,42,114,78,12,563,319,15,25,96,101,9,565
2020-02-22,경기,서울,124505,4037,5406,2700,2153,7381,146182,120206,3455,5436,2151,1890,7108,140246
2020-02-22,경기,세종,44,0,1,1,3,6,55,57,2,2,1,3,3,68
2020-02-22,경기,울산,25,0,1,3,4,0,33,38,2,5,13,26,0,84
2020-02-22,경기,전남,1225,8,77,92,108,33,1543,879,7,50,64,40,24,1064
2020-02-22,경기,전북,2179,15,130,57,91,91,2563,1737,26,105,76,85,56,2085
2020-02-22,경기,충남,41276,718,1632,1079,1966,1975,48646,39318,651,1617,994,2045,1867,46492
2020-02-22,경기,충북,28660,895,1325,1450,1877,1313,35520,27208,809,1271,1218,2211,1271,33988
2020-02-22,경남,강원,127,0,3,7,2,7,146,167,1,10,4,2,6,190
2020-02-22,경남,경기,2177,28,212,274,177,65,2933,3013,55,295,458,323,119,4263
2020-02-22,경남,경남,151742,5409,5373,3894,8178,10140,184736,151742,5409,5373,3894,8178,10140,184736
2020-02-22,경남,경북,9334,274,537,376,893,430,11844,11848,370,627,613,1201,570,15229
2020-02-22,경남,광주,1354,25,87,92,56,37,1651,1261,22,86,83,32,42,1526
2020-02-22,경남,대구,10455,346,645,488,566,417,12917,8517,240,472,238,196,315,9978
2020-02-22,경남,대전,973,6,83,33,19,29,1143,1360,15,100,85,35,50,1645
2020-02-22,경남,부산,75391,1484,2039,996,2178,4869,86957,74091,1482,2030,894,2314,4820,85631
2020-02-22,경남,서울,2240,24,454,149,72,68,3007,2995,36,533,120,84,89,3857
2020-02-22,경남,세종,198,2,7,3,4,6,220,320,3,14,4,7,9,357
2020-02-22,경남,울산,9659,315,377,180,231,576,11338,9472,301,391,164,267,540,11135
2020-02-22,경남,전남,6130,127,295,239,717,310,7818,6032,130,266,210,709,265,7612
2020-02-22,경남,전북,1469,25,93,45,127,57,1816,1249,26,85,57,119,38,1574
2020-02-22,경남,충남,1152,15,61,76,79,47,1430,1847,20,72,152,228,78,2397
2020-02-22,경남,충북,1171,11,72,107,166,57,1584,1564,25,119,243,346,70,2367
2020-02-22,경북,강원,514,14,23,14,11,15,591,423,15,24,7,15,12,496
2020-02-22,경북,경기,3691,78,243,437,318,115,4882,3855,75,263,433,299,148,5073
2020-02-22,경북,경남,11848,370,627,613,1201,570,15229,9334,274,537,376,893,430,11844
2020-02-22,경북,경북,53016,2035,2286,1448,2967,2543,64295,53016,2035,2286,1448,2967,2543,64295
2020-02-22,경북,광주,696,15,64,68,37,20,900,629,20,38,71,26,19,803
2020-02-22,경북,대구,44531,1632,1780,1020,2412,2075,53450,49059,1678,1944,1200,2565,2232,58678
2020-02-22,경북,대전,1852,26,80,56,29,78,2121,1911,18,77,75,29,92,2202
2020-02-22,경북,부산,4855,71,251,85,231,203,5696,5095,74,274,84,245,221,5993
2020-02-22,경북,서울,2783,51,296,165,80,91,3466,3065,42,308,118,75,104,3712
2020-02-22,경북,세종,250,1,10,6,14,9,290,300,2,10,3,8,7,330
2020-02-22,경북,울산,4671,68,168,257,625,248,6037,4938,64,175,136,770,251,6334
2020-02-22,경북,전남,1107,19,42,43,216,36,1463,799,15,39,23,135,26,1037
2020-02-22,경북,전북,1597,40,113,92,105,50,1997,1424,44,106,72,219,41,1906
2020-02-22,경북,충남,3008,50,137,176,252,95,3718,3248,65,169,203,358,115,4158
2020-02-22,경북,충북,4739,103,243,278,629,194,6186,4619,102,268,338,670,172,6169
2020-02-22,광주,강원,92,0,16,3,2,4,117,94,3,17,3,6,0,123
2020-02-22,광주,경기,896,14,105,101,35,24,1175,1163,20,139,168,84,38,1612
2020-02-22,광주,경남,1261,22,86,83,32,42,1526,1354,25,87,92,56,37,1651
2020-02-22,광주,경북,629,20,38,71,26,19,803,696,15,64,68,37,20,900
2020-02-22,광주,광주,10514,317,444,199,198,387,12059,10514,317,444,199,198,387,12059
2020-02-22,광주,대구,395,11,54,36,14,8,518,466,10,62,47,6,15,606
2020-02-22,광주,대전,526,9,7,14,6,23,585,552,7,12,17,14,19,621
2020-02-22,광주,부산,559,4,44,14,20,14,655,555,7,57,24,28,14,685
2020-02-22,광주,서울,809,13,22,49,15,28,936,1103,9,30,35,10,33,1220
2020-02-22,광주,세종,190,1,3,2,1,5,202,220,1,7,0,0,6,234
2020-02-22,광주,울산,63,0,9,0,3,0,75,64,1,8,1,3,0,77
2020-02-22,광주,전남,34785,608,853,446,779,1201,38672,32025,627,826,370,845,1089,35782
2020-02-22,광주,전북,8022,229,282,145,170,239,9087,8124,275,279,157,186,257,9278
2020-02-22,광주,충남,4952,42,534,217,98,153,5996,5361,69,563,308,211,167,6679
2020-02-22,광주,충북,584,13,38,42,16,18,711,768,9,59,69,36,13,954
2020-02-22,대구,강원,355,5,17,7,5,7,396,173,1,6,4,0,4,188
2020-02-22,대구,경기,2438,58,163,229,178,83,3149,1333,43,154,258,135,44,1967
2020-02-22,대구,경남,8517,240,472,238,196,315,9978,10455,346,645,488,566,417,12917
2020-02-22,대구,경북,49059,1678,1944,1200,2565,2232,58678,44531,1632,1780,1020,2412,2075,53450
2020-02-22,대구,광주,466,10,62,47,6,15,606,395,11,54,36,14,8,518
2020-02-22,대구,대구,34284,1141,971,686,758,1944,39784,34284,1141,971,686,758,1944,39784
2020-02-22,대구,대전,954,21,41,37,20,33,1106,537,11,28,54,12,19,661
2020-02-22,대구,부산,586,19,71,38,30,25,769,2533,42,195,35,70,86,2961
2020-02-22,대구,서울,2699,39,204,102,38,68,3150,1242,29,135,87,34,40,1567
2020-02-22,대구,세종,222,1,9,1,5,6,244,148,2,1,0,3,4,158
2020-02-22,대구,울산,983,27,91,46,93,32,1272,880,19,100,45,120,27,1191
2020-02-22,대구,전남,511,5,32,10,23,18,599,382,10,29,14,27,12,474
2020-02-22,대구,전북,291,6,29,7,6,8,347,248,8,29,10,15,10,320
2020-02-22,대구,충남,1149,24,67,73,72,50,1435,699,15,44,81,79,32,950
2020-02-22,대구,충북,1583,28,109,105,169,39,2033,939,40,96,139,88,22,1324
2020-02-22,대전,강원,254,2,30,4,1,14,305,200,5,28,1,0,11,245
2020-02-22,대전,경기,2503,51,166,46,22,118,2906,2894,50,168,75,32,132,3351
2020-02-22,대전,경남,1360,15,100,85,35,50,1645,973,6,83,33,19,29,1143
2020-02-22,대전,경북,1911,18,77,75,29,92,2202,1852,26,80,56,29,78,2121
2020-02-22,대전,광주,552,7,12,17,14,19,621,526,9,7,14,6,23,585
2020-02-22,대전,대구,537,11,28,54,12,19,661,954,21,41,37,20,33,1106
2020-02-22,대전,대전,10114,212,260,308,64,692,11650,10114,212,260,308,64,692,11650
2020-02-22,대전,부산,94,3,4,9,6,2,118,123,0,12,14,19,6,174
2020-02-22,대전,서울,2163,31,235,14,4,92,2539,2472,20,231,21,11,115,2870
2020-02-22,대전,세종,2557,65,43,14,32,167,2878,2605,71,54,21,37,169,2957
2020-02-22,대전,울산,122,4,9,10,12,4,161,148,0,13,1,12,5,179
2020-02-22,대전,전남,453,1,6,16,16,10,502,144,2,5,4,3,2,160
2020-02-22,대전,전북,3630,52,74,48,30,135,3969,3629,64,61,34,44,145,3977
2020-02-22,대전,충남,13044,234,332,144,105,756,14615,12190,245,319,116,117,765,13752
2020-02-22,대전,충북,8905,255,322,117,90,565,10254,8340,238,280,109,113,544,9624
2020-02-22,부산,강원,10,0,0,0,0,0,10,8,0,1,0,2,0,11
2020-02-22,부산,경기,319,15,25,96,101,9,565,308,9,42,114,78,12,563
2020-02-22,부산,경남,74091,1482,2030,894,2314,4820,85631,75391,1484,2039,996,2178,4869,86957
2020-02-22,부산,경북,5095,74,274,84,245,221,5993,4855,71,251,85,231,203,5696
2020-02-22,부산,광주,555,7,57,24,28,14,685,559,4,44,14,20,14,655
2020-02-22,부산,대구,2533,42,195,35,70,86,2961,586,19,71,38,30,25,769
2020-02-22,부산,대전,123,0,12,14,19,6,174,94,3,4,9,6,2,118
2020-02-22,부산,부산,37731,419,350,269,1165,2303,42237,37731,419,350,269,1165,2303,42237
2020-02-22,부산,서울,319,7,25,32,21,7,411,276,6,21,52,25,10,390
2020-02-22,부산,세종,32,1,0,1,2,1,37,25,0,0,0,1,0,26
2020-02-22,부산,울산,15497,218,234,271,1196,988,18404,16543,224,181,155,1190,1067,19360
2020-02-22,부산,전남,2273,45,79,85,289,83,2854,1974,25,83,57,276,79,2494
2020-02-22,부산,전북,408,8,37,11,44,17,525,348,5,34,14,16,5,422
2020-02-22,부산,충남,173,5,10,28,53,6,275,202,5,14,44,83,7,355
2020-02-22,부산,충북,151,5,15,32,77,4,284,131,5,15,64,58,3,276
2020-02-22,서울,강원,1444,11,264,4,5,53,1781,873,11,282,3,20,41,1230
2020-02-22,서울,경기,120206,3455,5436,2151,1890,7108,140246,124505,4037,5406,2700,2153,7381,146182
2020-02-22,서울,경남,2995,36,533,120,84,89,3857,2240,24,454,149,72,68,3007
2020-02-22,서울,경북,3065,42,308,118,75,104,3712,2783,51,296,165,80,91,3466
2020-02-22,서울,광주,1103,9,30,35,10,33,1220,809,13,22,49,15,28,936
2020-02-22,서울,대구,1242,29,135,87,34,40,1567,2699,39,204,102,38,68,3150
2020-02-22,서울,대전,2472,20,231,21,11,115,2870,2163,31,235,14,4,92,2539
2020-02-22,서울,부산,276,6,21,52,25,10,390,319,7,25,32,21,7,411
2020-02-22,서울,서울,172,1,3,1,2,7,186,172,1,3,1,2,7,186
2020-02-22,서울,세종,37,0,0,3,0,3,43,40,1,0,0,0,2,43
2020-02-22,서울,울산,34,1,0,2,0,2,39,32,0,2,1,5,2,42
2020-02-22,서울,전남,1301,5,23,26,31,35,1421,945,7,21,27,18,25,1043
2020-02-22,서울,전북,2041,6,38,9,16,44,2154,1727,17,36,9,34,45,1868
2020-02-22,서울,충남,32934,262,2198,439,448,1251,37532,30960,293,2174,530,623,1211,35791
2020-02-22,서울,충북,15572,179,948,374,333,624,18030,15333,248,921,428,475,609,18014
2020-02-22,세종,강원,16,0,0,0,1,1,18,8,0,0,1,1,0,10
2020-02-22,세종,경기,57,2,2,1,3,3,68,44,0,1,1,3,6,55
2020-02-22,세종,경남,320,3,14,4,7,9,357,198,2,7,3,4,6,220
2020-02-22,세종,경북,300,2,10,3,8,7,330,250,1,10,6,14,9,290
2020-02-22,세종,광주,220,1,7,0,0,6,234,190,1,3,2,1,5,202
2020-02-22,세종,대구,148,2,1,0,3,4,158,222,1,9,1,5,6,244
2020-02-22,세종,대전,2605,71,54,21,37,169,2957,2557,65,43,14,32,167,2878
2020-02-22,세종,부산,25,0,0,0,1,0,26,32,1,0,1,2,1,37
2020-02-22,세종,서울,40,1,0,0,0,2,43,37,0,0,3,0,3,43
2020-02-22,세종,세종,231,21,0,0,0,12,264,231,21,0,0,0,12,264
2020-02-22,세종,울산,3,1,0,0,1,0,5,6,2,0,0,2,0,10
2020-02-22,세종,전남,219,1,13,8,8,8,257,119,1,0,5,3,1,129
2020-02-22,세종,전북,924,5,11,3,14,33,990,748,4,7,6,21,36,822
2020-02-22,세종,충남,5545,113,102,51,111,273,6195,4052,86,91,56,108,177,4570
2020-02-22,세종,충북,261,6,11,14,4,22,318,239,5,14,14,10,27,309
2020-02-22,울산,강원,0,0,0,0,0,0,0,5,0,0,0,0,1,6
2020-02-22,울산,경기,38,2,5,13,26,0,84,25,0,1,3,4,0,33
2020-02-22,울산,경남,9472,301,391,164,267,540,11135,9659,315,377,180,231,576,11338
2020-02-22,울산,경북,4938,64,175,136,770,251,6334,4671,68,168,257,625,248,6037
2020-02-22,울산,광주,64,1,8,1,3,0,77,63,0,9,0,3,0,75
2020-02-22,울산,대구,880,19,100,45,120,27,1191,983,27,91,46,93,32,1272
2020-02-22,울산,대전,148,0,13,1,12,5,179,122,4,9,10,12,4,161
2020-02-22,울산,부산,16543,224,181,155,1190,1067,19360,15497,218,234,271,1196,988,18404
2020-02-22,울산,서울,32,0,2,1,5,2,42,34,1,0,2,0,2,39
2020-02-22,울산,세종,6,2,0,0,2,0,10,3,1,0,0,1,0,5
2020-02-22,울산,울산,5315,130,152,103,293,419,6412,5315,130,152,103,293,419,6412
2020-02-22,울산,전남,240,4,10,4,11,4,273,243,8,10,7,13,6,287
2020-02-22,울산,전북,67,2,6,0,8,1,84,47,0,7,0,2,2,58
2020-02-22,울산,충남,122,3,6,12,61,8,212,129,5,7,12,61,6,220
2020-02-22,울산,충북,21,0,1,2,25,1,50,20,1,0,8,15,0,44
2020-02-22,전남,강원,24,0,2,2,9,1,38,38,1,0,0,7,0,46
2020-02-22,전남,경기,879,7,50,64,40,24,1064,1225,8,77,92,108,33,1543
2020-02-22,전남,경남,6032,130,266,210,709,265,7612,6130,127,295,239,717,310,7818
2020-02-22,전남,경북,799,15,39,23,135,26,1037,1107,19,42,43,216,36,1463
2020-02-22,전남,광주,32025,627,826,370,845,1089,35782,34785,608,853,446,779,1201,38672
2020-02-22,전남,대구,382,10,29,14,27,12,474,511,5,32,10,23,18,599
2020-02-22,전남,대전,144,2,5,4,3,2,160,453,1,6,16,16,10,502
2020-02-22,전남,부산,1974,25,83,57,276,79,2494,2273,45,79,85,289,83,2854
2020-02-22,전남,서울,945,7,21,27,18,25,1043,1301,5,23,26,31,35,1421
2020-02-22,전남,세종,119,1,0,5,3,1,129,219,1,13,8,8,8,257
2020-02-22,전남,울산,243,8,10,7,13,6,287,240,4,10,4,11,4,273
2020-02-22,전남,전남,44818,780,1072,916,3080,1513,52179,44818,780,1072,916,3080,1513,52179
2020-02-22,전남,전북,8816,188,524,322,1208,275,11333,5516,138,327,351,759,166,7257
2020-02-22,전남,충남,2125,29,159,166,109,60,2648,6166,42,428,291,491,160,7578
2020-02-22,전남,충북,169,4,11,22,16,2,224,461,4,18,52,121,14,670
2020-02-22,전북,강원,237,3,10,10,8,5,273,155,2,9,10,4,10,190
2020-02-22,전북,경기,1737,26,105,76,85,56,2085,2179,15,130,57,91,91,2563
2020-02-22,전북,경남,1249,26,85,57,119,38,1574,1469,25,93,45,127,57,1816
2020-02-22,전북,경북,1424,44,106,72,219,41,1906,1597,40,113,92,105,50,1997
2020-02-22,전북,광주,8124,275,279,157,186,257,9278,8022,229,282,145,170,239,9087
2020-02-22,전북,대구,248,8,29,10,15,10,320,291,6,29,7,6,8,347
2020-02-22,전북,대전,3629,64,61,34,44,145,3977,3630,52,74,48,30,135,3969
2020-02-22,전북,부산,348,5,34,14,16,5,422,408,8,37,11,44,17,525
2020-02-22,전북,서울,1727,17,36,9,34,45,1868,2041,6,38,9,16,44,2154
2020-02-22,전북,세종,748,4,7,6,21,36,822,924,5,11,3,14,33,990
2020-02-22,전북,울산,47,0,7,0,2,2,58,67,2,6,0,8,1,84
2020-02-22,전북,전남,5516,138,327,351,759,166,7257,8816,188,524,322,1208,275,11333
2020-02-22,전북,전북,13707,374,667,302,705,499,16254,13707,374,667,302,705,499,16254
2020-02-22,전북,충남,18765,239,1326,533,1006,672,22541,17144,253,1197,526,792,588,20500
2020-02-22,전북,충북,2131,47,93,151,174,82,2678,2128,60,112,113,153,71,2637
2020-02-22,충남,강원,601,5,22,23,40,12,703,404,2,16,6,21,14,463
2020-02-22,충남,경기,39318,651,1617,994,2045,1867,46492,41276,718,1632,1079,1966,1975,48646
2020-02-22,충남,경남,1847,20,72,152,228,78,2397,1152,15,61,76,79,47,1430
2020-02-22,충남,경북,3248,65,169,203,358,115,4158,3008,50,137,176,252,95,3718
2020-02-22,충남,광주,5361,69,563,308,211,167,6679,4952,42,534,217,98,153,5996
2020-02-22,충남,대구,699,15,44,81,79,32,950,1149,24,67,73,72,50,1435
2020-02-22,충남,대전,12190,245,319,116,117,765,13752,13044,234,332,144,105,756,14615
2020-02-22,충남,부산,202,5,14,44,83,7,355,173,5,10,28,53,6,275
2020-02-22,충남,서울,30960,293,2174,530,623,1211,35791,32934,262,2198,439,448,1251,37532
2020-02-22,충남,세종,4052,86,91,56,108,177,4570,5545,113,102,51,111,273,6195
2020-02-22,충남,울산,129,5,7,12,61,6,220,122,3,6,12,61,8,212
2020-02-22,충남,전남,6166,42,428,291,491,160,7578,2125,29,159,166,109,60,2648
2020-02-22,충남,전북,17144,253,1197,526,792,588,20500,18765,239,1326,533,1006,672,22541
2020-02-22,충남,충남,99020,1704,5515,3137,4798,4216,118390,99020,1704,5515,3137,4798,4216,118390
2020-02-22,충남,충북,10727,308,502,437,822,573,13369,9948,298,452,373,739,536,12346
2020-02-22,충북,강원,5338,124,165,88,188,250,6153,4619,145,179,97,209,234,5483
2020-02-22,충북,경기,27208,809,1271,1218,2211,1271,33988,28660,895,1325,1450,1877,1313,35520
2020-02-22,충북,경남,1564,25,119,243,346,70,2367,1171,11,72,107,166,57,1584
2020-02-22,충북,경북,4619,102,268,338,670,172,6169,4739,103,243,278,629,194,6186
2020-02-22,충북,광주,768,9,59,69,36,13,954,584,13,38,42,16,18,711
2020-02-22,충북,대구,939,40,96,139,88,22,1324,1583,28,109,105,169,39,2033
2020-02-22,충북,대전,8340,238,280,109,113,544,9624,8905,255,322,117,90,565,10254
2020-02-22,충북,부산,131,5,15,64,58,3,276,151,5,15,32,77,4,284
2020-02-22,충북,서울,15333,248,921,428,475,609,18014,15572,179,948,374,333,624,18030
2020-02-22,충북,세종,239,5,14,14,10,27,309,261,6,11,14,4,22,318
2020-02-22,충북,울산,20,1,0,8,15,0,44,21,0,1,2,25,1,50
2020-02-22,충북,전남,461,4,18,52,121,14,670,169,4,11,22,16,2,224
2020-02-22,충북,전북,2128,60,112,113,153,71,2637,2131,47,93,151,174,82,2678
2020-02-22,충북,충남,9948,298,452,373,739,536,12346,10727,308,502,437,822,573,13369
2020-02-22,충북,충북,29805,973,1128,1005,1717,1534,36162,29805,973,1128,1005,1717,1534,36162
2020-02-23,강원,강원,58367,683,1831,298,413,3199,64791,58367,683,1831,298,413,3199,64791
2020-02-23,강원,경기,38362,211,765,186,148,1475,41147,22399,138,725,123,185,1014,24584
2020-02-23,강원,경남,228,1,6,6,6,7,254,102,0,2,6,2,5,117
2020-02-23,강원,경북,487,15,24,3,2,15,546,346,9,19,8,5,12,399
2020-02-23,강원,광주,122,0,17,3,0,3,145,83,1,15,1,1,2,103
2020-02-23,강원,대구,282,1,6,4,2,5,300,194,4,13,1,0,4,216
2020-02-23,강원,대전,253,2,24,0,0,16,295,193,2,26,1,0,8,230
2020-02-23,강원,부산,5,0,1,0,0,0,6,9,0,1,0,0,0,10
2020-02-23,강원,서울,1428,7,324,5,3,44,1811,792,4,239,0,4,31,1070
2020-02-23,강원,세종,8,0,0,0,0,1,9,7,0,1,0,1,0,9
2020-02-23,강원,울산,2,0,0,0,0,0,2,2,0,0,0,0,0,2
2020-02-23,강원,전남,63,2,3,0,3,1,72,21,0,1,0,1,0,23
2020-02-23,강원,전북,192,0,5,2,2,8,209,216,3,4,17,3,10,253
2020-02-23,강원,충남,482,2,14,4,21,20,543,438,1,16,7,20,22,504
2020-02-23,강원,충북,4561,77,123,39,54,201,5055,3779,60,118,33,48,225,4263
2020-02-23,경기,강원,22399,138,725,123,185,1014,24584,38362,211,765,186,148,1475,41147
2020-02-23,경기,경기,262822,4905,6178,3014,3324,16136,296379,262822,4905,6178,3014,3324,16136,296379
2020-02-23,경기,경남,2462,17,199,151,73,96,2998,2651,20,168,141,73,104,3157
2020-02-23,경기,경북,3115,30,181,143,74,112,3655,3914,38,149,188,84,156,4529
2020-02-23,경기,광주,742,10,93,30,10,20,905,1022,4,75,31,14,42,1188
2020-02-23,경기,대구,1418,15,99,95,28,39,1694,2186,23,105,95,44,83,2536
2020-02-23,경기,대전,1903,8,138,11,4,109,2173,2601,22,128,16,5,163,2935
2020-02-23,경기,부산,245,4,11,29,11,9,309,482,9,11,26,30,28,586
2020-02-23,경기,서울,95095,1626,3900,1076,701,5331,107729,106415,1821,3928,1104,723,6137,120128
2020-02-23,경기,세종,25,1,0,0,0,0,26,52,0,0,4,1,4,61
2020-02-23,경기,울산,24,0,0,2,2,1,29,32,0,2,2,5,0,41
2020-02-23,경기,전남,711,6,70,32,33,26,878,1194,9,59,53,17,25,1357
2020-02-23,경기,전북,1355,10,70,19,21,51,1526,2356,14,78,41,52,95,2636
2020-02-23,경기,충남,32568,281,1180,453,569,1553,36604,35947,286,1156,404,557,1669,40019
2020-02-23,경기,충북,22221,444,773,507,478,1132,25555,25811,440,765,469,411,1226,29122
2020-02-23,경남,강원,102,0,2,6,2,5,117,228,1,6,6,6,7,254
2020-02-23,경남,경기,2651,20,168,141,73,104,3157,2462,17,199,151,73,96,2998
2020-02-23,경남,경남,114752,2324,2819,969,1741,7420,130025,114752,2324,2819,969,1741,7420,130025
2020-02-23,경남,경북,8353,138,305,153,256,410,9615,9816,207,365,255,291,500,11434
2020-02-23,경남,광주,1182,18,66,27,3,35,1331,1269,11,64,25,11,45,1425
2020-02-23,경남,대구,10046,151,330,252,289,461,11529,5840,98,258,92,54,256,6598
2020-02-23,경남,대전,934,8,73,25,15,40,1095,1237,11,83,9,6,54,1400
2020-02-23,경남,부산,55819,654,1356,270,729,3458,62286,55187,710,1346,217,702,3487,61649
2020-02-23,경남,서울,2405,32,450,132,53,66,3138,2643,27,453,43,18,81,3265
2020-02-23,경남,세종,282,2,6,1,2,9,302,276,1,13,2,3,15,310
2020-02-23,경남,울산,8083,156,244,43,51,476,9053,7467,138,256,31,72,452,8416
2020-02-23,경남,전남,5409,62,165,100,150,235,6121,5632,71,148,96,161,250,6358
2020-02-23,경남,전북,1312,16,56,27,13,58,1482,1443,13,58,16,19,57,1606
2020-02-23,경남,충남,1377,18,31,40,33,78,1577,1464,14,45,53,49,62,1687
2020-02-23,경남,충북,1341,9,43,59,45,57,1554,1428,13,73,112,71,59,1756
2020-02-23,경북,강원,346,9,19,8,5,12,399,487,15,24,3,2,15,546
2020-02-23,경북,경기,3914,38,149,188,84,156,4529,3115,30,181,143,74,112,3655
2020-02-23,경북,경남,9816,207,365,255,291,500,11434,8353,138,305,153,256,410,9615
2020-02-23,경북,경북,42521,894,1136,501,581,2087,47720,42521,894,1136,501,581,2087,47720
2020-02-23,경북,광주,578,14,44,44,13,25,718,792,10,34,46,16,24,922
2020-02-23,경북,대구,34637,607,815,281,750,1564,38654,35331,615,1026,297,825,1589,39683
2020-02-23,경북,대전,1475,8,58,29,20,83,1673,1621,12,52,16,6,71,1778
2020-02-23,경북,부산,4263,26,190,29,74,179,4761,4872,36,212,26,103,216,5465
2020-02-23,경북,서울,2908,22,281,136,27,97,3471,2502,23,251,34,23,91,2924
2020-02-23,경북,세종,247,0,7,5,2,15,276,229,0,7,7,0,11,254
2020-02-23,경북,울산,4238,32,96,60,188,190,4804,3837,20,95,34,189,171,4346
2020-02-23,경북,전남,851,20,35,23,71,36,1036,828,13,25,15,66,38,985
2020-02-23,경북,전북,1304,22,50,24,38,33,1471,1526,26,38,40,93,46,1769
2020-02-23,경북,충남,2806,25,53,59,78,111,3132,2576,22,78,65,84,110,2935
2020-02-23,경북,충북,4108,48,142,176,172,198,4844,3981,52,146,145,124,179,4627
2020-02-23,광주,강원,83,1,15,1,1,2,103,122,0,17,3,0,3,145
2020-02-23,광주,경기,1022,4,75,31,14,42,1188,742,10,93,30,10,20,905
2020-02-23,광주,경남,1269,11,64,25,11,45,1425,1182,18,66,27,3,35,1331
2020-02-23,광주,경북,792,10,34,46,16,24,922,578,14,44,44,13,25,718
2020-02-23,광주,광주,8886,139,406,70,28,329,9858,8886,139,406,70,28,329,9858
2020-02-23,광주,대구,382,8,19,36,3,16,464,317,7,29,17,6,8,384
2020-02-23,광주,대전,475,1,7,4,5,14,506,467,0,7,1,4,20,499
2020-02-23,광주,부산,511,3,44,8,8,14,588,595,1,40,11,9,15,671
2020-02-23,광주,서울,1004,9,18,20,8,37,1096,747,7,11,6,4,24,799
2020-02-23,광주,세종,221,0,1,0,1,9,232,181,0,1,0,0,5,187
2020-02-23,광주,울산,77,1,4,0,1,6,89,46,0,7,0,1,3,57
2020-02-23,광주,전남,28885,265,708,185,126,996,31165,29351,246,600,262,126,1027,31612
2020-02-23,광주,전북,6772,82,162,56,45,212,7329,7002,88,183,62,42,212,7589
2020-02-23,광주,충남,5361,51,472,139,76,169,6268,4337,36,487,110,40,125,5135
2020-02-23,광주,충북,662,9,27,25,11,23,757,643,7,33,39,15,15,752
2020-02-23,대구,강원,194,4,13,1,0,4,216,282,1,6,4,2,5,300
2020-02-23,대구,경기,2186,23,105,95,44,83,2536,1418,15,99,95,28,39,1694
2020-02-23,대구,경남,5840,98,258,92,54,256,6598,10046,151,330,252,289,461,11529
2020-02-23,대구,경북,35331,615,1026,297,825,1589,39683,34637,607,815,281,750,1564,38654
2020-02-23,대구,광주,317,7,29,17,6,8,384,382,8,19,36,3,16,464
2020-02-23,대구,대구,21192,430,422,134,173,1205,23556,21192,430,422,134,173,1205,23556
2020-02-23,대구,대전,703,9,21,9,6,38,786,463,7,11,13,0,24,518
2020-02-23,대구,부산,371,6,19,10,7,12,425,2712,16,95,19,25,114,2981
2020-02-23,대구,서울,2109,25,120,49,16,50,2369,1509,15,95,15,6,41,1681
2020-02-23,대구,세종,251,0,8,0,2,11,272,145,0,1,0,0,1,147
2020-02-23,대구,울산,749,7,59,6,43,34,898,853,9,64,10,49,30,1015
2020-02-23,대구,전남,374,4,19,3,16,11,427,519,5,14,10,19,17,584
2020-02-23,대구,전북,229,4,20,3,3,7,266,252,3,22,4,4,4,289
2020-02-23,대구,충남,1055,9,24,22,36,44,1190,604,7,21,26,21,22,701
2020-02-23,대구,충북,1259,21,95,69,53,44,1541,968,18,59,41,27,33,1146
2020-02-23,대전,강원,193,2,26,1,0,8,230,253,2,24,0,0,16,295
2020-02-23,대전,경기,2601,22,128,16,5,163,2935,1903,8,138,11,4,109,2173
2020-02-23,대전,경남,1237,11,83,9,6,54,1400,934,8,73,25,15,40,1095
2020-02-23,대전,경북,1621,12,52,16,6,71,1778,1475,8,58,29,20,83,1673
2020-02-23,대전,광주,467,0,7,1,4,20,499,475,1,7,4,5,14,506
2020-02-23,대전,대구,463,7,11,13,0,24,518,703,9,21,9,6,38,786
2020-02-23,대전,대전,7396,94,132,43,11,506,8182,7396,94,132,43,11,506,8182
2020-02-23,대전,부산,110,0,2,4,2,10,128,145,2,2,2,2,5,158
2020-02-23,대전,서울,2232,8,216,6,0,109,2571,1687,15,215,1,0,64,1982
2020-02-23,대전,세종,1793,55,26,0,4,115,1993,1556,43,27,6,6,99,1737
2020-02-23,대전,울산,155,0,10,2,8,7,182,120,0,9,2,5,7,143
2020-02-23,대전,전남,389,0,3,4,2,7,405,158,0,2,2,1,5,168
2020-02-23,대전,전북,2843,16,46,6,11,118,3040,3469,29,49,15,16,142,3720
2020-02-23,대전,충남,10088,120,208,36,34,552,11038,9352,118,224,45,40,497,10276
2020-02-23,대전,충북,6947,140,222,30,16,435,7790,6379,101,214,23,15,409,7141
2020-02-23,부산,강원,9,0,1,0,0,0,10,5,0,1,0,0,0,6
2020-02-23,부산,경기,482,9,11,26,30,28,586,245,4,11,29,11,9,309
2020-02-23,부산,경남,55187,710,1346,217,702,3487,61649,55819,654,1356,270,729,3458,62286
2020-02-23,부산,경북,4872,36,212,26,103,216,5465,4263,26,190,29,74,179,4761
2020-02-23,부산,광주,595,1,40,11,9,15,671,511,3,44,8,8,14,588
2020-02-23,부산,대구,2712,16,95,19,25,114,2981,371,6,19,10,7,12,425
2020-02-23,부산,대전,145,2,2,2,2,5,158,110,0,2,4,2,10,128
2020-02-23,부산,부산,30677,171,180,92,502,1762,33384,30677,171,180,92,502,1762,33384
2020-02-23,부산,서울,424,3,13,33,13,22,508,322,5,8,8,2,8,353
2020-02-23,부산,세종,48,0,1,1,0,0,50,25,0,0,0,1,0,26
2020-02-23,부산,울산,13492,59,105,84,478,839,15057,12280,74,62,39,372,784,13611
2020-02-23,부산,전남,2115,20,73,44,130,89,2471,1951,17,72,82,129,68,2319
2020-02-23,부산,전북,388,0,38,2,13,21,462,351,1,41,8,7,15,423
2020-02-23,부산,충남,280,5,8,8,14,12,327,163,0,8,9,8,6,194
2020-02-23,부산,충북,207,0,6,8,28,6,255,113,1,3,24,4,1,146
2020-02-23,서울,강원,792,4,239,0,4,31,1070,1428,7,324,5,3,44,1811
2020-02-23,서울,경기,106415,1821,3928,1104,723,6137,120128,95095,1626,3900,1076,701,5331,107729
2020-02-23,서울,경남,2643,27,453,43,18,81,3265,2405,32,450,132,53,66,3138
2020-02-23,서울,경북,2502,23,251,34,23,91,2924,2908,22,281,136,27,97,3471
2020-02-23,서울,광주,747,7,11,6,4,24,799,1004,9,18,20,8,37,1096
2020-02-23,서울,대구,1509,15,95,15,6,41,1681,2109,25,120,49,16,50,2369
2020-02-23,서울,대전,1687,15,215,1,0,64,1982,2232,8,216,6,0,109,2571
2020-02-23,서울,부산,322,5,8,8,2,8,353,424,3,13,33,13,22,508
2020-02-23,서울,서울,184,4,11,1,3,5,208,184,4,11,1,3,5,208
2020-02-23,서울,세종,28,0,0,1,0,3,32,30,1,0,0,0,2,33
2020-02-23,서울,울산,34,0,1,0,0,0,35,27,0,4,0,1,2,34
2020-02-23,서울,전남,909,4,10,16,38,18,995,1376,10,22,52,34,40,1534
2020-02-23,서울,전북,1328,5,36,1,5,34,1409,2165,11,39,18,27,66,2326
2020-02-23,서울,충남,30255,153,1965,207,161,1238,33979,33360,197,1935,567,277,1257,37593
2020-02-23,서울,충북,13608,119,797,196,111,577,15408,13822,125,810,202,104,556,15619
2020-02-23,세종,강원,7,0,1,0,1,0,9,8,0,0,0,0,1,9
2020-02-23,세종,경기,52,0,0,4,1,4,61,25,1,0,0,0,0,26
2020-02-23,세종,경남,276,1,13,2,3,15,310,282,2,6,1,2,9,302
2020-02-23,세종,경북,229,0,7,7,0,11,254,247,0,7,5,2,15,276
2020-02-23,세종,광주,181,0,1,0,0,5,187,221,0,1,0,1,9,232
2020-02-23,세종,대구,145,0,1,0,0,1,147,251,0,8,0,2,11,272
2020-02-23,세종,대전,1556,43,27,6,6,99,1737,1793,55,26,0,4,115,1993
2020-02-23,세종,부산,25,0,0,0,1,0,26,48,0,1,1,0,0,50
2020-02-23,세종,서울,30,1,0,0,0,2,33,28,0,0,1,0,3,32
2020-02-23,세종,세종,148,6,0,0,0,13,167,148,6,0,0,0,13,167
2020-02-23,세종,울산,11,0,0,0,0,0,11,12,0,0,0,0,0,12
2020-02-23,세종,전남,176,1,2,0,1,5,185,157,0,2,5,0,4,168
2020-02-23,세종,전북,609,0,8,5,9,27,658,878,1,6,5,5,38,933
2020-02-23,세종,충남,4291,47,69,22,18,209,4656,3837,44,69,33,19,180,4182
2020-02-23,세종,충북,218,4,4,2,3,20,251,221,7,2,0,2,20,252
2020-02-23,울산,강원,2,0,0,0,0,0,2,2,0,0,0,0,0,2
2020-02-23,울산,경기,32,0,2,2,5,0,41,24,0,0,2,2,1,29
2020-02-23,울산,경남,7467,138,256,31,72,452,8416,8083,156,244,43,51,476,9053
2020-02-23,울산,경북,3837,20,95,34,189,171,4346,4238,32,96,60,188,190,4804
2020-02-23,울산,광주,46,0,7,0,1,3,57,77,1,4,0,1,6,89
2020-02-23,울산,대구,853,9,64,10,49,30,1015,749,7,59,6,43,34,898
2020-02-23,울산,대전,120,0,9,2,5,7,143,155,0,10,2,8,7,182
2020-02-23,울산,부산,12280,74,62,39,372,784,13611,13492,59,105,84,478,839,15057
2020-02-23,울산,서울,27,0,4,0,1,2,34,34,0,1,0,0,0,35
2020-02-23,울산,세종,12,0,0,0,0,0,12,11,0,0,0,0,0,11
2020-02-23,울산,울산,4048,39,95,27,60,322,4591,4048,39,95,27,60,322,4591
2020-02-23,울산,전남,233,1,4,0,5,8,251,231,1,2,4,1,5,244
2020-02-23,울산,전북,49,0,6,0,5,0,60,64,0,6,1,2,5,78
2020-02-23,울산,충남,165,0,4,4,22,7,202,140,0,3,7,21,7,178
2020-02-23,울산,충북,19,2,2,1,6,1,31,11,1,0,1,5,0,18
2020-02-23,전남,강원,21,0,1,0,1,0,23,63,2,3,0,3,1,72
2020-02-23,전남,경기,1194,9,59,53,17,25,1357,711,6,70,32,33,26,878
2020-02-23,전남,경남,5632,71,148,96,161,250,6358,5409,62,165,100,150,235,6121
2020-02-23,전남,경북,828,13,25,15,66,38,985,851,20,35,23,71,36,1036
2020-02-23,전남,광주,29351,246,600,262,126,1027,31612,28885,265,708,185,126,996,31165
2020-02-23,전남,대구,519,5,14,10,19,17,584,374,4,19,3,16,11,427
2020-02-23,전남,대전,158,0,2,2,1,5,168,389,0,3,4,2,7,405
2020-02-23,전남,부산,1951,17,72,82,129,68,2319,2115,20,73,44,130,89,2471
2020-02-23,전남,서울,1376,10,22,52,34,40,1534,909,4,10,16,38,18,995
2020-02-23,전남,세종,157,0,2,5,0,4,168,176,1,2,0,1,5,185
2020-02-23,전남,울산,231,1,2,4,1,5,244,233,1,4,0,5,8,251
2020-02-23,전남,전남,40481,433,756,623,941,1452,44686,40481,433,756,623,941,1452,44686
2020-02-23,전남,전북,10067,134,309,324,766,269,11869,5068,73,181,134,250,156,5862
2020-02-23,전남,충남,2926,31,168,353,121,57,3656,4641,35,365,102,220,150,5513
2020-02-23,전남,충북,177,4,2,29,6,8,226,417,3,19,18,49,15,521
2020-02-23,전북,강원,216,3,4,17,3,10,253,192,0,5,2,2,8,209
2020-02-23,전북,경기,2356,14,78,41,52,95,2636,1355,10,70,19,21,51,1526
2020-02-23,전북,경남,1443,13,58,16,19,57,1606,1312,16,56,27,13,58,1482
2020-02-23,전북,경북,1526,26,38,40,93,46,1769,1304,22,50,24,38,33,1471
2020-02-23,전북,광주,7002,88,183,62,42,212,7589,6772,82,162,56,45,212,7329
2020-02-23,전북,대구,252,3,22,4,4,4,289,229,4,20,3,3,7,266
2020-02-23,전북,대전,3469,29,49,15,16,142,3720,2843,16,46,6,11,118,3040
2020-02-23,전북,부산,351,1,41,8,7,15,423,388,0,38,2,13,21,462
2020-02-23,전북,서울,2165,11,39,18,27,66,2326,1328,5,36,1,5,34,1409
2020-02-23,전북,세종,878,1,6,5,5,38,933,609,0,8,5,9,27,658
2020-02-23,전북,울산,64,0,6,1,2,5,78,49,0,6,0,5,0,60
2020-02-23,전북,전남,5068,73,181,134,250,156,5862,10067,134,309,324,766,269,11869
2020-02-23,전북,전북,12035,150,351,111,254,416,13317,12035,150,351,111,254,416,13317
2020-02-23,전북,충남,20674,170,1050,349,628,658,23529,12918,123,863,151,215,461,14731
2020-02-23,전북,충북,2340,38,47,143,83,79,2730,1608,40,65,67,38,66,1884
2020-02-23,충남,강원,438,1,16,7,20,22,504,482,2,14,4,21,20,543
2020-02-23,충남,경기,35947,286,1156,404,557,1669,40019,32568,281,1180,453,569,1553,36604
2020-02-23,충남,경남,1464,14,45,53,49,62,1687,1377,18,31,40,33,78,1577
2020-02-23,충남,경북,2576,22,78,65,84,110,2935,2806,25,53,59,78,111,3132
2020-02-23,충남,광주,4337,36,487,110,40,125,5135,5361,51,472,139,76,169,6268
2020-02-23,충남,대구,604,7,21,26,21,22,701,1055,9,24,22,36,44,1190
2020-02-23,충남,대전,9352,118,224,45,40,497,10276,10088,120,208,36,34,552,11038
2020-02-23,충남,부산,163,0,8,9,8,6,194,280,5,8,8,14,12,327
2020-02-23,충남,서울,33360,197,1935,567,277,1257,37593,30255,153,1965,207,161,1238,33979
2020-02-23,충남,세종,3837,44,69,33,19,180,4182,4291,47,69,22,18,209,4656
2020-02-23,충남,울산,140,0,3,7,21,7,178,165,0,4,4,22,7,202
2020-02-23,충남,전남,4641,35,365,102,220,150,5513,2926,31,168,353,121,57,3656
2020-02-23,충남,전북,12918,123,863,151,215,461,14731,20674,170,1050,349,628,658,23529
2020-02-23,충남,충남,86862,897,4086,1411,1860,3592,98708,86862,897,4086,1411,1860,3592,98708
2020-02-23,충남,충북,8486,147,277,225,238,447,9820,8016,134,293,189,278,399,9309
2020-02-23,충북,강원,3779,60,118,33,48,225,4263,4561,77,123,39,54,201,5055
2020-02-23,충북,경기,25811,440,765,469,411,1226,29122,22221,444,773,507,478,1132,25555
2020-02-23,충북,경남,1428,13,73,112,71,59,1756,1341,9,43,59,45,57,1554
2020-02-23,충북,경북,3981,52,146,145,124,179,4627,4108,48,142,176,172,198,4844
2020-02-23,충북,광주,643,7,33,39,15,15,752,662,9,27,25,11,23,757
2020-02-23,충북,대구,968,18,59,41,27,33,1146,1259,21,95,69,53,44,1541
2020-02-23,충북,대전,6379,101,214,23,15,409,7141,6947,140,222,30,16,435,7790
2020-02-23,충북,부산,113,1,3,24,4,1,146,207,0,6,8,28,6,255
2020-02-23,충북,서울,13822,125,810,202,104,556,15619,13608,119,797,196,111,577,15408
2020-02-23,충북,세종,221,7,2,0,2,20,252,218,4,4,2,3,20,251
2020-02-23,충북,울산,11,1,0,1,5,0,18,19,2,2,1,6,1,31
2020-02-23,충북,전남,417,3,19,18,49,15,521,177,4,2,29,6,8,226
2020-02-23,충북,전북,1608,40,65,67,38,66,1884,2340,38,47,143,83,79,2730
2020-02-23,충북,충남,8016,134,293,189,278,399,9309,8486,147,277,225,238,447,9820
2020-02-23,충북,충북,24364,449,611,439,392,1274,27529,24364,449,611,439,392,1274,27529
2020-02-24,강원,강원,55531,2096,2845,1140,2281,3848,67741,55531,2096,2845,1140,2281,3848,67741
2020-02-24,강원,경기,19905,570,1154,604,678,932,23843,17409,572,1147,616,747,885,21376
2020-02-24,강원,경남,163,4,9,14,14,5,209,92,0,6,27,14,6,145
2020-02-24,강원,경북,308,14,25,18,22,14,401,265,13,23,31,28,19,379
2020-02-24,강원,광주,84,2,21,7,4,2,120,86,2,13,5,9,1,116
2020-02-24,강원,대구,131,3,11,8,10,4,167,192,4,21,20,20,7,264
2020-02-24,강원,대전,129,2,28,6,0,3,168,155,4,29,5,0,8,201
2020-02-24,강원,부산,2,0,0,0,3,0,5,0,1,0,1,2,0,4
2020-02-24,강원,서울,621,9,249,11,22,27,939,634,12,196,16,12,26,896
2020-02-24,강원,세종,8,0,0,1,0,0,9,11,0,0,0,2,0,13
2020-02-24,강원,울산,1,0,0,0,1,0,2,1,0,0,0,0,0,1
2020-02-24,강원,전남,36,1,2,2,10,1,52,14,0,3,2,6,0,25
2020-02-24,강원,전북,120,1,8,6,13,4,152,148,6,13,12,30,9,218
2020-02-24,강원,충남,352,8,12,19,43,24,458,411,9,21,32,57,16,546
2020-02-24,강원,충북,4224,222,286,234,354,254,5574,4082,210,249,163,327,242,5273
2020-02-24,경기,강원,17409,572,1147,616,747,885,21376,19905,570,1154,604,678,932,23843
2020-02-24,경기,경기,409569,22823,24320,18407,22800,30873,528792,409569,22823,24320,18407,22800,30873,528792
2020-02-24,경기,경남,2324,60,301,427,392,84,3588,1858,65,228,429,323,73,2976
2020-02-24,경기,경북,3144,180,469,561,507,110,4971,3035,154,439,864,525,122,5139
2020-02-24,경기,광주,702,36,163,223,113,18,1255,755,27,135,201,94,17,1229
2020-02-24,경기,대구,1224,74,158,257,171,36,1920,2087,92,182,341,391,80,3173
2020-02-24,경기,대전,1778,95,216,80,36,78,2283,2249,105,201,86,63,99,2803
2020-02-24,경기,부산,238,13,27,72,118,9,477,302,16,35,101,197,11,662
2020-02-24,경기,서울,137321,7033,8771,4510,3471,9283,170389,146901,6799,9101,4771,3167,9935,180674
2020-02-24,경기,세종,36,4,2,0,2,1,45,48,4,3,4,6,3,68
2020-02-24,경기,울산,21,3,1,5,5,1,36,47,0,5,15,48,1,116
2020-02-24,경기,전남,689,19,101,140,115,14,1078,619,15,75,104,75,18,906
2020-02-24,경기,전북,1120,44,163,119,151,44,1641,1344,41,158,184,213,43,1983
2020-02-24,경기,충남,36872,1509,2754,2276,4138,1998,49547,34119,1439,2661,2091,4000,1870,46180
2020-02-24,경기,충북,27026,2156,2910,2924,3261,1349,39626,25252,2094,2725,2740,3597,1324,37732
2020-02-24,경남,강원,92,0,6,27,14,6,145,163,4,9,14,14,5,209
2020-02-24,경남,경기,1858,65,228,429,323,73,2976,2324,60,301,427,392,84,3588
2020-02-24,경남,경남,171858,10043,9693,7180,13186,12988,224948,171858,10043,9693,7180,13186,12988,224948
2020-02-24,경남,경북,7980,633,935,885,1807,371,12611,9132,836,1132,1062,2493,429,15084
2020-02-24,경남,광주,899,43,113,150,124,21,1350,1017,43,116,148,87,22,1433
2020-02-24,경남,대구,9598,686,825,1000,1565,378,14052,6850,462,641,450,484,275,9162
2020-02-24,경남,대전,628,16,93,69,23,27,856,873,19,99,68,47,34,1140
2020-02-24,경남,부산,75741,2650,2760,2010,4708,5398,93267,78019,2779,3028,2151,5101,5528,96606
2020-02-24,경남,서울,1764,35,405,224,114,51,2593,2368,41,424,99,81,75,3088
2020-02-24,경남,세종,155,6,8,12,4,3,188,219,9,18,10,9,10,275
2020-02-24,경남,울산,8686,627,705,489,617,561,11685,8101,574,747,411,628,514,10975
2020-02-24,경남,전남,5378,247,525,443,1318,258,8169,5182,244,439,416,1237,229,7747
2020-02-24,경남,전북,1021,48,117,97,163,34,1480,990,40,107,85,131,38,1391
2020-02-24,경남,충남,1094,56,110,225,224,50,1759,1356,51,143,222,409,55,2236
2020-02-24,경남,충북,1029,49,125,251,273,28,1755,1102,68,194,360,498,36,2258
2020-02-24,경북,강원,265,13,23,31,28,19,379,308,14,25,18,22,14,401
2020-02-24,경북,경기,3035,154,439,864,525,122,5139,3144,180,469,561,507,110,4971
2020-02-24,경북,경남,9132,836,1132,1062,2493,429,15084,7980,633,935,885,1807,371,12611
2020-02-24,경북,경북,56519,3623,3986,2850,4474,3111,74563,56519,3623,3986,2850,4474,3111,74563
2020-02-24,경북,광주,589,49,113,160,107,18,1036,656,35,83,156,66,18,1014
2020-02-24,경북,대구,54030,2765,2529,1507,3283,2958,67072,59096,2937,2905,1936,3816,3024,73714
2020-02-24,경북,대전,1333,59,105,90,64,53,1704,1541,41,99,94,54,73,1902
2020-02-24,경북,부산,3123,108,287,157,624,139,4438,3790,123,320,208,717,166,5324
2020-02-24,경북,서울,1983,94,300,286,116,61,2840,2192,80,287,178,75,86,2898
2020-02-24,경북,세종,232,8,14,21,24,12,311,241,7,13,14,13,10,298
2020-02-24,경북,울산,3884,159,312,390,994,199,5938,3953,149,325,353,1335,216,6331
2020-02-24,경북,전남,694,41,71,103,414,24,1347,642,41,65,71,236,21,1076
2020-02-24,경북,전북,1511,84,206,179,231,52,2263,1381,93,198,154,455,47,2328
2020-02-24,경북,충남,2564,110,307,497,516,97,4091,2622,114,307,393,597,93,4126
2020-02-24,경북,충북,3826,221,506,721,1044,148,6466,3755,231,531,582,1084,145,6328
2020-02-24,광주,강원,86,2,13,5,9,1,116,84,2,21,7,4,2,120
2020-02-24,광주,경기,755,27,135,201,94,17,1229,702,36,163,223,113,18,1255
2020-02-24,광주,경남,1017,43,116,148,87,22,1433,899,43,113,150,124,21,1350
2020-02-24,광주,경북,656,35,83,156,66,18,1014,589,49,113,160,107,18,1036
2020-02-24,광주,광주,12168,423,612,372,307,510,14392,12168,423,612,372,307,510,14392
2020-02-24,광주,대구,374,19,62,90,21,7,573,400,27,68,78,23,12,608
2020-02-24,광주,대전,403,20,16,10,10,13,472,479,20,19,17,13,10,558
2020-02-24,광주,부산,323,11,33,27,82,9,485,357,12,34,58,107,12,580
2020-02-24,광주,서울,574,16,18,55,22,12,697,690,20,23,23,20,27,803
2020-02-24,광주,세종,161,2,9,2,1,4,179,168,7,7,5,4,5,196
2020-02-24,광주,울산,53,3,6,1,2,2,67,42,3,7,5,9,1,67
2020-02-24,광주,전남,32081,930,1141,656,1918,1273,37999,29125,912,1008,575,1839,1209,34668
2020-02-24,광주,전북,7409,368,524,356,384,275,9316,7119,399,490,296,383,284,8971
2020-02-24,광주,충남,3890,127,501,441,231,108,5298,3877,120,485,468,251,116,5317
2020-02-24,광주,충북,556,28,59,106,51,16,816,550,16,87,147,58,13,871
2020-02-24,대구,강원,192,4,21,20,20,7,264,131,3,11,8,10,4,167
2020-02-24,대구,경기,2087,92,182,341,391,80,3173,1224,74,158,257,171,36,1920
2020-02-24,대구,경남,6850,462,641,450,484,275,9162,9598,686,825,1000,1565,378,14052
2020-02-24,대구,경북,59096,2937,2905,1936,3816,3024,73714,54030,2765,2529,1507,3283,2958,67072
2020-02-24,대구,광주,400,27,68,78,23,12,608,374,19,62,90,21,7,573
2020-02-24,대구,대구,50099,2107,1723,852,1202,3297,59280,50099,2107,1723,852,1202,3297,59280
2020-02-24,대구,대전,673,33,39,49,26,22,842,402,21,23,41,21,15,523
2020-02-24,대구,부산,450,58,110,56,116,9,799,2178,100,205,86,209,81,2859
2020-02-24,대구,서울,1994,54,108,138,79,63,2436,1263,43,83,81,33,47,1550
2020-02-24,대구,세종,191,3,9,4,8,9,224,126,0,4,1,4,5,140
2020-02-24,대구,울산,833,41,109,67,149,30,1229,780,50,107,53,150,30,1170
2020-02-24,대구,전남,298,10,39,27,51,17,442,285,14,38,33,54,16,440
2020-02-24,대구,전북,240,12,20,22,24,7,325,199,12,20,16,18,6,271
2020-02-24,대구,충남,1181,56,125,176,221,31,1790,618,54,95,138,114,25,1044
2020-02-24,대구,충북,1245,81,166,235,328,40,2095,805,71,125,173,119,26,1319
2020-02-24,대전,강원,155,4,29,5,0,8,201,129,2,28,6,0,3,168
2020-02-24,대전,경기,2249,105,201,86,63,99,2803,1778,95,216,80,36,78,2283
2020-02-24,대전,경남,873,19,99,68,47,34,1140,628,16,93,69,23,27,856
2020-02-24,대전,경북,1541,41,99,94,54,73,1902,1333,59,105,90,64,53,1704
2020-02-24,대전,광주,479,20,19,17,13,10,558,403,20,16,10,10,13,472
2020-02-24,대전,대구,402,21,23,41,21,15,523,673,33,39,49,26,22,842
2020-02-24,대전,대전,12892,417,374,237,100,966,14986,12892,417,374,237,100,966,14986
2020-02-24,대전,부산,87,2,5,10,9,7,120,87,6,4,13,7,2,119
2020-02-24,대전,서울,1750,39,182,30,9,53,2063,1678,44,176,25,9,68,2000
2020-02-24,대전,세종,3220,96,89,31,46,279,3761,3267,95,74,40,43,271,3790
2020-02-24,대전,울산,114,5,11,14,22,4,170,96,2,14,8,24,3,147
2020-02-24,대전,전남,297,7,1,16,19,7,347,103,3,6,8,5,3,128
2020-02-24,대전,전북,2804,65,79,52,46,113,3159,2783,80,73,69,77,108,3190
2020-02-24,대전,충남,15604,488,533,283,271,1122,18301,13100,472,478,272,248,989,15559
2020-02-24,대전,충북,10392,413,447,183,184,754,12373,9048,380,373,147,135,678,10761
2020-02-24,부산,강원,0,1,0,1,2,0,4,2,0,0,0,3,0,5
2020-02-24,부산,경기,302,16,35,101,197,11,662,238,13,27,72,118,9,477
2020-02-24,부산,경남,78019,2779,3028,2151,5101,5528,96606,75741,2650,2760,2010,4708,5398,93267
2020-02-24,부산,경북,3790,123,320,208,717,166,5324,3123,108,287,157,624,139,4438
2020-02-24,부산,광주,357,12,34,58,107,12,580,323,11,33,27,82,9,485
2020-02-24,부산,대구,2178,100,205,86,209,81,2859,450,58,110,56,116,9,799
2020-02-24,부산,대전,87,6,4,13,7,2,119,87,2,5,10,9,7,120
2020-02-24,부산,부산,35611,735,666,989,2096,2500,42597,35611,735,666,989,2096,2500,42597
2020-02-24,부산,서울,268,11,13,72,33,9,406,232,6,12,28,31,6,315
2020-02-24,부산,세종,26,0,1,2,1,2,32,29,0,0,0,0,2,31
2020-02-24,부산,울산,14733,407,472,692,2650,1030,19984,13420,410,389,408,2502,987,18116
2020-02-24,부산,전남,1925,92,121,186,554,87,2965,1522,78,107,156,602,58,2523
2020-02-24,부산,전북,302,6,18,32,81,10,449,194,5,23,28,51,7,308
2020-02-24,부산,충남,199,8,19,62,126,10,424,133,10,13,37,127,4,324
2020-02-24,부산,충북,150,8,22,73,155,4,412,103,11,12,77,164,4,371
2020-02-24,서울,강원,634,12,196,16,12,26,896,621,9,249,11,22,27,939
2020-02-24,서울,경기,146901,6799,9101,4771,3167,9935,180674,137321,7033,8771,4510,3471,9283,170389
2020-02-24,서울,경남,2368,41,424,99,81,75,3088,1764,35,405,224,114,51,2593
2020-02-24,서울,경북,2192,80,287,178,75,86,2898,1983,94,300,286,116,61,2840
2020-02-24,서울,광주,690,20,23,23,20,27,803,574,16,18,55,22,12,697
2020-02-24,서울,대구,1263,43,83,81,33,47,1550,1994,54,108,138,79,63,2436
2020-02-24,서울,대전,1678,44,176,25,9,68,2000,1750,39,182,30,9,53,2063
2020-02-24,서울,부산,232,6,12,28,31,6,315,268,11,13,72,33,9,406
2020-02-24,서울,서울,198,6,8,2,2,8,224,198,6,8,2,2,8,224
2020-02-24,서울,세종,33,0,0,0,0,2,35,34,0,1,0,0,3,38
2020-02-24,서울,울산,29,1,0,0,1,2,33,24,2,6,3,10,0,45
2020-02-24,서울,전남,736,12,22,34,40,32,876,678,13,16,64,28,18,817
2020-02-24,서울,전북,1060,17,49,16,29,32,1203,1133,23,34,33,37,45,1305
2020-02-24,서울,충남,26699,500,2211,709,653,1167,31939,24178,606,2196,1116,1031,1018,30145
2020-02-24,서울,충북,14247,520,1054,667,642,636,17766,11922,592,1084,748,777,585,15708
2020-02-24,세종,강원,11,0,0,0,2,0,13,8,0,0,1,0,0,9
2020-02-24,세종,경기,48,4,3,4,6,3,68,36,4,2,0,2,1,45
2020-02-24,세종,경남,219,9,18,10,9,10,275,155,6,8,12,4,3,188
2020-02-24,세종,경북,241,7,13,14,13,10,298,232,8,14,21,24,12,311
2020-02-24,세종,광주,168,7,7,5,4,5,196,161,2,9,2,1,4,179
2020-02-24,세종,대구,126,0,4,1,4,5,140,191,3,9,4,8,9,224
2020-02-24,세종,대전,3267,95,74,40,43,271,3790,3220,96,89,31,46,279,3761
2020-02-24,세종,부산,29,0,0,0,0,2,31,26,0,1,2,1,2,32
2020-02-24,세종,서울,34,0,1,0,0,3,38,33,0,0,0,0,2,35
2020-02-24,세종,세종,182,22,3,3,1,14,225,182,22,3,3,1,14,225
2020-02-24,세종,울산,10,0,0,4,2,0,16,6,0,1,0,2,0,9
2020-02-24,세종,전남,167,3,5,10,20,2,207,99,2,4,4,10,3,122
2020-02-24,세종,전북,688,23,23,17,52,28,831,622,20,22,15,63,19,761
2020-02-24,세종,충남,5887,172,169,102,153,307,6790,3862,134,143,96,122,220,4577
2020-02-24,세종,충북,291,14,17,16,25,27,390,256,20,26,15,16,27,360
2020-02-24,울산,강원,1,0,0,0,0,0,1,1,0,0,0,1,0,2
2020-02-24,울산,경기,47,0,5,15,48,1,116,21,3,1,5,5,1,36
2020-02-24,울산,경남,8101,574,747,411,628,514,10975,8686,627,705,489,617,561,11685
2020-02-24,울산,경북,3953,149,325,353,1335,216,6331,3884,159,312,390,994,199,5938
2020-02-24,울산,광주,42,3,7,5,9,1,67,53,3,6,1,2,2,67
2020-02-24,울산,대구,780,50,107,53,150,30,1170,833,41,109,67,149,30,1229
2020-02-24,울산,대전,96,2,14,8,24,3,147,114,5,11,14,22,4,170
2020-02-24,울산,부산,13420,410,389,408,2502,987,18116,14733,407,472,692,2650,1030,19984
2020-02-24,울산,서울,24,2,6,3,10,0,45,29,1,0,0,1,2,33
2020-02-24,울산,세종,6,0,1,0,2,0,9,10,0,0,4,2,0,16
2020-02-24,울산,울산,7189,316,539,288,609,659,9600,7189,316,539,288,609,659,9600
2020-02-24,울산,전남,166,12,17,18,29,4,246,174,15,22,10,45,4,270
2020-02-24,울산,전북,32,0,5,4,8,2,51,40,0,6,4,0,0,50
2020-02-24,울산,충남,107,2,16,35,135,5,300,112,2,7,33,95,3,252
2020-02-24,울산,충북,21,2,3,19,42,1,88,17,0,4,10,37,0,68
2020-02-24,전남,강원,14,0,3,2,6,0,25,36,1,2,2,10,1,52
2020-02-24,전남,경기,619,15,75,104,75,18,906,689,19,101,140,115,14,1078
2020-02-24,전남,경남,5182,244,439,416,1237,229,7747,5378,247,525,443,1318,258,8169
2020-02-24,전남,경북,642,41,65,71,236,21,1076,694,41,71,103,414,24,1347
2020-02-24,전남,광주,29125,912,1008,575,1839,1209,34668,32081,930,1141,656,1918,1273,37999
2020-02-24,전남,대구,285,14,38,33,54,16,440,298,10,39,27,51,17,442
2020-02-24,전남,대전,103,3,6,8,5,3,128,297,7,1,16,19,7,347
2020-02-24,전남,부산,1522,78,107,156,602,58,2523,1925,92,121,186,554,87,2965
2020-02-24,전남,서울,678,13,16,64,28,18,817,736,12,22,34,40,32,876
2020-02-24,전남,세종,99,2,4,4,10,3,122,167,3,5,10,20,2,207
2020-02-24,전남,울산,174,15,22,10,45,4,270,166,12,17,18,29,4,246
2020-02-24,전남,전남,42230,1271,1501,1717,4681,1756,53156,42230,1271,1501,1717,4681,1756,53156
2020-02-24,전남,전북,6818,322,699,812,2814,193,11658,4263,207,457,556,1277,118,6878
2020-02-24,전남,충남,1685,49,208,410,267,43,2662,3900,95,429,439,967,109,5939
2020-02-24,전남,충북,131,12,11,39,63,3,259,313,18,39,84,191,14,659
2020-02-24,전북,강원,148,6,13,12,30,9,218,120,1,8,6,13,4,152
2020-02-24,전북,경기,1344,41,158,184,213,43,1983,1120,44,163,119,151,44,1641
2020-02-24,전북,경남,990,40,107,85,131,38,1391,1021,48,117,97,163,34,1480
2020-02-24,전북,경북,1381,93,198,154,455,47,2328,1511,84,206,179,231,52,2263
2020-02-24,전북,광주,7119,399,490,296,383,284,8971,7409,368,524,356,384,275,9316
2020-02-24,전북,대구,199,12,20,16,18,6,271,240,12,20,22,24,7,325
2020-02-24,전북,대전,2783,80,73,69,77,108,3190,2804,65,79,52,46,113,3159
2020-02-24,전북,부산,194,5,23,28,51,7,308,302,6,18,32,81,10,449
2020-02-24,전북,서울,1133,23,34,33,37,45,1305,1060,17,49,16,29,32,1203
2020-02-24,전북,세종,622,20,22,15,63,19,761,688,23,23,17,52,28,831
2020-02-24,전북,울산,40,0,6,4,0,0,50,32,0,5,4,8,2,51
2020-02-24,전북,전남,4263,207,457,556,1277,118,6878,6818,322,699,812,2814,193,11658
2020-02-24,전북,전북,14871,613,918,648,1223,554,18827,14871,613,918,648,1223,554,18827
2020-02-24,전북,충남,14500,533,1656,1254,2369,512,20824,12177,473,1436,795,1327,463,16671
2020-02-24,전북,충북,1855,124,175,355,435,74,3018,1499,122,186,233,245,68,2353
2020-02-24,충남,강원,411,9,21,32,57,16,546,352,8,12,19,43,24,458
2020-02-24,충남,경기,34119,1439,2661,2091,4000,1870,46180,36872,1509,2754,2276,4138,1998,49547
2020-02-24,충남,경남,1356,51,143,222,409,55,2236,1094,56,110,225,224,50,1759
2020-02-24,충남,경북,2622,114,307,393,597,93,4126,2564,110,307,497,516,97,4091
2020-02-24,충남,광주,3877,120,485,468,251,116,5317,3890,127,501,441,231,108,5298
2020-02-24,충남,대구,618,54,95,138,114,25,1044,1181,56,125,176,221,31,1790
2020-02-24,충남,대전,13100,472,478,272,248,989,15559,15604,488,533,283,271,1122,18301
2020-02-24,충남,부산,133,10,13,37,127,4,324,199,8,19,62,126,10,424
2020-02-24,충남,서울,24178,606,2196,1116,1031,1018,30145,26699,500,2211,709,653,1167,31939
2020-02-24,충남,세종,3862,134,143,96,122,220,4577,5887,172,169,102,153,307,6790
2020-02-24,충남,울산,112,2,7,33,95,3,252,107,2,16,35,135,5,300
2020-02-24,충남,전남,3900,95,429,439,967,109,5939,1685,49,208,410,267,43,2662
2020-02-24,충남,전북,12177,473,1436,795,1327,463,16671,14500,533,1656,1254,2369,512,20824
2020-02-24,충남,충남,90628,3549,7606,6525,9914,4523,122745,90628,3549,7606,6525,9914,4523,122745
2020-02-24,충남,충북,12314,694,860,828,1328,754,16778,11369,638,857,777,1281,665,15587
2020-02-24,충북,강원,4082,210,249,163,327,242,5273,4224,222,286,234,354,254,5574
2020-02-24,충북,경기,25252,2094,2725,2740,3597,1324,37732,27026,2156,2910,2924,3261,1349,39626
2020-02-24,충북,경남,1102,68,194,360,498,36,2258,1029,49,125,251,273,28,1755
2020-02-24,충북,경북,3755,231,531,582,1084,145,6328,3826,221,506,721,1044,148,6466
2020-02-24,충북,광주,550,16,87,147,58,13,871,556,28,59,106,51,16,816
2020-02-24,충북,대구,805,71,125,173,119,26,1319,1245,81,166,235,328,40,2095
2020-02-24,충북,대전,9048,380,373,147,135,678,10761,10392,413,447,183,184,754,12373
2020-02-24,충북,부산,103,11,12,77,164,4,371,150,8,22,73,155,4,412
2020-02-24,충북,서울,11922,592,1084,748,777,585,15708,14247,520,1054,667,642,636,17766
2020-02-24,충북,세종,256,20,26,15,16,27,360,291,14,17,16,25,27,390
2020-02-24,충북,울산,17,0,4,10,37,0,68,21,2,3,19,42,1,88
2020-02-24,충북,전남,313,18,39,84,191,14,659,131,12,11,39,63,3,259
2020-02-24,충북,전북,1499,122,186,233,245,68,2353,1855,124,175,355,435,74,3018
2020-02-24,충북,충남,11369,638,857,777,1281,665,15587,12314,694,860,828,1328,754,16778
2020-02-24,충북,충북,32782,1824,2235,2059,2836,2029,43765,32782,1824,2235,2059,2836,2029,43765
2020-02-25,강원,강원,44007,1881,2553,1184,1863,3176,54664,44007,1881,2553,1184,1863,3176,54664
2020-02-25,강원,경기,13323,519,1026,635,619,663,16785,12560,577,1042,639,672,656,16146
2020-02-25,강원,경남,91,3,10,13,17,4,138,56,3,7,25,15,4,110
2020-02-25,강원,경북,228,15,17,17,23,8,308,192,8,19,31,24,13,287
2020-02-25,강원,광주,59,3,15,16,4,2,99,59,4,10,15,5,4,97
2020-02-25,강원,대구,109,1,4,11,7,0,132,159,4,12,7,20,2,204
2020-02-25,강원,대전,109,3,26,6,0,5,149,88,5,25,4,1,3,126
2020-02-25,강원,부산,6,1,2,1,1,0,11,3,0,1,1,3,1,9
2020-02-25,강원,서울,440,11,233,7,17,17,725,463,18,183,13,14,23,714
2020-02-25,강원,세종,3,0,0,0,0,0,3,4,1,0,2,1,0,8
2020-02-25,강원,울산,1,0,0,0,1,0,2,2,0,0,0,1,0,3
2020-02-25,강원,전남,20,1,1,8,9,2,41,13,1,1,1,3,0,19
2020-02-25,강원,전북,82,3,7,14,18,3,127,92,8,9,16,28,3,156
2020-02-25,강원,충남,170,4,14,26,37,7,258,238,14,16,42,62,7,379
2020-02-25,강원,충북,3190,195,253,185,279,194,4296,3182,163,228,208,263,204,4248
2020-02-25,경기,강원,12560,577,1042,639,672,656,16146,13323,519,1026,635,619,663,16785
2020-02-25,경기,경기,363694,20867,22989,17932,17717,28319,471518,363694,20867,22989,17932,17717,28319,471518
2020-02-25,경기,경남,1829,113,306,867,559,61,3735,1392,67,263,590,400,47,2759
2020-02-25,경기,경북,2147,163,458,707,551,75,4101,2239,175,434,919,528,68,4363
2020-02-25,경기,광주,616,26,174,334,154,17,1321,578,28,143,240,107,12,1108
2020-02-25,경기,대구,957,91,187,381,204,30,1850,1615,112,196,478,404,46,2851
2020-02-25,경기,대전,1386,83,213,113,40,61,1896,1461,100,194,98,48,89,1990
2020-02-25,경기,부산,167,19,40,191,140,1,558,225,28,42,201,254,5,755
2020-02-25,경기,서울,125518,6726,8561,5014,2639,8828,157286,126735,6303,8968,4783,2591,9003,158383
2020-02-25,경기,세종,28,1,5,1,2,1,38,30,2,4,1,3,1,41
2020-02-25,경기,울산,25,3,3,14,12,1,58,33,4,12,38,73,3,163
2020-02-25,경기,전남,579,15,116,176,122,14,1022,518,21,68,113,78,15,813
2020-02-25,경기,전북,906,51,153,139,189,35,1473,1003,58,163,211,217,37,1689
2020-02-25,경기,충남,28536,1348,2721,2354,3602,1529,40090,28446,1337,2602,2266,3300,1552,39503
2020-02-25,경기,충북,19756,1984,2763,2939,2695,1014,31151,19417,1911,2690,2707,2778,961,30464
2020-02-25,경남,강원,56,3,7,25,15,4,110,91,3,10,13,17,4,138
2020-02-25,경남,경기,1392,67,263,590,400,47,2759,1829,113,306,867,559,61,3735
2020-02-25,경남,경남,144187,9022,9002,6199,10699,11286,190395,144187,9022,9002,6199,10699,11286,190395
2020-02-25,경남,경북,5680,515,969,835,1640,216,9855,6975,742,1068,1151,2320,299,12555
2020-02-25,경남,광주,697,46,127,171,117,22,1180,672,34,133,150,101,14,1104
2020-02-25,경남,대구,7058,634,826,1007,1616,266,11407,4882,428,602,395,424,212,6943
2020-02-25,경남,대전,447,20,96,70,41,11,685,548,22,105,139,61,18,893
2020-02-25,경남,부산,64830,2353,2647,1285,3833,4685,79633,65121,2404,2840,1336,4193,4777,80671
2020-02-25,경남,서울,1462,43,417,264,133,46,2365,1939,53,390,219,112,55,2768
2020-02-25,경남,세종,115,1,10,7,3,1,137,161,2,23,10,10,5,211
2020-02-25,경남,울산,6826,592,630,429,557,410,9444,6352,558,694,414,590,404,9012
2020-02-25,경남,전남,4075,226,407,424,1331,210,6673,4035,253,377,346,1256,205,6472
2020-02-25,경남,전북,653,30,106,121,158,25,1093,653,39,95,111,158,25,1081
2020-02-25,경남,충남,735,43,107,266,218,31,1400,994,60,148,327,513,27,2069
2020-02-25,경남,충북,646,51,134,273,277,26,1407,847,78,187,530,562,21,2225
2020-02-25,경북,강원,192,8,19,31,24,13,287,228,15,17,17,23,8,308
2020-02-25,경북,경기,2239,175,434,919,528,68,4363,2147,163,458,707,551,75,4101
2020-02-25,경북,경남,6975,742,1068,1151,2320,299,12555,5680,515,969,835,1640,216,9855
2020-02-25,경북,경북,43854,3186,3475,2520,3523,2527,59085,43854,3186,3475,2520,3523,2527,59085
2020-02-25,경북,광주,455,42,100,165,140,17,919,435,43,87,152,76,14,807
2020-02-25,경북,대구,44307,2389,2180,1315,1816,2459,54466,45639,2533,2504,1684,2267,2470,57097
2020-02-25,경북,대전,1033,51,106,117,75,51,1433,1066,51,106,143,56,60,1482
2020-02-25,경북,부산,2376,102,291,186,631,101,3687,2446,109,298,199,757,110,3919
2020-02-25,경북,서울,1489,101,289,388,127,46,2440,1616,66,268,221,107,43,2321
2020-02-25,경북,세종,154,6,15,24,17,6,222,163,6,16,13,15,8,221
2020-02-25,경북,울산,2822,122,306,364,918,164,4696,2725,128,316,291,1030,167,4657
2020-02-25,경북,전남,553,38,64,107,465,21,1248,522,27,61,58,279,12,959
2020-02-25,경북,전북,1138,67,184,150,214,37,1790,1061,80,190,127,489,37,1984
2020-02-25,경북,충남,1864,103,319,535,543,73,3437,1922,104,342,447,755,73,3643
2020-02-25,경북,충북,2862,216,447,686,743,109,5063,2699,233,531,603,761,105,4932
2020-02-25,광주,강원,59,4,10,15,5,4,97,59,3,15,16,4,2,99
2020-02-25,광주,경기,578,28,143,240,107,12,1108,616,26,174,334,154,17,1321
2020-02-25,광주,경남,672,34,133,150,101,14,1104,697,46,127,171,117,22,1180
2020-02-25,광주,경북,435,43,87,152,76,14,807,455,42,100,165,140,17,919
2020-02-25,광주,광주,10459,442,575,318,180,457,12431,10459,442,575,318,180,457,12431
2020-02-25,광주,대구,267,24,59,81,33,5,469,291,23,72,73,28,8,495
2020-02-25,광주,대전,287,17,10,18,17,10,359,368,18,17,34,15,9,461
2020-02-25,광주,부산,283,14,42,34,92,6,471,314,19,45,73,114,9,574
2020-02-25,광주,서울,507,22,28,81,21,16,675,581,28,27,58,19,22,735
2020-02-25,광주,세종,100,3,7,2,3,3,118,106,1,6,11,0,3,127
2020-02-25,광주,울산,47,1,4,2,4,0,58,33,2,7,5,8,1,56
2020-02-25,광주,전남,25884,834,1038,561,1439,1028,30784,24767,810,903,519,1307,1016,29322
2020-02-25,광주,전북,5660,382,520,333,324,222,7441,5818,409,443,300,329,216,7515
2020-02-25,광주,충남,2978,102,487,484,235,77,4363,3057,139,498,587,329,85,4695
2020-02-25,광주,충북,405,21,62,107,65,15,675,422,29,83,163,88,11,796
2020-02-25,대구,강원,159,4,12,7,20,2,204,109,1,4,11,7,0,132
2020-02-25,대구,경기,1615,112,196,478,404,46,2851,957,91,187,381,204,30,1850
2020-02-25,대구,경남,4882,428,602,395,424,212,6943,7058,634,826,1007,1616,266,11407
2020-02-25,대구,경북,45639,2533,2504,1684,2267,2470,57097,44307,2389,2180,1315,1816,2459,54466
2020-02-25,대구,광주,291,23,72,73,28,8,495,267,24,59,81,33,5,469
2020-02-25,대구,대구,42785,1833,1501,732,799,3039,50689,42785,1833,1501,732,799,3039,50689
2020-02-25,대구,대전,455,32,41,91,35,19,673,281,21,21,63,15,11,412
2020-02-25,대구,부산,313,47,91,58,142,13,664,1408,89,179,88,207,54,2025
2020-02-25,대구,서울,1630,62,123,244,98,46,2203,902,61,79,135,51,23,1251
2020-02-25,대구,세종,133,1,13,5,7,4,163,80,5,1,3,1,2,92
2020-02-25,대구,울산,595,45,74,72,149,22,957,596,42,91,73,143,24,969
2020-02-25,대구,전남,233,6,32,23,46,7,347,221,7,33,33,66,5,365
2020-02-25,대구,전북,174,8,26,12,27,1,248,151,9,25,21,23,2,231
2020-02-25,대구,충남,750,60,122,207,223,28,1390,458,47,92,157,166,14,934
2020-02-25,대구,충북,833,93,174,263,375,24,1762,550,66,131,244,120,18,1129
2020-02-25,대전,강원,88,5,25,4,1,3,126,109,3,26,6,0,5,149
2020-02-25,대전,경기,1461,100,194,98,48,89,1990,1386,83,213,113,40,61,1896
2020-02-25,대전,경남,548,22,105,139,61,18,893,447,20,96,70,41,11,685
2020-02-25,대전,경북,1066,51,106,143,56,60,1482,1033,51,106,117,75,51,1433
2020-02-25,대전,광주,368,18,17,34,15,9,461,287,17,10,18,17,10,359
2020-02-25,대전,대구,281,21,21,63,15,11,412,455,32,41,91,35,19,673
2020-02-25,대전,대전,11313,346,375,185,202,863,13284,11313,346,375,185,202,863,13284
2020-02-25,대전,부산,52,2,4,23,17,1,99,62,1,8,19,17,3,110
2020-02-25,대전,서울,1304,43,162,28,8,54,1599,1331,25,167,36,9,56,1624
2020-02-25,대전,세종,2777,87,74,23,25,225,3211,2766,84,78,37,34,213,3212
2020-02-25,대전,울산,64,2,12,21,25,1,125,57,5,14,11,21,4,112
2020-02-25,대전,전남,187,3,8,25,29,8,260,79,0,6,11,6,1,103
2020-02-25,대전,전북,2031,69,83,82,43,91,2399,2167,95,85,69,55,103,2574
2020-02-25,대전,충남,12824,398,484,221,129,991,15047,11579,353,420,215,132,900,13599
2020-02-25,대전,충북,8934,420,399,165,110,694,10722,7850,361,351,141,105,625,9433
2020-02-25,부산,강원,3,0,1,1,3,1,9,6,1,2,1,1,0,11
2020-02-25,부산,경기,225,28,42,201,254,5,755,167,19,40,191,140,1,558
2020-02-25,부산,경남,65121,2404,2840,1336,4193,4777,80671,64830,2353,2647,1285,3833,4685,79633
2020-02-25,부산,경북,2446,109,298,199,757,110,3919,2376,102,291,186,631,101,3687
2020-02-25,부산,광주,314,19,45,73,114,9,574,283,14,42,34,92,6,471
2020-02-25,부산,대구,1408,89,179,88,207,54,2025,313,47,91,58,142,13,664
2020-02-25,부산,대전,62,1,8,19,17,3,110,52,2,4,23,17,1,99
2020-02-25,부산,부산,29106,576,537,412,1675,2241,34547,29106,576,537,412,1675,2241,34547
2020-02-25,부산,서울,190,14,22,96,66,4,392,157,15,15,63,28,5,283
2020-02-25,부산,세종,12,0,1,0,6,0,19,13,0,0,3,2,1,19
2020-02-25,부산,울산,11351,321,448,589,2477,839,16025,11481,327,386,389,2368,858,15809
2020-02-25,부산,전남,1341,71,120,164,503,54,2253,1174,71,115,142,541,49,2092
2020-02-25,부산,전북,197,9,33,34,92,1,366,169,6,30,44,71,3,323
2020-02-25,부산,충남,115,15,25,67,162,4,388,94,14,24,96,211,4,443
2020-02-25,부산,충북,93,15,24,105,237,11,485,54,11,24,115,189,3,396
2020-02-25,서울,강원,463,18,183,13,14,23,714,440,11,233,7,17,17,725
2020-02-25,서울,경기,126735,6303,8968,4783,2591,9003,158383,125518,6726,8561,5014,2639,8828,157286
2020-02-25,서울,경남,1939,53,390,219,112,55,2768,1462,43,417,264,133,46,2365
2020-02-25,서울,경북,1616,66,268,221,107,43,2321,1489,101,289,388,127,46,2440
2020-02-25,서울,광주,581,28,27,58,19,22,735,507,22,28,81,21,16,675
2020-02-25,서울,대구,902,61,79,135,51,23,1251,1630,62,123,244,98,46,2203
2020-02-25,서울,대전,1331,25,167,36,9,56,1624,1304,43,162,28,8,54,1599
2020-02-25,서울,부산,157,15,15,63,28,5,283,190,14,22,96,66,4,392
2020-02-25,서울,서울,185,2,8,2,0,7,204,185,2,8,2,0,7,204
2020-02-25,서울,세종,31,0,1,0,0,1,33,22,1,0,1,0,1,25
2020-02-25,서울,울산,28,0,0,3,0,0,31,19,0,1,13,7,0,40
2020-02-25,서울,전남,640,10,34,48,35,18,785,538,11,32,75,30,13,699
2020-02-25,서울,전북,912,16,35,25,26,17,1031,884,23,33,44,30,19,1033
2020-02-25,서울,충남,19988,495,2138,779,628,819,24847,19998,548,2069,1224,939,808,25586
2020-02-25,서울,충북,9963,492,1056,737,560,449,13257,9737,564,1016,790,605,405,13117
2020-02-25,세종,강원,4,1,0,2,1,0,8,3,0,0,0,0,0,3
2020-02-25,세종,경기,30,2,4,1,3,1,41,28,1,5,1,2,1,38
2020-02-25,세종,경남,161,2,23,10,10,5,211,115,1,10,7,3,1,137
2020-02-25,세종,경북,163,6,16,13,15,8,221,154,6,15,24,17,6,222
2020-02-25,세종,광주,106,1,6,11,0,3,127,100,3,7,2,3,3,118
2020-02-25,세종,대구,80,5,1,3,1,2,92,133,1,13,5,7,4,163
2020-02-25,세종,대전,2766,84,78,37,34,213,3212,2777,87,74,23,25,225,3211
2020-02-25,세종,부산,13,0,0,3,2,1,19,12,0,1,0,6,0,19
2020-02-25,세종,서울,22,1,0,1,0,1,25,31,0,1,0,0,1,33
2020-02-25,세종,세종,178,23,1,1,3,18,224,178,23,1,1,3,18,224
2020-02-25,세종,울산,2,0,0,0,1,0,3,6,0,0,1,2,0,9
2020-02-25,세종,전남,111,1,5,5,18,5,145,92,0,1,9,6,1,109
2020-02-25,세종,전북,440,18,17,15,38,22,550,450,8,18,19,43,20,558
2020-02-25,세종,충남,4512,151,146,76,120,248,5253,3393,125,125,96,123,175,4037
2020-02-25,세종,충북,239,12,16,13,13,22,315,217,16,16,6,8,16,279
2020-02-25,울산,강원,2,0,0,0,1,0,3,1,0,0,0,1,0,2
2020-02-25,울산,경기,33,4,12,38,73,3,163,25,3,3,14,12,1,58
2020-02-25,울산,경남,6352,558,694,414,590,404,9012,6826,592,630,429,557,410,9444
2020-02-25,울산,경북,2725,128,316,291,1030,167,4657,2822,122,306,364,918,164,4696
2020-02-25,울산,광주,33,2,7,5,8,1,56,47,1,4,2,4,0,58
2020-02-25,울산,대구,596,42,91,73,143,24,969,595,45,74,72,149,22,957
2020-02-25,울산,대전,57,5,14,11,21,4,112,64,2,12,21,25,1,125
2020-02-25,울산,부산,11481,327,386,389,2368,858,15809,11351,321,448,589,2477,839,16025
2020-02-25,울산,서울,19,0,1,13,7,0,40,28,0,0,3,0,0,31
2020-02-25,울산,세종,6,0,0,1,2,0,9,2,0,0,0,1,0,3
2020-02-25,울산,울산,6303,235,464,233,483,582,8300,6303,235,464,233,483,582,8300
2020-02-25,울산,전남,126,9,14,9,23,5,186,152,12,21,10,35,1,231
2020-02-25,울산,전북,27,1,6,4,11,3,52,22,2,5,1,3,0,33
2020-02-25,울산,충남,76,3,13,40,110,0,242,77,6,12,31,97,3,226
2020-02-25,울산,충북,15,1,9,16,43,0,84,12,3,1,17,34,0,67
2020-02-25,전남,강원,13,1,1,1,3,0,19,20,1,1,8,9,2,41
2020-02-25,전남,경기,518,21,68,113,78,15,813,579,15,116,176,122,14,1022
2020-02-25,전남,경남,4035,253,377,346,1256,205,6472,4075,226,407,424,1331,210,6673
2020-02-25,전남,경북,522,27,61,58,279,12,959,553,38,64,107,465,21,1248
2020-02-25,전남,광주,24767,810,903,519,1307,1016,29322,25884,834,1038,561,1439,1028,30784
2020-02-25,전남,대구,221,7,33,33,66,5,365,233,6,32,23,46,7,347
2020-02-25,전남,대전,79,0,6,11,6,1,103,187,3,8,25,29,8,260
2020-02-25,전남,부산,1174,71,115,142,541,49,2092,1341,71,120,164,503,54,2253
2020-02-25,전남,서울,538,11,32,75,30,13,699,640,10,34,48,35,18,785
2020-02-25,전남,세종,92,0,1,9,6,1,109,111,1,5,5,18,5,145
2020-02-25,전남,울산,152,12,21,10,35,1,231,126,9,14,9,23,5,186
2020-02-25,전남,전남,34339,1149,1286,1226,3538,1450,42988,34339,1149,1286,1226,3538,1450,42988
2020-02-25,전남,전북,5126,276,619,723,2577,166,9487,3068,193,403,507,1037,108,5316
2020-02-25,전남,충남,1344,44,179,409,238,39,2253,3082,82,440,517,953,81,5155
2020-02-25,전남,충북,107,10,22,50,46,3,238,235,13,54,104,238,3,647
2020-02-25,전북,강원,92,8,9,16,28,3,156,82,3,7,14,18,3,127
2020-02-25,전북,경기,1003,58,163,211,217,37,1689,906,51,153,139,189,35,1473
2020-02-25,전북,경남,653,39,95,111,158,25,1081,653,30,106,121,158,25,1093
2020-02-25,전북,경북,1061,80,190,127,489,37,1984,1138,67,184,150,214,37,1790
2020-02-25,전북,광주,5818,409,443,300,329,216,7515,5660,382,520,333,324,222,7441
2020-02-25,전북,대구,151,9,25,21,23,2,231,174,8,26,12,27,1,248
2020-02-25,전북,대전,2167,95,85,69,55,103,2574,2031,69,83,82,43,91,2399
2020-02-25,전북,부산,169,6,30,44,71,3,323,197,9,33,34,92,1,366
2020-02-25,전북,서울,884,23,33,44,30,19,1033,912,16,35,25,26,17,1031
2020-02-25,전북,세종,450,8,18,19,43,20,558,440,18,17,15,38,22,550
2020-02-25,전북,울산,22,2,5,1,3,0,33,27,1,6,4,11,3,52
2020-02-25,전북,전남,3068,193,403,507,1037,108,5316,5126,276,619,723,2577,166,9487
2020-02-25,전북,전북,12445,485,828,573,1046,474,15851,12445,485,828,573,1046,474,15851
2020-02-25,전북,충남,11199,470,1578,1338,2208,358,17151,9438,449,1397,907,1229,330,13750
2020-02-25,전북,충북,1303,103,184,328,366,42,2326,1181,114,194,285,227,41,2042
2020-02-25,충남,강원,238,14,16,42,62,7,379,170,4,14,26,37,7,258
2020-02-25,충남,경기,28446,1337,2602,2266,3300,1552,39503,28536,1348,2721,2354,3602,1529,40090
2020-02-25,충남,경남,994,60,148,327,513,27,2069,735,43,107,266,218,31,1400
2020-02-25,충남,경북,1922,104,342,447,755,73,3643,1864,103,319,535,543,73,3437
2020-02-25,충남,광주,3057,139,498,587,329,85,4695,2978,102,487,484,235,77,4363
2020-02-25,충남,대구,458,47,92,157,166,14,934,750,60,122,207,223,28,1390
2020-02-25,충남,대전,11579,353,420,215,132,900,13599,12824,398,484,221,129,991,15047
2020-02-25,충남,부산,94,14,24,96,211,4,443,115,15,25,67,162,4,388
2020-02-25,충남,서울,19998,548,2069,1224,939,808,25586,19988,495,2138,779,628,819,24847
2020-02-25,충남,세종,3393,125,125,96,123,175,4037,4512,151,146,76,120,248,5253
2020-02-25,충남,울산,77,6,12,31,97,3,226,76,3,13,40,110,0,242
2020-02-25,충남,전남,3082,82,440,517,953,81,5155,1344,44,179,409,238,39,2253
2020-02-25,충남,전북,9438,449,1397,907,1229,330,13750,11199,470,1578,1338,2208,358,17151
2020-02-25,충남,충남,73295,3119,7314,6622,9342,3641,103333,73295,3119,7314,6622,9342,3641,103333
2020-02-25,충남,충북,10485,594,855,925,1251,638,14748,9477,547,776,809,1280,581,13470
2020-02-25,충북,강원,3182,163,228,208,263,204,4248,3190,195,253,185,279,194,4296
2020-02-25,충북,경기,19417,1911,2690,2707,2778,961,30464,19756,1984,2763,2939,2695,1014,31151
2020-02-25,충북,경남,847,78,187,530,562,21,2225,646,51,134,273,277,26,1407
2020-02-25,충북,경북,2699,233,531,603,761,105,4932,2862,216,447,686,743,109,5063
2020-02-25,충북,광주,422,29,83,163,88,11,796,405,21,62,107,65,15,675
2020-02-25,충북,대구,550,66,131,244,120,18,1129,833,93,174,263,375,24,1762
2020-02-25,충북,대전,7850,361,351,141,105,625,9433,8934,420,399,165,110,694,10722
2020-02-25,충북,부산,54,11,24,115,189,3,396,93,15,24,105,237,11,485
2020-02-25,충북,서울,9737,564,1016,790,605,405,13117,9963,492,1056,737,560,449,13257
2020-02-25,충북,세종,217,16,16,6,8,16,279,239,12,16,13,13,22,315
2020-02-25,충북,울산,12,3,1,17,34,0,67,15,1,9,16,43,0,84
2020-02-25,충북,전남,235,13,54,104,238,3,647,107,10,22,50,46,3,238
2020-02-25,충북,전북,1181,114,194,285,227,41,2042,1303,103,184,328,366,42,2326
2020-02-25,충북,충남,9477,547,776,809,1280,581,13470,10485,594,855,925,1251,638,14748
2020-02-25,충북,충북,27682,1745,2116,1861,2271,1753,37428,27682,1745,2116,1861,2271,1753,37428
2020-02-26,강원,강원,48882,1980,2593,1255,1849,3384,59943,48882,1980,2593,1255,1849,3384,59943
2020-02-26,강원,경기,14580,578,1090,645,659,682,18234,16199,585,1108,697,781,779,20149
2020-02-26,강원,경남,75,5,9,17,17,3,126,58,5,5,27,16,4,115
2020-02-26,강원,경북,198,22,20,21,24,6,291,195,15,17,30,27,10,294
2020-02-26,강원,광주,51,7,13,9,11,1,92,53,1,13,12,4,0,83
2020-02-26,강원,대구,90,5,5,7,9,1,117,166,5,11,22,20,4,228
2020-02-26,강원,대전,106,2,30,5,0,5,148,129,3,31,7,2,1,173
2020-02-26,강원,부산,4,0,0,2,2,0,8,3,0,0,1,1,0,5
2020-02-26,강원,서울,563,12,228,15,32,18,868,763,21,211,14,15,39,1063
2020-02-26,강원,세종,4,0,1,0,1,1,7,7,0,0,0,2,1,10
2020-02-26,강원,울산,1,0,0,0,0,0,1,1,0,1,0,0,0,2
2020-02-26,강원,전남,27,1,4,7,7,2,48,12,1,0,4,6,1,24
2020-02-26,강원,전북,87,4,12,9,22,4,138,116,5,14,21,33,4,193
2020-02-26,강원,충남,222,7,12,19,36,3,299,299,8,22,39,52,13,433
2020-02-26,강원,충북,3649,217,263,226,310,215,4880,3722,198,238,201,288,228,4875
2020-02-26,경기,강원,16199,585,1108,697,781,779,20149,14580,578,1090,645,659,682,18234
2020-02-26,경기,경기,403059,24071,25109,20108,22669,30198,525214,403059,24071,25109,20108,22669,30198,525214
2020-02-26,경기,경남,1873,109,325,786,599,46,3738,1373,70,249,588,464,48,2792
2020-02-26,경기,경북,2269,181,466,719,624,84,4343,2255,182,410,987,560,78,4472
2020-02-26,경기,광주,650,30,167,343,164,18,1372,575,16,146,261,118,11,1127
2020-02-26,경기,대구,953,82,176,387,202,31,1831,1576,117,159,469,424,60,2805
2020-02-26,경기,대전,1628,91,225,126,48,92,2210,1642,115,224,106,48,74,2209
2020-02-26,경기,부산,175,30,53,217,158,4,637,203,25,33,172,268,6,707
2020-02-26,경기,서울,138255,7537,9021,5254,3464,9345,172876,140279,7235,9421,5019,3075,9593,174622
2020-02-26,경기,세종,22,2,2,4,2,0,32,34,4,4,7,1,2,52
2020-02-26,경기,울산,23,1,5,11,15,0,55,31,1,9,33,82,3,159
2020-02-26,경기,전남,626,23,94,204,165,27,1139,503,18,69,134,87,15,826
2020-02-26,경기,전북,1031,46,176,137,212,31,1633,1073,44,167,192,236,28,1740
2020-02-26,경기,충남,32724,1573,2881,2575,4298,1735,45786,31633,1534,2808,2525,4057,1642,44199
2020-02-26,경기,충북,23079,2296,3081,3442,3288,1107,36293,22433,2198,2843,3033,3565,1120,35192
2020-02-26,경남,강원,58,5,5,27,16,4,115,75,5,9,17,17,3,126
2020-02-26,경남,경기,1373,70,249,588,464,48,2792,1873,109,325,786,599,46,3738
2020-02-26,경남,경남,165103,10448,10134,8349,12186,12306,218526,165103,10448,10134,8349,12186,12306,218526
2020-02-26,경남,경북,6219,588,971,914,1799,280,10771,7745,829,1098,1257,2565,332,13826
2020-02-26,경남,광주,735,57,141,169,140,22,1264,720,44,126,159,104,21,1174
2020-02-26,경남,대구,7727,705,857,1111,1666,334,12400,5763,495,603,433,461,238,7993
2020-02-26,경남,대전,492,29,87,86,42,20,756,696,33,104,115,52,17,1017
2020-02-26,경남,부산,73344,2720,2811,1752,4269,5269,90165,73686,2801,3081,1812,4605,5248,91233
2020-02-26,경남,서울,1395,40,387,284,164,35,2305,2061,51,409,196,118,57,2892
2020-02-26,경남,세종,111,3,9,15,4,5,147,154,6,20,19,11,3,213
2020-02-26,경남,울산,7563,664,734,489,618,474,10542,7323,598,789,467,619,446,10242
2020-02-26,경남,전남,4701,248,475,559,1472,201,7656,4431,282,436,427,1257,220,7053
2020-02-26,경남,전북,815,39,110,103,167,30,1264,744,33,123,121,126,24,1171
2020-02-26,경남,충남,779,49,112,254,277,12,1483,1060,51,131,355,539,26,2162
2020-02-26,경남,충북,671,55,144,253,322,19,1464,955,82,211,521,613,23,2405
2020-02-26,경북,강원,195,15,17,30,27,10,294,198,22,20,21,24,6,291
2020-02-26,경북,경기,2255,182,410,987,560,78,4472,2269,181,466,719,624,84,4343
2020-02-26,경북,경남,7745,829,1098,1257,2565,332,13826,6219,588,971,914,1799,280,10771
2020-02-26,경북,경북,50477,3799,3846,2955,4406,2714,68197,50477,3799,3846,2955,4406,2714,68197
2020-02-26,경북,광주,534,56,111,168,128,5,1002,450,38,106,145,73,7,819
2020-02-26,경북,대구,50432,2841,2368,1622,2262,2731,62256,53089,3045,2728,2019,2825,2833,66539
2020-02-26,경북,대전,1195,52,107,136,61,52,1603,1196,38,116,131,60,54,1595
2020-02-26,경북,부산,2489,119,294,200,546,126,3774,2792,122,318,212,795,117,4356
2020-02-26,경북,서울,1506,97,270,410,151,44,2478,1740,72,278,263,112,54,2519
2020-02-26,경북,세종,176,7,19,22,14,6,244,171,6,21,15,11,5,229
2020-02-26,경북,울산,3315,170,323,401,970,193,5372,3410,176,328,323,1203,202,5642
2020-02-26,경북,전남,684,41,61,116,457,21,1380,538,39,67,62,288,19,1013
2020-02-26,경북,전북,1360,82,181,195,248,38,2104,1270,99,183,190,462,36,2240
2020-02-26,경북,충남,2012,147,321,572,607,86,3745,2155,124,341,522,796,73,4011
2020-02-26,경북,충북,3115,226,552,705,953,105,5656,2958,231,503,687,947,111,5437
2020-02-26,광주,강원,53,1,13,12,4,0,83,51,7,13,9,11,1,92
2020-02-26,광주,경기,575,16,146,261,118,11,1127,650,30,167,343,164,18,1372
2020-02-26,광주,경남,720,44,126,159,104,21,1174,735,57,141,169,140,22,1264
2020-02-26,광주,경북,450,38,106,145,73,7,819,534,56,111,168,128,5,1002
2020-02-26,광주,광주,11888,472,597,339,222,536,14054,11888,472,597,339,222,536,14054
2020-02-26,광주,대구,274,22,59,80,23,5,463,322,30,69,74,34,5,534
2020-02-26,광주,대전,324,19,20,22,14,14,413,380,21,16,22,14,11,464
2020-02-26,광주,부산,251,14,39,37,68,9,418,282,20,30,75,121,3,531
2020-02-26,광주,서울,504,15,21,71,27,9,647,664,22,20,39,19,13,777
2020-02-26,광주,세종,108,1,6,2,8,2,127,138,6,6,7,0,2,159
2020-02-26,광주,울산,29,1,8,2,5,2,47,20,0,3,2,8,2,35
2020-02-26,광주,전남,29636,982,1102,818,1776,1177,35491,28251,958,951,696,1680,1081,33617
2020-02-26,광주,전북,6490,433,497,341,366,242,8369,6589,474,452,320,374,273,8482
2020-02-26,광주,충남,3160,122,463,504,254,88,4591,3398,141,476,616,323,88,5042
2020-02-26,광주,충북,448,25,58,112,80,11,734,484,25,78,177,99,10,873
2020-02-26,대구,강원,166,5,11,22,20,4,228,90,5,5,7,9,1,117
2020-02-26,대구,경기,1576,117,159,469,424,60,2805,953,82,176,387,202,31,1831
2020-02-26,대구,경남,5763,495,603,433,461,238,7993,7727,705,857,1111,1666,334,12400
2020-02-26,대구,경북,53089,3045,2728,2019,2825,2833,66539,50432,2841,2368,1622,2262,2731,62256
2020-02-26,대구,광주,322,30,69,74,34,5,534,274,22,59,80,23,5,463
2020-02-26,대구,대구,47644,2159,1612,828,926,3121,56290,47644,2159,1612,828,926,3121,56290
2020-02-26,대구,대전,509,32,38,59,50,17,705,304,23,19,61,17,7,431
2020-02-26,대구,부산,410,52,119,83,147,9,820,1580,106,200,90,237,61,2274
2020-02-26,대구,서울,1513,61,111,209,109,48,2051,846,52,70,116,56,26,1166
2020-02-26,대구,세종,125,2,15,6,9,5,162,81,2,3,5,2,5,98
2020-02-26,대구,울산,715,46,93,76,157,35,1122,640,45,84,79,178,31,1057
2020-02-26,대구,전남,312,9,44,23,53,6,447,245,12,37,26,59,4,383
2020-02-26,대구,전북,167,6,25,8,16,6,228,173,9,31,15,20,6,254
2020-02-26,대구,충남,784,66,108,206,245,17,1426,500,59,90,172,173,7,1001
2020-02-26,대구,충북,953,85,135,241,433,27,1874,627,79,133,213,129,17,1198
2020-02-26,대전,강원,129,3,31,7,2,1,173,106,2,30,5,0,5,148
2020-02-26,대전,경기,1642,115,224,106,48,74,2209,1628,91,225,126,48,92,2210
2020-02-26,대전,경남,696,33,104,115,52,17,1017,492,29,87,86,42,20,756
2020-02-26,대전,경북,1196,38,116,131,60,54,1595,1195,52,107,136,61,52,1603
2020-02-26,대전,광주,380,21,16,22,14,11,464,324,19,20,22,14,14,413
2020-02-26,대전,대구,304,23,19,61,17,7,431,509,32,38,59,50,17,705
2020-02-26,대전,대전,12999,409,370,322,193,958,15251,12999,409,370,322,193,958,15251
2020-02-26,대전,부산,51,3,5,21,24,1,105,58,5,10,23,22,1,119
2020-02-26,대전,서울,1468,40,171,37,10,62,1788,1431,37,171,31,8,53,1731
2020-02-26,대전,세종,3214,111,76,32,37,261,3731,3200,114,83,38,33,242,3710
2020-02-26,대전,울산,75,5,12,18,17,5,132,81,2,9,16,23,1,132
2020-02-26,대전,전남,208,6,6,19,26,9,274,91,3,5,5,6,3,113
2020-02-26,대전,전북,2534,76,93,82,52,124,2961,2603,102,85,91,55,122,3058
2020-02-26,대전,충남,14707,461,501,253,212,1123,17257,13165,474,490,205,212,977,15523
2020-02-26,대전,충북,9904,453,440,203,171,737,11908,8845,393,394,199,150,693,10674
2020-02-26,부산,강원,3,0,0,1,1,0,5,4,0,0,2,2,0,8
2020-02-26,부산,경기,203,25,33,172,268,6,707,175,30,53,217,158,4,637
2020-02-26,부산,경남,73686,2801,3081,1812,4605,5248,91233,73344,2720,2811,1752,4269,5269,90165
2020-02-26,부산,경북,2792,122,318,212,795,117,4356,2489,119,294,200,546,126,3774
2020-02-26,부산,광주,282,20,30,75,121,3,531,251,14,39,37,68,9,418
2020-02-26,부산,대구,1580,106,200,90,237,61,2274,410,52,119,83,147,9,820
2020-02-26,부산,대전,58,5,10,23,22,1,119,51,3,5,21,24,1,105
2020-02-26,부산,부산,35292,626,623,551,1772,2495,41359,35292,626,623,551,1772,2495,41359
2020-02-26,부산,서울,182,10,12,85,78,4,371,154,19,25,60,33,1,292
2020-02-26,부산,세종,16,0,3,6,9,0,34,11,0,0,2,3,0,16
2020-02-26,부산,울산,12932,350,471,691,2557,900,17901,12860,367,413,417,2519,923,17499
2020-02-26,부산,전남,1561,80,109,200,538,60,2548,1325,61,107,125,557,51,2226
2020-02-26,부산,전북,198,7,26,40,93,6,370,176,4,25,44,79,6,334
2020-02-26,부산,충남,110,7,28,87,174,2,408,105,12,29,95,212,2,455
2020-02-26,부산,충북,80,4,19,82,239,4,428,80,14,34,127,165,1,421
2020-02-26,서울,강원,763,21,211,14,15,39,1063,563,12,228,15,32,18,868
2020-02-26,서울,경기,140279,7235,9421,5019,3075,9593,174622,138255,7537,9021,5254,3464,9345,172876
2020-02-26,서울,경남,2061,51,409,196,118,57,2892,1395,40,387,284,164,35,2305
2020-02-26,서울,경북,1740,72,278,263,112,54,2519,1506,97,270,410,151,44,2478
2020-02-26,서울,광주,664,22,20,39,19,13,777,504,15,21,71,27,9,647
2020-02-26,서울,대구,846,52,70,116,56,26,1166,1513,61,111,209,109,48,2051
2020-02-26,서울,대전,1431,37,171,31,8,53,1731,1468,40,171,37,10,62,1788
2020-02-26,서울,부산,154,19,25,60,33,1,292,182,10,12,85,78,4,371
2020-02-26,서울,서울,183,8,10,5,3,5,214,183,8,10,5,3,5,214
2020-02-26,서울,세종,30,2,0,0,0,0,32,26,2,0,1,2,0,31
2020-02-26,서울,울산,32,1,4,4,1,0,42,28,0,6,7,13,0,54
2020-02-26,서울,전남,718,17,16,41,19,23,834,598,8,20,73,41,14,754
2020-02-26,서울,전북,1040,17,39,22,28,37,1183,982,26,42,33,37,19,1139
2020-02-26,서울,충남,22388,595,2100,853,711,942,27589,21665,668,2095,1299,1124,881,27732
2020-02-26,서울,충북,11329,530,1098,798,627,475,14857,10976,682,1109,891,759,457,14874
2020-02-26,세종,강원,7,0,0,0,2,1,10,4,0,1,0,1,1,7
2020-02-26,세종,경기,34,4,4,7,1,2,52,22,2,2,4,2,0,32
2020-02-26,세종,경남,154,6,20,19,11,3,213,111,3,9,15,4,5,147
2020-02-26,세종,경북,171,6,21,15,11,5,229,176,7,19,22,14,6,244
2020-02-26,세종,광주,138,6,6,7,0,2,159,108,1,6,2,8,2,127
2020-02-26,세종,대구,81,2,3,5,2,5,98,125,2,15,6,9,5,162
2020-02-26,세종,대전,3200,114,83,38,33,242,3710,3214,111,76,32,37,261,3731
2020-02-26,세종,부산,11,0,0,2,3,0,16,16,0,3,6,9,0,34
2020-02-26,세종,서울,26,2,0,1,2,0,31,30,2,0,0,0,0,32
2020-02-26,세종,세종,198,24,5,1,0,14,242,198,24,5,1,0,14,242
2020-02-26,세종,울산,11,0,1,1,2,0,15,5,0,1,1,7,0,14
2020-02-26,세종,전남,116,3,3,7,10,10,149,72,0,2,9,9,2,94
2020-02-26,세종,전북,502,22,21,10,41,18,614,542,15,18,16,48,23,662
2020-02-26,세종,충남,5170,160,168,112,152,281,6043,3844,134,154,123,140,208,4603
2020-02-26,세종,충북,327,8,18,16,13,34,416,291,17,20,16,14,31,389
2020-02-26,울산,강원,1,0,1,0,0,0,2,1,0,0,0,0,0,1
2020-02-26,울산,경기,31,1,9,33,82,3,159,23,1,5,11,15,0,55
2020-02-26,울산,경남,7323,598,789,467,619,446,10242,7563,664,734,489,618,474,10542
2020-02-26,울산,경북,3410,176,328,323,1203,202,5642,3315,170,323,401,970,193,5372
2020-02-26,울산,광주,20,0,3,2,8,2,35,29,1,8,2,5,2,47
2020-02-26,울산,대구,640,45,84,79,178,31,1057,715,46,93,76,157,35,1122
2020-02-26,울산,대전,81,2,9,16,23,1,132,75,5,12,18,17,5,132
2020-02-26,울산,부산,12860,367,413,417,2519,923,17499,12932,350,471,691,2557,900,17901
2020-02-26,울산,서울,28,0,6,7,13,0,54,32,1,4,4,1,0,42
2020-02-26,울산,세종,5,0,1,1,7,0,14,11,0,1,1,2,0,15
2020-02-26,울산,울산,6901,304,467,311,544,667,9194,6901,304,467,311,544,667,9194
2020-02-26,울산,전남,133,10,13,18,27,3,204,131,9,21,10,38,2,211
2020-02-26,울산,전북,20,0,5,3,11,0,39,23,0,6,4,8,2,43
2020-02-26,울산,충남,76,6,14,54,124,5,279,84,2,12,37,115,3,253
2020-02-26,울산,충북,13,4,2,20,49,0,88,16,2,2,11,43,0,74
2020-02-26,전남,강원,12,1,0,4,6,1,24,27,1,4,7,7,2,48
2020-02-26,전남,경기,503,18,69,134,87,15,826,626,23,94,204,165,27,1139
2020-02-26,전남,경남,4431,282,436,427,1257,220,7053,4701,248,475,559,1472,201,7656
2020-02-26,전남,경북,538,39,67,62,288,19,1013,684,41,61,116,457,21,1380
2020-02-26,전남,광주,28251,958,951,696,1680,1081,33617,29636,982,1102,818,1776,1177,35491
2020-02-26,전남,대구,245,12,37,26,59,4,383,312,9,44,23,53,6,447
2020-02-26,전남,대전,91,3,5,5,6,3,113,208,6,6,19,26,9,274
2020-02-26,전남,부산,1325,61,107,125,557,51,2226,1561,80,109,200,538,60,2548
2020-02-26,전남,서울,598,8,20,73,41,14,754,718,17,16,41,19,23,834
2020-02-26,전남,세종,72,0,2,9,9,2,94,116,3,3,7,10,10,149
2020-02-26,전남,울산,131,9,21,10,38,2,211,133,10,13,18,27,3,204
2020-02-26,전남,전남,38766,1312,1436,1569,4460,1588,49131,38766,1312,1436,1569,4460,1588,49131
2020-02-26,전남,전북,5700,335,697,806,2735,137,10410,3848,223,448,542,1215,111,6387
2020-02-26,전남,충남,1420,67,218,433,262,39,2439,3488,88,409,523,1027,92,5627
2020-02-26,전남,충북,98,11,15,27,76,3,230,305,20,51,113,246,9,744
2020-02-26,전북,강원,116,5,14,21,33,4,193,87,4,12,9,22,4,138
2020-02-26,전북,경기,1073,44,167,192,236,28,1740,1031,46,176,137,212,31,1633
2020-02-26,전북,경남,744,33,123,121,126,24,1171,815,39,110,103,167,30,1264
2020-02-26,전북,경북,1270,99,183,190,462,36,2240,1360,82,181,195,248,38,2104
2020-02-26,전북,광주,6589,474,452,320,374,273,8482,6490,433,497,341,366,242,8369
2020-02-26,전북,대구,173,9,31,15,20,6,254,167,6,25,8,16,6,228
2020-02-26,전북,대전,2603,102,85,91,55,122,3058,2534,76,93,82,52,124,2961
2020-02-26,전북,부산,176,4,25,44,79,6,334,198,7,26,40,93,6,370
2020-02-26,전북,서울,982,26,42,33,37,19,1139,1040,17,39,22,28,37,1183
2020-02-26,전북,세종,542,15,18,16,48,23,662,502,22,21,10,41,18,614
2020-02-26,전북,울산,23,0,6,4,8,2,43,20,0,5,3,11,0,39
2020-02-26,전북,전남,3848,223,448,542,1215,111,6387,5700,335,697,806,2735,137,10410
2020-02-26,전북,전북,14666,597,900,652,1135,544,18494,14666,597,900,652,1135,544,18494
2020-02-26,전북,충남,12236,569,1655,1381,2286,410,18537,10705,469,1395,949,1351,415,15284
2020-02-26,전북,충북,1508,125,191,328,452,42,2646,1378,129,211,299,244,48,2309
2020-02-26,충남,강원,299,8,22,39,52,13,433,222,7,12,19,36,3,299
2020-02-26,충남,경기,31633,1534,2808,2525,4057,1642,44199,32724,1573,2881,2575,4298,1735,45786
2020-02-26,충남,경남,1060,51,131,355,539,26,2162,779,49,112,254,277,12,1483
2020-02-26,충남,경북,2155,124,341,522,796,73,4011,2012,147,321,572,607,86,3745
2020-02-26,충남,광주,3398,141,476,616,323,88,5042,3160,122,463,504,254,88,4591
2020-02-26,충남,대구,500,59,90,172,173,7,1001,784,66,108,206,245,17,1426
2020-02-26,충남,대전,13165,474,490,205,212,977,15523,14707,461,501,253,212,1123,17257
2020-02-26,충남,부산,105,12,29,95,212,2,455,110,7,28,87,174,2,408
2020-02-26,충남,서울,21665,668,2095,1299,1124,881,27732,22388,595,2100,853,711,942,27589
2020-02-26,충남,세종,3844,134,154,123,140,208,4603,5170,160,168,112,152,281,6043
2020-02-26,충남,울산,84,2,12,37,115,3,253,76,6,14,54,124,5,279
2020-02-26,충남,전남,3488,88,409,523,1027,92,5627,1420,67,218,433,262,39,2439
2020-02-26,충남,전북,10705,469,1395,949,1351,415,15284,12236,569,1655,1381,2286,410,18537
2020-02-26,충남,충남,82064,3613,7674,7441,10285,3980,115057,82064,3613,7674,7441,10285,3980,115057
2020-02-26,충남,충북,11671,678,881,947,1436,656,16269,10589,640,881,824,1403,604,14941
2020-02-26,충북,강원,3722,198,238,201,288,228,4875,3649,217,263,226,310,215,4880
2020-02-26,충북,경기,22433,2198,2843,3033,3565,1120,35192,23079,2296,3081,3442,3288,1107,36293
2020-02-26,충북,경남,955,82,211,521,613,23,2405,671,55,144,253,322,19,1464
2020-02-26,충북,경북,2958,231,503,687,947,111,5437,3115,226,552,705,953,105,5656
2020-02-26,충북,광주,484,25,78,177,99,10,873,448,25,58,112,80,11,734
2020-02-26,충북,대구,627,79,133,213,129,17,1198,953,85,135,241,433,27,1874
2020-02-26,충북,대전,8845,393,394,199,150,693,10674,9904,453,440,203,171,737,11908
2020-02-26,충북,부산,80,14,34,127,165,1,421,80,4,19,82,239,4,428
2020-02-26,충북,서울,10976,682,1109,891,759,457,14874,11329,530,1098,798,627,475,14857
2020-02-26,충북,세종,291,17,20,16,14,31,389,327,8,18,16,13,34,416
2020-02-26,충북,울산,16,2,2,11,43,0,74,13,4,2,20,49,0,88
2020-02-26,충북,전남,305,20,51,113,246,9,744,98,11,15,27,76,3,230
2020-02-26,충북,전북,1378,129,211,299,244,48,2309,1508,125,191,328,452,42,2646
2020-02-26,충북,충남,10589,640,881,824,1403,604,14941,11671,678,881,947,1436,656,16269
2020-02-26,충북,충북,31757,2031,2243,2056,3046,1920,43053,31757,2031,2243,2056,3046,1920,43053
2020-02-27,강원,강원,53992,2055,2725,1430,2307,3684,66193,53992,2055,2725,1430,2307,3684,66193
2020-02-27,강원,경기,16021,580,1171,663,722,758,19915,17957,578,1137,687,864,831,22054
2020-02-27,강원,경남,105,2,13,12,22,1,155,66,2,8,18,30,4,128
2020-02-27,강원,경북,224,23,26,18,24,12,327,258,12,27,27,25,7,356
2020-02-27,강원,광주,44,1,15,10,10,2,82,59,0,13,13,5,1,91
2020-02-27,강원,대구,120,4,9,8,10,4,155,186,7,10,19,26,10,258
2020-02-27,강원,대전,105,1,26,3,1,2,138,122,2,25,6,1,5,161
2020-02-27,강원,부산,2,1,0,3,2,0,8,3,0,1,0,8,0,12
2020-02-27,강원,서울,608,10,230,10,18,25,901,736,12,182,18,5,26,979
2020-02-27,강원,세종,8,0,2,0,0,1,11,1,0,2,0,2,0,5
2020-02-27,강원,울산,1,0,0,0,0,0,1,0,0,0,1,0,0,1
2020-02-27,강원,전남,30,0,2,5,17,0,54,12,0,0,5,4,0,21
2020-02-27,강원,전북,80,5,10,14,10,1,120,137,9,16,28,30,2,222
2020-02-27,강원,충남,235,5,15,28,41,3,327,330,13,15,43,53,11,465
2020-02-27,강원,충북,3631,206,279,263,369,232,4980,3810,199,252,224,303,220,5008
2020-02-27,경기,강원,17957,578,1137,687,864,831,22054,16021,580,1171,663,722,758,19915
2020-02-27,경기,경기,401820,23931,25621,20429,23750,29715,525266,401820,23931,25621,20429,23750,29715,525266
2020-02-27,경기,경남,1898,126,348,817,643,55,3887,1427,84,269,593,462,52,2887
2020-02-27,경기,경북,2313,193,474,764,635,71,4450,2309,208,445,960,640,74,4636
2020-02-27,경기,광주,683,39,175,337,176,16,1426,582,28,140,276,129,13,1168
2020-02-27,경기,대구,925,89,176,397,216,30,1833,1562,106,197,492,436,46,2839
2020-02-27,경기,대전,1662,102,217,120,54,81,2236,1575,105,197,111,49,76,2113
2020-02-27,경기,부산,165,31,34,211,173,6,620,202,23,31,194,275,5,730
2020-02-27,경기,서울,139038,7763,9249,5614,3878,9377,174919,139193,7267,9501,5221,3491,9416,174089
2020-02-27,경기,세종,29,1,2,1,1,0,34,31,3,5,6,2,3,50
2020-02-27,경기,울산,29,1,2,13,16,0,61,29,2,9,37,80,2,159
2020-02-27,경기,전남,602,25,108,176,167,12,1090,491,22,87,111,110,19,840
2020-02-27,경기,전북,1042,59,173,137,183,31,1625,1080,62,164,215,268,31,1820
2020-02-27,경기,충남,32369,1599,2952,2652,4682,1711,45965,31116,1526,2775,2549,4470,1601,44037
2020-02-27,경기,충북,23340,2221,3038,3345,3396,1110,36450,22751,2137,2914,2952,3569,1078,35401
2020-02-27,경남,강원,66,2,8,18,30,4,128,105,2,13,12,22,1,155
2020-02-27,경남,경기,1427,84,269,593,462,52,2887,1898,126,348,817,643,55,3887
2020-02-27,경남,경남,164097,10262,10056,7524,13453,12355,217747,164097,10262,10056,7524,13453,12355,217747
2020-02-27,경남,경북,6294,608,1003,1008,1881,289,11083,7850,871,1123,1312,2683,364,14203
2020-02-27,경남,광주,824,48,139,191,149,28,1379,787,40,127,154,99,24,1231
2020-02-27,경남,대구,7838,723,863,1076,1827,289,12616,5693,495,618,407,509,249,7971
2020-02-27,경남,대전,534,20,99,83,55,25,816,652,32,103,115,76,19,997
2020-02-27,경남,부산,72776,2656,2818,1834,4706,5189,89979,73204,2758,2933,1926,4880,5171,90872
2020-02-27,경남,서울,1523,45,396,321,170,39,2494,1927,64,392,222,125,80,2810
2020-02-27,경남,세종,130,2,15,12,8,7,174,158,3,17,16,16,7,217
2020-02-27,경남,울산,7671,640,695,492,661,486,10645,7283,577,726,456,601,464,10107
2020-02-27,경남,전남,4578,242,458,501,1425,198,7402,4754,285,431,400,1250,192,7312
2020-02-27,경남,전북,769,50,133,103,176,23,1254,750,37,112,106,184,26,1215
2020-02-27,경남,충남,833,50,134,275,269,21,1582,1122,72,166,385,647,40,2432
2020-02-27,경남,충북,738,63,133,315,333,26,1608,969,85,229,537,692,31,2543
2020-02-27,경북,강원,258,12,27,27,25,7,356,224,23,26,18,24,12,327
2020-02-27,경북,경기,2309,208,445,960,640,74,4636,2313,193,474,764,635,71,4450
2020-02-27,경북,경남,7850,871,1123,1312,2683,364,14203,6294,608,1003,1008,1881,289,11083
2020-02-27,경북,경북,51646,3742,3880,3004,4892,2827,69991,51646,3742,3880,3004,4892,2827,69991
2020-02-27,경북,광주,521,58,116,181,157,11,1044,493,46,95,155,79,10,878
2020-02-27,경북,대구,51041,2746,2290,1546,3147,2715,63485,53440,2986,2644,1906,3704,2725,67405
2020-02-27,경북,대전,1181,60,101,119,79,46,1586,1185,67,102,154,81,40,1629
2020-02-27,경북,부산,2622,125,222,196,663,128,3956,2826,130,243,215,828,121,4363
2020-02-27,경북,서울,1606,114,285,436,180,48,2669,1604,87,278,248,121,52,2390
2020-02-27,경북,세종,158,4,12,40,10,7,231,162,6,16,14,7,8,213
2020-02-27,경북,울산,3405,157,334,380,979,182,5437,3395,142,313,335,1185,177,5547
2020-02-27,경북,전남,619,43,76,131,453,18,1340,502,39,57,61,271,16,946
2020-02-27,경북,전북,1434,87,182,187,236,45,2171,1269,101,197,152,474,39,2232
2020-02-27,경북,충남,1999,159,317,633,685,74,3867,2122,135,338,475,841,75,3986
2020-02-27,경북,충북,3121,251,480,710,1055,143,5760,3061,254,501,672,1071,138,5697
2020-02-27,광주,강원,59,0,13,13,5,1,91,44,1,15,10,10,2,82
2020-02-27,광주,경기,582,28,140,276,129,13,1168,683,39,175,337,176,16,1426
2020-02-27,광주,경남,787,40,127,154,99,24,1231,824,48,139,191,149,28,1379
2020-02-27,광주,경북,493,46,95,155,79,10,878,521,58,116,181,157,11,1044
2020-02-27,광주,광주,12472,495,615,464,292,504,14842,12472,495,615,464,292,504,14842
2020-02-27,광주,대구,240,30,53,76,29,5,433,296,34,55,70,40,5,500
2020-02-27,광주,대전,347,19,18,15,15,8,422,390,16,23,30,19,7,485
2020-02-27,광주,부산,305,17,41,35,74,8,480,339,25,45,79,125,6,619
2020-02-27,광주,서울,511,19,33,73,31,13,680,596,24,30,45,20,25,740
2020-02-27,광주,세종,100,3,5,8,4,4,124,141,4,6,5,3,4,163
2020-02-27,광주,울산,35,3,5,1,3,1,48,37,0,7,6,9,0,59
2020-02-27,광주,전남,30844,1004,1162,705,1912,1255,36882,29401,991,1025,637,1846,1211,35111
2020-02-27,광주,전북,6640,422,576,360,388,243,8629,6778,439,493,314,401,233,8658
2020-02-27,광주,충남,3391,128,486,482,293,102,4882,3497,142,483,637,394,94,5247
2020-02-27,광주,충북,426,29,64,120,67,10,716,479,42,86,164,99,11,881
2020-02-27,대구,강원,186,7,10,19,26,10,258,120,4,9,8,10,4,155
2020-02-27,대구,경기,1562,106,197,492,436,46,2839,925,89,176,397,216,30,1833
2020-02-27,대구,경남,5693,495,618,407,509,249,7971,7838,723,863,1076,1827,289,12616
2020-02-27,대구,경북,53440,2986,2644,1906,3704,2725,67405,51041,2746,2290,1546,3147,2715,63485
2020-02-27,대구,광주,296,34,55,70,40,5,500,240,30,53,76,29,5,433
2020-02-27,대구,대구,46554,2077,1684,859,1236,3113,55523,46554,2077,1684,859,1236,3113,55523
2020-02-27,대구,대전,510,42,39,82,56,17,746,345,26,17,60,20,11,479
2020-02-27,대구,부산,374,54,107,94,120,11,760,1565,112,195,108,238,68,2286
2020-02-27,대구,서울,1553,81,121,254,126,53,2188,784,62,67,136,47,23,1119
2020-02-27,대구,세종,126,1,9,11,7,3,157,66,4,1,7,0,3,81
2020-02-27,대구,울산,642,49,94,71,159,25,1040,594,57,92,71,194,27,1035
2020-02-27,대구,전남,271,11,45,26,38,12,403,260,13,38,37,71,8,427
2020-02-27,대구,전북,174,7,31,16,15,4,247,166,8,27,22,20,6,249
2020-02-27,대구,충남,826,63,141,213,274,22,1539,517,51,94,148,171,17,998
2020-02-27,대구,충북,889,97,174,258,412,26,1856,597,80,125,228,152,17,1199
2020-02-27,대전,강원,122,2,25,6,1,5,161,105,1,26,3,1,2,138
2020-02-27,대전,경기,1575,105,197,111,49,76,2113,1662,102,217,120,54,81,2236
2020-02-27,대전,경남,652,32,103,115,76,19,997,534,20,99,83,55,25,816
2020-02-27,대전,경북,1185,67,102,154,81,40,1629,1181,60,101,119,79,46,1586
2020-02-27,대전,광주,390,16,23,30,19,7,485,347,19,18,15,15,8,422
2020-02-27,대전,대구,345,26,17,60,20,11,479,510,42,39,82,56,17,746
2020-02-27,대전,대전,12761,421,419,215,220,938,14974,12761,421,419,215,220,938,14974
2020-02-27,대전,부산,43,5,8,18,24,3,101,59,5,14,16,29,3,126
2020-02-27,대전,서울,1450,39,172,35,9,75,1780,1437,42,170,30,8,63,1750
2020-02-27,대전,세종,3179,128,79,36,39,258,3719,3254,115,82,30,50,244,3775
2020-02-27,대전,울산,58,4,12,23,24,1,122,84,4,10,15,25,3,141
2020-02-27,대전,전남,197,11,4,19,26,11,268,101,3,7,6,8,1,126
2020-02-27,대전,전북,2449,91,89,82,64,132,2907,2627,129,95,82,75,129,3137
2020-02-27,대전,충남,14556,524,529,236,246,1092,17183,13107,500,483,232,195,993,15510
2020-02-27,대전,충북,9963,434,421,191,163,723,11895,8810,384,391,176,158,664,10583
2020-02-27,부산,강원,3,0,1,0,8,0,12,2,1,0,3,2,0,8
2020-02-27,부산,경기,202,23,31,194,275,5,730,165,31,34,211,173,6,620
2020-02-27,부산,경남,73204,2758,2933,1926,4880,5171,90872,72776,2656,2818,1834,4706,5189,89979
2020-02-27,부산,경북,2826,130,243,215,828,121,4363,2622,125,222,196,663,128,3956
2020-02-27,부산,광주,339,25,45,79,125,6,619,305,17,41,35,74,8,480
2020-02-27,부산,대구,1565,112,195,108,238,68,2286,374,54,107,94,120,11,760
2020-02-27,부산,대전,59,5,14,16,29,3,126,43,5,8,18,24,3,101
2020-02-27,부산,부산,35414,700,608,596,1906,2614,41838,35414,700,608,596,1906,2614,41838
2020-02-27,부산,서울,190,18,16,93,92,4,413,202,16,17,60,50,6,351
2020-02-27,부산,세종,14,1,1,2,3,0,21,12,0,1,2,4,0,19
2020-02-27,부산,울산,12715,402,491,626,2619,887,17740,12768,397,393,416,2363,907,17244
2020-02-27,부산,전남,1529,80,105,183,570,51,2518,1465,71,111,137,643,53,2480
2020-02-27,부산,전북,190,7,27,40,99,4,367,179,8,33,39,74,1,334
2020-02-27,부산,충남,115,10,26,84,179,2,416,107,13,30,89,291,3,533
2020-02-27,부산,충북,79,11,25,95,241,2,453,84,15,20,130,198,2,449
2020-02-27,서울,강원,736,12,182,18,5,26,979,608,10,230,10,18,25,901
2020-02-27,서울,경기,139193,7267,9501,5221,3491,9416,174089,139038,7763,9249,5614,3878,9377,174919
2020-02-27,서울,경남,1927,64,392,222,125,80,2810,1523,45,396,321,170,39,2494
2020-02-27,서울,경북,1604,87,278,248,121,52,2390,1606,114,285,436,180,48,2669
2020-02-27,서울,광주,596,24,30,45,20,25,740,511,19,33,73,31,13,680
2020-02-27,서울,대구,784,62,67,136,47,23,1119,1553,81,121,254,126,53,2188
2020-02-27,서울,대전,1437,42,170,30,8,63,1750,1450,39,172,35,9,75,1780
2020-02-27,서울,부산,202,16,17,60,50,6,351,190,18,16,93,92,4,413
2020-02-27,서울,서울,181,12,17,8,1,10,229,181,12,17,8,1,10,229
2020-02-27,서울,세종,23,0,1,2,0,2,28,28,2,0,2,0,1,33
2020-02-27,서울,울산,19,2,3,0,1,1,26,22,2,3,6,14,1,48
2020-02-27,서울,전남,654,11,21,40,29,23,778,577,19,28,83,25,16,748
2020-02-27,서울,전북,1019,25,38,29,34,36,1181,1043,31,51,41,42,28,1236
2020-02-27,서울,충남,22280,560,2094,873,746,924,27477,22574,709,2090,1313,1202,874,28762
2020-02-27,서울,충북,11576,555,1078,822,763,489,15283,11466,672,1091,860,898,450,15437
2020-02-27,세종,강원,1,0,2,0,2,0,5,8,0,2,0,0,1,11
2020-02-27,세종,경기,31,3,5,6,2,3,50,29,1,2,1,1,0,34
2020-02-27,세종,경남,158,3,17,16,16,7,217,130,2,15,12,8,7,174
2020-02-27,세종,경북,162,6,16,14,7,8,213,158,4,12,40,10,7,231
2020-02-27,세종,광주,141,4,6,5,3,4,163,100,3,5,8,4,4,124
2020-02-27,세종,대구,66,4,1,7,0,3,81,126,1,9,11,7,3,157
2020-02-27,세종,대전,3254,115,82,30,50,244,3775,3179,128,79,36,39,258,3719
2020-02-27,세종,부산,12,0,1,2,4,0,19,14,1,1,2,3,0,21
2020-02-27,세종,서울,28,2,0,2,0,1,33,23,0,1,2,0,2,28
2020-02-27,세종,세종,196,27,5,2,0,18,248,196,27,5,2,0,18,248
2020-02-27,세종,울산,9,0,1,2,2,0,14,11,0,1,3,7,0,22
2020-02-27,세종,전남,139,3,6,5,14,3,170,85,0,2,7,14,2,110
2020-02-27,세종,전북,564,17,27,12,41,14,675,620,13,18,14,45,13,723
2020-02-27,세종,충남,5037,153,166,122,190,276,5944,3805,132,142,108,176,209,4572
2020-02-27,세종,충북,310,13,16,23,6,34,402,287,20,19,12,5,21,364
2020-02-27,울산,강원,0,0,0,1,0,0,1,1,0,0,0,0,0,1
2020-02-27,울산,경기,29,2,9,37,80,2,159,29,1,2,13,16,0,61
2020-02-27,울산,경남,7283,577,726,456,601,464,10107,7671,640,695,492,661,486,10645
2020-02-27,울산,경북,3395,142,313,335,1185,177,5547,3405,157,334,380,979,182,5437
2020-02-27,울산,광주,37,0,7,6,9,0,59,35,3,5,1,3,1,48
2020-02-27,울산,대구,594,57,92,71,194,27,1035,642,49,94,71,159,25,1040
2020-02-27,울산,대전,84,4,10,15,25,3,141,58,4,12,23,24,1,122
2020-02-27,울산,부산,12768,397,393,416,2363,907,17244,12715,402,491,626,2619,887,17740
2020-02-27,울산,서울,22,2,3,6,14,1,48,19,2,3,0,1,1,26
2020-02-27,울산,세종,11,0,1,3,7,0,22,9,0,1,2,2,0,14
2020-02-27,울산,울산,6721,281,493,262,708,642,9107,6721,281,493,262,708,642,9107
2020-02-27,울산,전남,139,10,22,12,30,2,215,150,15,15,11,49,1,241
2020-02-27,울산,전북,28,0,5,3,8,1,45,16,0,6,1,4,1,28
2020-02-27,울산,충남,88,4,15,47,139,3,296,72,2,12,40,98,4,228
2020-02-27,울산,충북,21,2,3,14,40,0,80,11,2,1,13,31,0,58
2020-02-27,전남,강원,12,0,0,5,4,0,21,30,0,2,5,17,0,54
2020-02-27,전남,경기,491,22,87,111,110,19,840,602,25,108,176,167,12,1090
2020-02-27,전남,경남,4754,285,431,400,1250,192,7312,4578,242,458,501,1425,198,7402
2020-02-27,전남,경북,502,39,57,61,271,16,946,619,43,76,131,453,18,1340
2020-02-27,전남,광주,29401,991,1025,637,1846,1211,35111,30844,1004,1162,705,1912,1255,36882
2020-02-27,전남,대구,260,13,38,37,71,8,427,271,11,45,26,38,12,403
2020-02-27,전남,대전,101,3,7,6,8,1,126,197,11,4,19,26,11,268
2020-02-27,전남,부산,1465,71,111,137,643,53,2480,1529,80,105,183,570,51,2518
2020-02-27,전남,서울,577,19,28,83,25,16,748,654,11,21,40,29,23,778
2020-02-27,전남,세종,85,0,2,7,14,2,110,139,3,6,5,14,3,170
2020-02-27,전남,울산,150,15,15,11,49,1,241,139,10,22,12,30,2,215
2020-02-27,전남,전남,39913,1381,1522,1546,4643,1567,50572,39913,1381,1522,1546,4643,1567,50572
2020-02-27,전남,전북,6184,316,710,843,2970,171,11194,4200,242,447,562,1337,107,6895
2020-02-27,전남,충남,1562,63,210,501,324,41,2701,3558,102,404,559,1080,112,5815
2020-02-27,전남,충북,116,11,12,42,74,9,264,254,12,45,104,254,13,682
2020-02-27,전북,강원,137,9,16,28,30,2,222,80,5,10,14,10,1,120
2020-02-27,전북,경기,1080,62,164,215,268,31,1820,1042,59,173,137,183,31,1625
2020-02-27,전북,경남,750,37,112,106,184,26,1215,769,50,133,103,176,23,1254
2020-02-27,전북,경북,1269,101,197,152,474,39,2232,1434,87,182,187,236,45,2171
2020-02-27,전북,광주,6778,439,493,314,401,233,8658,6640,422,576,360,388,243,8629
2020-02-27,전북,대구,166,8,27,22,20,6,249,174,7,31,16,15,4,247
2020-02-27,전북,대전,2627,129,95,82,75,129,3137,2449,91,89,82,64,132,2907
2020-02-27,전북,부산,179,8,33,39,74,1,334,190,7,27,40,99,4,367
2020-02-27,전북,서울,1043,31,51,41,42,28,1236,1019,25,38,29,34,36,1181
2020-02-27,전북,세종,620,13,18,14,45,13,723,564,17,27,12,41,14,675
2020-02-27,전북,울산,16,0,6,1,4,1,28,28,0,5,3,8,1,45
2020-02-27,전북,전남,4200,242,447,562,1337,107,6895,6184,316,710,843,2970,171,11194
2020-02-27,전북,전북,15166,587,979,661,1291,576,19260,15166,587,979,661,1291,576,19260
2020-02-27,전북,충남,12632,602,1677,1402,2500,448,19261,10896,519,1448,1001,1410,387,15661
2020-02-27,전북,충북,1567,144,218,364,471,57,2821,1321,142,246,283,289,46,2327
2020-02-27,충남,강원,330,13,15,43,53,11,465,235,5,15,28,41,3,327
2020-02-27,충남,경기,31116,1526,2775,2549,4470,1601,44037,32369,1599,2952,2652,4682,1711,45965
2020-02-27,충남,경남,1122,72,166,385,647,40,2432,833,50,134,275,269,21,1582
2020-02-27,충남,경북,2122,135,338,475,841,75,3986,1999,159,317,633,685,74,3867
2020-02-27,충남,광주,3497,142,483,637,394,94,5247,3391,128,486,482,293,102,4882
2020-02-27,충남,대구,517,51,94,148,171,17,998,826,63,141,213,274,22,1539
2020-02-27,충남,대전,13107,500,483,232,195,993,15510,14556,524,529,236,246,1092,17183
2020-02-27,충남,부산,107,13,30,89,291,3,533,115,10,26,84,179,2,416
2020-02-27,충남,서울,22574,709,2090,1313,1202,874,28762,22280,560,2094,873,746,924,27477
2020-02-27,충남,세종,3805,132,142,108,176,209,4572,5037,153,166,122,190,276,5944
2020-02-27,충남,울산,72,2,12,40,98,4,228,88,4,15,47,139,3,296
2020-02-27,충남,전남,3558,102,404,559,1080,112,5815,1562,63,210,501,324,41,2701
2020-02-27,충남,전북,10896,519,1448,1001,1410,387,15661,12632,602,1677,1402,2500,448,19261
2020-02-27,충남,충남,83551,3729,7807,7433,10907,3959,117386,83551,3729,7807,7433,10907,3959,117386
2020-02-27,충남,충북,11646,682,899,1004,1392,616,16239,10655,683,842,883,1509,600,15172
2020-02-27,충북,강원,3810,199,252,224,303,220,5008,3631,206,279,263,369,232,4980
2020-02-27,충북,경기,22751,2137,2914,2952,3569,1078,35401,23340,2221,3038,3345,3396,1110,36450
2020-02-27,충북,경남,969,85,229,537,692,31,2543,738,63,133,315,333,26,1608
2020-02-27,충북,경북,3061,254,501,672,1071,138,5697,3121,251,480,710,1055,143,5760
2020-02-27,충북,광주,479,42,86,164,99,11,881,426,29,64,120,67,10,716
2020-02-27,충북,대구,597,80,125,228,152,17,1199,889,97,174,258,412,26,1856
2020-02-27,충북,대전,8810,384,391,176,158,664,10583,9963,434,421,191,163,723,11895
2020-02-27,충북,부산,84,15,20,130,198,2,449,79,11,25,95,241,2,453
2020-02-27,충북,서울,11466,672,1091,860,898,450,15437,11576,555,1078,822,763,489,15283
2020-02-27,충북,세종,287,20,19,12,5,21,364,310,13,16,23,6,34,402
2020-02-27,충북,울산,11,2,1,13,31,0,58,21,2,3,14,40,0,80
2020-02-27,충북,전남,254,12,45,104,254,13,682,116,11,12,42,74,9,264
2020-02-27,충북,전북,1321,142,246,283,289,46,2327,1567,144,218,364,471,57,2821
2020-02-27,충북,충남,10655,683,842,883,1509,600,15172,11646,682,899,1004,1392,616,16239
2020-02-27,충북,충북,31926,2007,2256,2067,3048,1839,43143,31926,2007,2256,2067,3048,1839,43143
2020-02-28,강원,강원,58996,2116,2650,1287,2456,3735,71240,58996,2116,2650,1287,2456,3735,71240
2020-02-28,강원,경기,17226,567,1102,637,635,863,21030,21872,585,1078,675,797,987,25994
2020-02-28,강원,경남,120,2,6,19,23,4,174,106,1,11,23,16,3,160
2020-02-28,강원,경북,270,20,16,14,28,13,361,310,15,8,27,28,12,400
2020-02-28,강원,광주,67,2,20,5,7,2,103,75,1,13,15,6,2,112
2020-02-28,강원,대구,128,4,7,8,8,3,158,218,5,7,19,23,6,278
2020-02-28,강원,대전,154,5,27,4,3,8,201,164,7,24,5,1,5,206
2020-02-28,강원,부산,3,1,0,1,2,0,7,4,0,1,2,5,0,12
2020-02-28,강원,서울,608,8,271,9,24,26,946,774,14,221,15,8,29,1061
2020-02-28,강원,세종,7,0,0,0,1,0,8,6,0,0,0,2,1,9
2020-02-28,강원,울산,0,0,0,0,0,0,0,0,0,0,0,1,0,1
2020-02-28,강원,전남,32,1,2,4,3,1,43,29,1,0,3,4,3,40
2020-02-28,강원,전북,103,3,8,8,19,2,143,148,4,12,25,33,1,223
2020-02-28,강원,충남,266,6,26,18,52,15,383,389,7,28,42,72,23,561
2020-02-28,강원,충북,3924,204,260,207,355,243,5193,4282,194,226,204,287,269,5462
2020-02-28,경기,강원,21872,585,1078,675,797,987,25994,17226,567,1102,637,635,863,21030
2020-02-28,경기,경기,392446,21840,23875,18606,21358,29530,507655,392446,21840,23875,18606,21358,29530,507655
2020-02-28,경기,경남,2492,80,333,728,550,116,4299,1984,74,264,566,423,71,3382
2020-02-28,경기,경북,2694,162,470,706,523,93,4648,3130,176,439,972,519,117,5353
2020-02-28,경기,광주,932,30,170,332,147,24,1635,712,26,144,266,101,23,1272
2020-02-28,경기,대구,1078,87,186,369,185,36,1941,1851,107,163,465,361,54,3001
2020-02-28,경기,대전,2242,95,218,119,53,117,2844,1823,101,190,113,41,97,2365
2020-02-28,경기,부산,210,17,41,206,181,8,663,293,18,29,163,236,12,751
2020-02-28,경기,서울,137004,7119,9021,5218,3381,9474,171217,131149,6725,9282,4902,3148,9046,164252
2020-02-28,경기,세종,33,5,3,1,0,2,44,42,2,3,2,0,4,53
2020-02-28,경기,울산,22,0,1,13,15,1,52,37,2,7,39,71,2,158
2020-02-28,경기,전남,833,12,101,165,182,20,1313,685,10,76,95,91,27,984
2020-02-28,경기,전북,1496,56,182,114,187,31,2066,1269,55,162,216,241,39,1982
2020-02-28,경기,충남,34109,1452,2906,2467,4036,1842,46812,35524,1382,2773,2433,3783,1862,47757
2020-02-28,경기,충북,24664,2061,2854,3087,3004,1274,36944,24880,1980,2674,2834,3195,1282,36845
2020-02-28,경남,강원,106,1,11,23,16,3,160,120,2,6,19,23,4,174
2020-02-28,경남,경기,1984,74,264,566,423,71,3382,2492,80,333,728,550,116,4299
2020-02-28,경남,경남,167640,9554,9484,6779,12585,12703,218745,167640,9554,9484,6779,12585,12703,218745
2020-02-28,경남,경북,7144,544,887,875,1796,343,11589,9619,771,1043,1163,2415,459,15470
2020-02-28,경남,광주,1068,48,120,174,120,29,1559,857,37,127,153,112,24,1310
2020-02-28,경남,대구,8818,671,822,991,1515,341,13158,6311,473,605,381,520,288,8578
2020-02-28,경남,대전,731,24,97,79,36,36,1003,820,30,106,111,60,47,1174
2020-02-28,경남,부산,76314,2564,2647,1742,4554,5459,93280,74442,2601,2872,1777,4697,5222,91611
2020-02-28,경남,서울,1873,44,398,306,145,50,2816,2150,55,406,208,146,59,3024
2020-02-28,경남,세종,214,4,13,8,6,7,252,252,4,19,14,11,13,313
2020-02-28,경남,울산,8307,609,688,494,603,527,11228,8105,553,741,446,619,503,10967
2020-02-28,경남,전남,5188,258,405,474,1229,248,7802,5403,283,424,370,1149,240,7869
2020-02-28,경남,전북,1000,37,114,110,195,27,1483,918,28,110,95,176,33,1360
2020-02-28,경남,충남,931,56,116,254,214,30,1601,1657,58,148,351,518,63,2795
2020-02-28,경남,충북,908,42,135,252,297,37,1671,1199,77,195,480,547,50,2548
2020-02-28,경북,강원,310,15,8,27,28,12,400,270,20,16,14,28,13,361
2020-02-28,경북,경기,3130,176,439,972,519,117,5353,2694,162,470,706,523,93,4648
2020-02-28,경북,경남,9619,771,1043,1163,2415,459,15470,7144,544,887,875,1796,343,11589
2020-02-28,경북,경북,52872,3404,3584,2710,4105,2893,69568,52872,3404,3584,2710,4105,2893,69568
2020-02-28,경북,광주,696,54,116,170,132,16,1184,458,29,106,125,80,10,808
2020-02-28,경북,대구,51847,2639,2183,1402,2977,2690,63738,52812,2752,2493,1717,3459,2676,65909
2020-02-28,경북,대전,1461,47,121,99,78,60,1866,1212,47,99,119,68,49,1594
2020-02-28,경북,부산,3422,109,207,189,583,167,4677,3168,117,196,204,764,145,4594
2020-02-28,경북,서울,2025,105,297,394,166,71,3058,1773,74,287,231,113,56,2534
2020-02-28,경북,세종,236,8,18,32,17,13,324,220,3,19,13,14,10,279
2020-02-28,경북,울산,3623,154,308,390,935,210,5620,3695,145,289,323,1199,206,5857
2020-02-28,경북,전남,776,35,66,113,471,18,1479,578,33,65,81,269,16,1042
2020-02-28,경북,전북,1401,80,184,148,204,54,2071,1286,96,179,137,481,48,2227
2020-02-28,경북,충남,2339,120,304,562,575,91,3991,2600,116,344,488,704,115,4367
2020-02-28,경북,충북,3730,203,453,632,991,138,6147,3291,223,512,599,1044,139,5808
2020-02-28,광주,강원,75,1,13,15,6,2,112,67,2,20,5,7,2,103
2020-02-28,광주,경기,712,26,144,266,101,23,1272,932,30,170,332,147,24,1635
2020-02-28,광주,경남,857,37,127,153,112,24,1310,1068,48,120,174,120,29,1559
2020-02-28,광주,경북,458,29,106,125,80,10,808,696,54,116,170,132,16,1184
2020-02-28,광주,광주,11578,474,597,316,293,531,13789,11578,474,597,316,293,531,13789
2020-02-28,광주,대구,314,17,63,69,28,8,499,330,22,63,60,24,8,507
2020-02-28,광주,대전,439,14,17,20,12,12,514,468,21,17,30,21,11,568
2020-02-28,광주,부산,337,14,39,33,63,9,495,408,17,42,76,97,7,647
2020-02-28,광주,서울,711,16,25,78,31,22,883,861,22,27,56,23,15,1004
2020-02-28,광주,세종,166,2,10,10,5,6,199,266,6,9,8,3,7,299
2020-02-28,광주,울산,45,0,11,2,4,3,65,68,0,8,3,9,0,88
2020-02-28,광주,전남,29092,909,1082,566,1620,1245,34514,29740,875,976,524,1607,1240,34962
2020-02-28,광주,전북,6611,418,534,328,373,247,8511,7334,438,451,330,366,259,9178
2020-02-28,광주,충남,3938,91,501,482,222,119,5353,4790,113,549,580,325,132,6489
2020-02-28,광주,충북,504,21,53,93,64,5,740,661,25,75,173,103,27,1064
2020-02-28,대구,강원,218,5,7,19,23,6,278,128,4,7,8,8,3,158
2020-02-28,대구,경기,1851,107,163,465,361,54,3001,1078,87,186,369,185,36,1941
2020-02-28,대구,경남,6311,473,605,381,520,288,8578,8818,671,822,991,1515,341,13158
2020-02-28,대구,경북,52812,2752,2493,1717,3459,2676,65909,51847,2639,2183,1402,2977,2690,63738
2020-02-28,대구,광주,330,22,63,60,24,8,507,314,17,63,69,28,8,499
2020-02-28,대구,대구,46625,1966,1594,778,1177,2980,55120,46625,1966,1594,778,1177,2980,55120
2020-02-28,대구,대전,615,32,30,67,41,30,815,357,22,19,49,22,16,485
2020-02-28,대구,부산,413,47,113,61,171,25,830,1647,114,194,92,223,79,2349
2020-02-28,대구,서울,1896,69,106,196,115,51,2433,911,41,64,105,51,23,1195
2020-02-28,대구,세종,178,2,11,4,8,7,210,94,0,3,5,2,3,107
2020-02-28,대구,울산,726,50,86,69,134,36,1101,744,44,86,79,163,31,1147
2020-02-28,대구,전남,301,14,38,27,44,7,431,326,15,36,21,50,6,454
2020-02-28,대구,전북,195,15,23,14,13,7,267,176,12,26,6,18,4,242
2020-02-28,대구,충남,790,68,115,189,267,20,1449,641,38,87,146,162,27,1101
2020-02-28,대구,충북,990,90,144,248,335,29,1836,719,81,122,189,140,20,1271
2020-02-28,대전,강원,164,7,24,5,1,5,206,154,5,27,4,3,8,201
2020-02-28,대전,경기,1823,101,190,113,41,97,2365,2242,95,218,119,53,117,2844
2020-02-28,대전,경남,820,30,106,111,60,47,1174,731,24,97,79,36,36,1003
2020-02-28,대전,경북,1212,47,99,119,68,49,1594,1461,47,121,99,78,60,1866
2020-02-28,대전,광주,468,21,17,30,21,11,568,439,14,17,20,12,12,514
2020-02-28,대전,대구,357,22,19,49,22,16,485,615,32,30,67,41,30,815
2020-02-28,대전,대전,12362,358,368,242,241,908,14479,12362,358,368,242,241,908,14479
2020-02-28,대전,부산,57,2,9,22,24,0,114,87,4,7,13,16,7,134
2020-02-28,대전,서울,1686,40,183,44,13,54,2020,1797,34,185,32,15,81,2144
2020-02-28,대전,세종,3111,105,79,16,37,257,3605,3122,107,78,24,48,250,3629
2020-02-28,대전,울산,94,5,9,16,20,4,148,144,1,11,8,20,7,191
2020-02-28,대전,전남,234,13,2,25,22,12,308,152,4,5,5,4,6,176
2020-02-28,대전,전북,2459,62,97,73,42,103,2836,2932,81,90,79,60,122,3364
2020-02-28,대전,충남,13832,423,502,224,178,1084,16243,13242,401,465,201,196,980,15485
2020-02-28,대전,충북,9696,426,403,181,163,704,11573,9239,380,390,171,147,670,10997
2020-02-28,부산,강원,4,0,1,2,5,0,12,3,1,0,1,2,0,7
2020-02-28,부산,경기,293,18,29,163,236,12,751,210,17,41,206,181,8,663
2020-02-28,부산,경남,74442,2601,2872,1777,4697,5222,91611,76314,2564,2647,1742,4554,5459,93280
2020-02-28,부산,경북,3168,117,196,204,764,145,4594,3422,109,207,189,583,167,4677
2020-02-28,부산,광주,408,17,42,76,97,7,647,337,14,39,33,63,9,495
2020-02-28,부산,대구,1647,114,194,92,223,79,2349,413,47,113,61,171,25,830
2020-02-28,부산,대전,87,4,7,13,16,7,134,57,2,9,22,24,0,114
2020-02-28,부산,부산,35830,698,611,684,2098,2693,42614,35830,698,611,684,2098,2693,42614
2020-02-28,부산,서울,245,18,16,65,67,6,417,183,15,23,76,45,4,346
2020-02-28,부산,세종,27,0,1,4,2,2,36,27,1,0,1,4,0,33
2020-02-28,부산,울산,13199,364,458,620,2490,935,18066,14507,355,425,391,2242,1033,18953
2020-02-28,부산,전남,1636,78,105,164,486,74,2543,1630,79,83,111,538,74,2515
2020-02-28,부산,전북,255,12,27,24,72,6,396,218,14,33,38,57,4,364
2020-02-28,부산,충남,134,8,19,81,174,4,420,152,8,30,76,212,6,484
2020-02-28,부산,충북,104,7,17,87,201,3,419,110,14,24,110,191,2,451
2020-02-28,서울,강원,774,14,221,15,8,29,1061,608,8,271,9,24,26,946
2020-02-28,서울,경기,131149,6725,9282,4902,3148,9046,164252,137004,7119,9021,5218,3381,9474,171217
2020-02-28,서울,경남,2150,55,406,208,146,59,3024,1873,44,398,306,145,50,2816
2020-02-28,서울,경북,1773,74,287,231,113,56,2534,2025,105,297,394,166,71,3058
2020-02-28,서울,광주,861,22,27,56,23,15,1004,711,16,25,78,31,22,883
2020-02-28,서울,대구,911,41,64,105,51,23,1195,1896,69,106,196,115,51,2433
2020-02-28,서울,대전,1797,34,185,32,15,81,2144,1686,40,183,44,13,54,2020
2020-02-28,서울,부산,183,15,23,76,45,4,346,245,18,16,65,67,6,417
2020-02-28,서울,서울,228,5,6,4,4,6,253,228,5,6,4,4,6,253
2020-02-28,서울,세종,30,1,0,0,0,0,31,41,0,0,1,0,1,43
2020-02-28,서울,울산,25,0,2,3,2,0,32,26,0,4,10,10,0,50
2020-02-28,서울,전남,887,8,20,31,30,18,994,759,13,21,53,32,28,906
2020-02-28,서울,전북,1332,14,43,23,23,51,1486,1246,32,35,35,33,35,1416
2020-02-28,서울,충남,24231,493,2155,768,681,993,29321,26119,615,2175,1194,1060,1045,32208
2020-02-28,서울,충북,12080,506,1066,768,632,525,15577,13478,614,1070,813,767,535,17277
2020-02-28,세종,강원,6,0,0,0,2,1,9,7,0,0,0,1,0,8
2020-02-28,세종,경기,42,2,3,2,0,4,53,33,5,3,1,0,2,44
2020-02-28,세종,경남,252,4,19,14,11,13,313,214,4,13,8,6,7,252
2020-02-28,세종,경북,220,3,19,13,14,10,279,236,8,18,32,17,13,324
2020-02-28,세종,광주,266,6,9,8,3,7,299,166,2,10,10,5,6,199
2020-02-28,세종,대구,94,0,3,5,2,3,107,178,2,11,4,8,7,210
2020-02-28,세종,대전,3122,107,78,24,48,250,3629,3111,105,79,16,37,257,3605
2020-02-28,세종,부산,27,1,0,1,4,0,33,27,0,1,4,2,2,36
2020-02-28,세종,서울,41,0,0,1,0,1,43,30,1,0,0,0,0,31
2020-02-28,세종,세종,200,23,1,1,0,12,237,200,23,1,1,0,12,237
2020-02-28,세종,울산,8,0,0,2,4,0,14,11,0,2,2,6,1,22
2020-02-28,세종,전남,183,3,5,6,12,6,215,132,0,2,7,5,5,151
2020-02-28,세종,전북,640,18,25,17,60,22,782,757,14,25,19,64,22,901
2020-02-28,세종,충남,4955,143,150,110,179,261,5798,4325,115,149,110,148,221,5068
2020-02-28,세종,충북,285,12,24,18,8,30,377,273,11,21,14,6,26,351
2020-02-28,울산,강원,0,0,0,0,1,0,1,0,0,0,0,0,0,0
2020-02-28,울산,경기,37,2,7,39,71,2,158,22,0,1,13,15,1,52
2020-02-28,울산,경남,8105,553,741,446,619,503,10967,8307,609,688,494,603,527,11228
2020-02-28,울산,경북,3695,145,289,323,1199,206,5857,3623,154,308,390,935,210,5620
2020-02-28,울산,광주,68,0,8,3,9,0,88,45,0,11,2,4,3,65
2020-02-28,울산,대구,744,44,86,79,163,31,1147,726,50,86,69,134,36,1101
2020-02-28,울산,대전,144,1,11,8,20,7,191,94,5,9,16,20,4,148
2020-02-28,울산,부산,14507,355,425,391,2242,1033,18953,13199,364,458,620,2490,935,18066
2020-02-28,울산,서울,26,0,4,10,10,0,50,25,0,2,3,2,0,32
2020-02-28,울산,세종,11,0,2,2,6,1,22,8,0,0,2,4,0,14
2020-02-28,울산,울산,6877,277,469,290,611,664,9188,6877,277,469,290,611,664,9188
2020-02-28,울산,전남,179,9,17,10,24,7,246,219,9,24,12,43,5,312
2020-02-28,울산,전북,46,1,7,1,12,0,67,28,0,5,1,6,1,41
2020-02-28,울산,충남,96,4,19,47,90,2,258,100,6,14,21,113,3,257
2020-02-28,울산,충북,11,3,3,22,43,0,82,9,0,5,11,22,1,48
2020-02-28,전남,강원,29,1,0,3,4,3,40,32,1,2,4,3,1,43
2020-02-28,전남,경기,685,10,76,95,91,27,984,833,12,101,165,182,20,1313
2020-02-28,전남,경남,5403,283,424,370,1149,240,7869,5188,258,405,474,1229,248,7802
2020-02-28,전남,경북,578,33,65,81,269,16,1042,776,35,66,113,471,18,1479
2020-02-28,전남,광주,29740,875,976,524,1607,1240,34962,29092,909,1082,566,1620,1245,34514
2020-02-28,전남,대구,326,15,36,21,50,6,454,301,14,38,27,44,7,431
2020-02-28,전남,대전,152,4,5,5,4,6,176,234,13,2,25,22,12,308
2020-02-28,전남,부산,1630,79,83,111,538,74,2515,1636,78,105,164,486,74,2543
2020-02-28,전남,서울,759,13,21,53,32,28,906,887,8,20,31,30,18,994
2020-02-28,전남,세종,132,0,2,7,5,5,151,183,3,5,6,12,6,215
2020-02-28,전남,울산,219,9,24,12,43,5,312,179,9,17,10,24,7,246
2020-02-28,전남,전남,41011,1212,1344,1313,3998,1703,50581,41011,1212,1344,1313,3998,1703,50581
2020-02-28,전남,전북,6915,267,668,713,2400,214,11177,4038,190,435,490,1189,141,6483
2020-02-28,전남,충남,1927,52,226,405,270,53,2933,4616,98,414,496,999,134,6757
2020-02-28,전남,충북,153,6,12,36,56,2,265,372,12,51,95,234,8,772
2020-02-28,전북,강원,148,4,12,25,33,1,223,103,3,8,8,19,2,143
2020-02-28,전북,경기,1269,55,162,216,241,39,1982,1496,56,182,114,187,31,2066
2020-02-28,전북,경남,918,28,110,95,176,33,1360,1000,37,114,110,195,27,1483
2020-02-28,전북,경북,1286,96,179,137,481,48,2227,1401,80,184,148,204,54,2071
2020-02-28,전북,광주,7334,438,451,330,366,259,9178,6611,418,534,328,373,247,8511
2020-02-28,전북,대구,176,12,26,6,18,4,242,195,15,23,14,13,7,267
2020-02-28,전북,대전,2932,81,90,79,60,122,3364,2459,62,97,73,42,103,2836
2020-02-28,전북,부산,218,14,33,38,57,4,364,255,12,27,24,72,6,396
2020-02-28,전북,서울,1246,32,35,35,33,35,1416,1332,14,43,23,23,51,1486
2020-02-28,전북,세종,757,14,25,19,64,22,901,640,18,25,17,60,22,782
2020-02-28,전북,울산,28,0,5,1,6,1,41,46,1,7,1,12,0,67
2020-02-28,전북,전남,4038,190,435,490,1189,141,6483,6915,267,668,713,2400,214,11177
2020-02-28,전북,전북,14090,549,838,629,1084,590,17780,14090,549,838,629,1084,590,17780
2020-02-28,전북,충남,14619,510,1637,1283,2066,535,20650,13194,458,1421,928,1335,502,17838
2020-02-28,전북,충북,1734,111,191,323,401,62,2822,1715,103,196,260,269,44,2587
2020-02-28,충남,강원,389,7,28,42,72,23,561,266,6,26,18,52,15,383
2020-02-28,충남,경기,35524,1382,2773,2433,3783,1862,47757,34109,1452,2906,2467,4036,1842,46812
2020-02-28,충남,경남,1657,58,148,351,518,63,2795,931,56,116,254,214,30,1601
2020-02-28,충남,경북,2600,116,344,488,704,115,4367,2339,120,304,562,575,91,3991
2020-02-28,충남,광주,4790,113,549,580,325,132,6489,3938,91,501,482,222,119,5353
2020-02-28,충남,대구,641,38,87,146,162,27,1101,790,68,115,189,267,20,1449
2020-02-28,충남,대전,13242,401,465,201,196,980,15485,13832,423,502,224,178,1084,16243
2020-02-28,충남,부산,152,8,30,76,212,6,484,134,8,19,81,174,4,420
2020-02-28,충남,서울,26119,615,2175,1194,1060,1045,32208,24231,493,2155,768,681,993,29321
2020-02-28,충남,세종,4325,115,149,110,148,221,5068,4955,143,150,110,179,261,5798
2020-02-28,충남,울산,100,6,14,21,113,3,257,96,4,19,47,90,2,258
2020-02-28,충남,전남,4616,98,414,496,999,134,6757,1927,52,226,405,270,53,2933
2020-02-28,충남,전북,13194,458,1421,928,1335,502,17838,14619,510,1637,1283,2066,535,20650
2020-02-28,충남,충남,88622,3394,7620,6986,9504,4334,120460,88622,3394,7620,6986,9504,4334,120460
2020-02-28,충남,충북,11752,624,839,930,1392,710,16247,10444,583,785,785,1357,627,14581
2020-02-28,충북,강원,4282,194,226,204,287,269,5462,3924,204,260,207,355,243,5193
2020-02-28,충북,경기,24880,1980,2674,2834,3195,1282,36845,24664,2061,2854,3087,3004,1274,36944
2020-02-28,충북,경남,1199,77,195,480,547,50,2548,908,42,135,252,297,37,1671
2020-02-28,충북,경북,3291,223,512,599,1044,139,5808,3730,203,453,632,991,138,6147
2020-02-28,충북,광주,661,25,75,173,103,27,1064,504,21,53,93,64,5,740
2020-02-28,충북,대구,719,81,122,189,140,20,1271,990,90,144,248,335,29,1836
2020-02-28,충북,대전,9239,380,390,171,147,670,10997,9696,426,403,181,163,704,11573
2020-02-28,충북,부산,110,14,24,110,191,2,451,104,7,17,87,201,3,419
2020-02-28,충북,서울,13478,614,1070,813,767,535,17277,12080,506,1066,768,632,525,15577
2020-02-28,충북,세종,273,11,21,14,6,26,351,285,12,24,18,8,30,377
2020-02-28,충북,울산,9,0,5,11,22,1,48,11,3,3,22,43,0,82
2020-02-28,충북,전남,372,12,51,95,234,8,772,153,6,12,36,56,2,265
2020-02-28,충북,전북,1715,103,196,260,269,44,2587,1734,111,191,323,401,62,2822
2020-02-28,충북,충남,10444,583,785,785,1357,627,14581,11752,624,839,930,1392,710,16247
2020-02-28,충북,충북,31231,1825,2127,2039,2665,1958,41845,31231,1825,2127,2039,2665,1958,41845
2020-02-29,강원,강원,67360,1483,2006,739,1791,3599,76978,67360,1483,2006,739,1791,3599,76978
2020-02-29,강원,경기,24902,308,834,359,365,1043,27811,32927,335,854,397,474,1292,36279
2020-02-29,강원,경남,119,3,18,4,7,4,155,103,1,2,5,10,0,121
2020-02-29,강원,경북,308,13,6,14,11,16,368,297,12,13,14,15,22,373
2020-02-29,강원,광주,71,4,15,7,0,3,100,48,1,10,6,2,2,69
2020-02-29,강원,대구,107,1,5,4,1,4,122,241,4,5,7,4,8,269
2020-02-29,강원,대전,143,2,24,1,0,5,175,177,5,23,2,0,5,212
2020-02-29,강원,부산,2,0,0,1,1,0,4,3,0,1,0,0,0,4
2020-02-29,강원,서울,794,5,257,5,10,26,1097,1334,8,203,7,6,45,1603
2020-02-29,강원,세종,3,0,0,1,1,0,5,6,0,1,0,2,0,9
2020-02-29,강원,울산,1,0,0,0,0,0,1,3,0,0,0,0,0,3
2020-02-29,강원,전남,31,2,2,0,4,1,40,20,2,2,1,2,0,27
2020-02-29,강원,전북,102,1,5,9,7,2,126,145,4,9,14,12,1,185
2020-02-29,강원,충남,311,0,10,8,19,12,360,483,9,17,28,35,18,590
2020-02-29,강원,충북,3518,129,188,123,208,154,4320,3995,126,159,117,179,212,4788
2020-02-29,경기,강원,32927,335,854,397,474,1292,36279,24902,308,834,359,365,1043,27811
2020-02-29,경기,경기,315412,10577,12269,9636,11944,19911,379749,315412,10577,12269,9636,11944,19911,379749
2020-02-29,경기,경남,1956,42,230,427,303,92,3050,1494,39,186,295,226,59,2299
2020-02-29,경기,경북,2499,85,225,396,322,99,3626,2275,83,202,475,313,92,3440
2020-02-29,경기,광주,833,13,130,160,77,28,1241,616,8,82,134,51,20,911
2020-02-29,경기,대구,716,31,91,198,85,26,1147,1447,40,104,248,181,65,2085
2020-02-29,경기,대전,2191,54,173,80,34,131,2663,1806,54,168,59,25,111,2223
2020-02-29,경기,부산,221,13,16,127,87,9,473,230,5,16,85,99,4,439
2020-02-29,경기,서울,113682,4154,5387,2937,2652,6556,135368,112040,3704,5569,2363,2297,6434,132407
2020-02-29,경기,세종,31,1,3,0,0,1,36,47,2,1,4,1,1,56
2020-02-29,경기,울산,25,0,4,1,10,0,40,36,7,3,12,30,4,92
2020-02-29,경기,전남,889,11,81,94,100,22,1197,611,14,52,58,54,17,806
2020-02-29,경기,전북,1601,23,118,74,110,53,1979,1298,20,108,109,99,44,1678
2020-02-29,경기,충남,35211,679,1687,1230,1963,1670,42440,31768,645,1664,1130,2024,1540,38771
2020-02-29,경기,충북,23774,957,1439,1648,1760,1127,30705,22139,914,1314,1425,2069,1033,28894
2020-02-29,경남,강원,103,1,2,5,10,0,121,119,3,18,4,7,4,155
2020-02-29,경남,경기,1494,39,186,295,226,59,2299,1956,42,230,427,303,92,3050
2020-02-29,경남,경남,124511,5048,4745,3297,7835,8361,153797,124511,5048,4745,3297,7835,8361,153797
2020-02-29,경남,경북,6005,213,449,337,784,302,8090,7871,289,465,539,1005,373,10542
2020-02-29,경남,광주,1003,17,74,92,77,29,1292,890,16,49,66,37,22,1080
2020-02-29,경남,대구,6337,291,467,448,543,237,8323,5879,209,344,195,197,224,7048
2020-02-29,경남,대전,630,6,79,25,22,24,786,882,19,87,79,35,36,1138
2020-02-29,경남,부산,63955,1449,1819,1097,2190,4063,74573,50196,1249,1402,887,1950,3176,58860
2020-02-29,경남,서울,1555,18,350,129,53,50,2155,2081,34,386,121,73,75,2770
2020-02-29,경남,세종,132,1,8,2,2,6,151,203,6,14,0,4,10,237
2020-02-29,경남,울산,7269,320,325,182,204,450,8750,6208,273,304,143,192,321,7441
2020-02-29,경남,전남,5245,132,227,250,616,232,6702,4872,147,220,174,581,226,6220
2020-02-29,경남,전북,1050,19,73,38,63,43,1286,896,24,71,33,81,36,1141
2020-02-29,경남,충남,732,19,47,85,84,32,999,1214,21,73,175,235,54,1772
2020-02-29,경남,충북,806,17,82,127,145,24,1201,1061,28,119,228,349,29,1814
2020-02-29,경북,강원,297,12,13,14,15,22,373,308,13,6,14,11,16,368
2020-02-29,경북,경기,2275,83,202,475,313,92,3440,2499,85,225,396,322,99,3626
2020-02-29,경북,경남,7871,289,465,539,1005,373,10542,6005,213,449,337,784,302,8090
2020-02-29,경북,경북,49390,2081,1997,1595,2487,2414,59964,49390,2081,1997,1595,2487,2414,59964
2020-02-29,경북,광주,530,28,58,65,60,13,754,466,22,59,56,32,6,641
2020-02-29,경북,대구,33741,1306,1013,934,1725,1541,40260,46709,1641,1349,1257,2141,2087,55184
2020-02-29,경북,대전,1282,30,56,53,44,62,1527,1314,24,54,88,36,62,1578
2020-02-29,경북,부산,3497,63,140,86,252,179,4217,3522,54,141,78,292,159,4246
2020-02-29,경북,서울,1753,36,218,174,86,68,2335,2021,35,237,144,89,71,2597
2020-02-29,경북,세종,225,2,4,17,6,7,261,236,3,8,5,7,8,267
2020-02-29,경북,울산,3680,62,135,186,628,198,4889,3815,59,147,137,678,236,5072
2020-02-29,경북,전남,844,33,42,37,206,30,1192,608,31,35,22,134,23,853
2020-02-29,경북,전북,1430,54,99,91,115,49,1838,1308,56,112,67,229,42,1814
2020-02-29,경북,충남,2037,60,134,188,243,83,2745,2480,54,164,242,310,98,3348
2020-02-29,경북,충북,3366,95,244,292,466,131,4594,3239,134,277,358,593,130,4731
2020-02-29,광주,강원,48,1,10,6,2,2,69,71,4,15,7,0,3,100
2020-02-29,광주,경기,616,8,82,134,51,20,911,833,13,130,160,77,28,1241
2020-02-29,광주,경남,890,16,49,66,37,22,1080,1003,17,74,92,77,29,1292
2020-02-29,광주,경북,466,22,59,56,32,6,641,530,28,58,65,60,13,754
2020-02-29,광주,광주,10797,345,450,189,158,367,12306,10797,345,450,189,158,367,12306
2020-02-29,광주,대구,218,12,39,40,10,6,325,331,12,45,52,5,15,460
2020-02-29,광주,대전,424,9,6,9,7,11,466,453,2,12,19,11,12,509
2020-02-29,광주,부산,327,3,45,12,29,14,430,356,2,50,20,34,7,469
2020-02-29,광주,서울,504,11,10,43,15,14,597,769,13,17,36,14,18,867
2020-02-29,광주,세종,156,2,6,2,1,1,168,194,1,5,2,3,8,213
2020-02-29,광주,울산,36,1,7,0,2,1,47,41,1,7,2,3,0,54
2020-02-29,광주,전남,32481,630,797,422,928,1149,36407,30067,607,756,361,991,1080,33862
2020-02-29,광주,전북,7276,231,283,139,199,215,8343,7273,278,267,157,234,220,8429
2020-02-29,광주,충남,3837,38,433,220,105,112,4745,4313,60,451,358,177,124,5483
2020-02-29,광주,충북,446,12,36,40,15,10,559,588,11,47,70,52,9,777
2020-02-29,대구,강원,241,4,5,7,4,8,269,107,1,5,4,1,4,122
2020-02-29,대구,경기,1447,40,104,248,181,65,2085,716,31,91,198,85,26,1147
2020-02-29,대구,경남,5879,209,344,195,197,224,7048,6337,291,467,448,543,237,8323
2020-02-29,대구,경북,46709,1641,1349,1257,2141,2087,55184,33741,1306,1013,934,1725,1541,40260
2020-02-29,대구,광주,331,12,45,52,5,15,460,218,12,39,40,10,6,325
2020-02-29,대구,대구,29204,925,721,398,714,1729,33691,29204,925,721,398,714,1729,33691
2020-02-29,대구,대전,595,15,19,36,29,19,713,267,9,8,28,7,4,323
2020-02-29,대구,부산,478,14,70,46,60,17,685,1308,28,126,40,99,57,1658
2020-02-29,대구,서울,1675,26,91,99,50,49,1990,748,18,57,69,27,25,944
2020-02-29,대구,세종,148,1,7,1,0,8,165,75,0,0,3,1,3,82
2020-02-29,대구,울산,660,25,50,37,89,34,895,379,17,41,24,84,10,555
2020-02-29,대구,전남,414,8,31,15,16,10,494,299,8,32,11,12,13,375
2020-02-29,대구,전북,210,4,14,7,11,7,253,156,1,9,10,8,6,190
2020-02-29,대구,충남,707,28,47,76,81,22,961,375,17,26,67,62,13,560
2020-02-29,대구,충북,983,32,81,112,157,28,1393,553,27,58,129,60,12,839
2020-02-29,대전,강원,177,5,23,2,0,5,212,143,2,24,1,0,5,175
2020-02-29,대전,경기,1806,54,168,59,25,111,2223,2191,54,173,80,34,131,2663
2020-02-29,대전,경남,882,19,87,79,35,36,1138,630,6,79,25,22,24,786
2020-02-29,대전,경북,1314,24,54,88,36,62,1578,1282,30,56,53,44,62,1527
2020-02-29,대전,광주,453,2,12,19,11,12,509,424,9,6,9,7,11,466
2020-02-29,대전,대구,267,9,8,28,7,4,323,595,15,19,36,29,19,713
2020-02-29,대전,대전,10040,217,259,129,96,663,11404,10040,217,259,129,96,663,11404
2020-02-29,대전,부산,69,1,1,15,12,5,103,84,3,6,10,16,1,120
2020-02-29,대전,서울,1641,26,179,16,10,83,1955,1928,12,182,28,8,81,2239
2020-02-29,대전,세종,2320,79,67,24,35,153,2678,2208,76,52,16,39,164,2555
2020-02-29,대전,울산,73,1,8,9,7,4,102,95,2,7,5,12,7,128
2020-02-29,대전,전남,329,2,5,16,19,10,381,118,2,5,6,2,5,138
2020-02-29,대전,전북,3098,45,59,52,24,137,3415,3107,59,56,38,34,135,3429
2020-02-29,대전,충남,11763,241,319,140,105,660,13228,11007,244,317,125,114,645,12452
2020-02-29,대전,충북,8088,282,309,108,113,468,9368,7536,255,288,108,95,462,8744
2020-02-29,부산,강원,3,0,1,0,0,0,4,2,0,0,1,1,0,4
2020-02-29,부산,경기,230,5,16,85,99,4,439,221,13,16,127,87,9,473
2020-02-29,부산,경남,50196,1249,1402,887,1950,3176,58860,63955,1449,1819,1097,2190,4063,74573
2020-02-29,부산,경북,3522,54,141,78,292,159,4246,3497,63,140,86,252,179,4217
2020-02-29,부산,광주,356,2,50,20,34,7,469,327,3,45,12,29,14,430
2020-02-29,부산,대구,1308,28,126,40,99,57,1658,478,14,70,46,60,17,685
2020-02-29,부산,대전,84,3,6,10,16,1,120,69,1,1,15,12,5,103
2020-02-29,부산,부산,36745,383,347,468,1023,2268,41234,36745,383,347,468,1023,2268,41234
2020-02-29,부산,서울,192,6,8,37,22,9,274,252,1,14,55,28,9,359
2020-02-29,부산,세종,18,1,0,1,3,1,24,27,0,1,1,2,1,32
2020-02-29,부산,울산,12135,188,228,248,1078,768,14645,13180,187,160,165,1068,842,15602
2020-02-29,부산,전남,1710,30,75,73,279,68,2235,1468,26,85,58,258,53,1948
2020-02-29,부산,전북,249,3,27,11,49,11,350,207,6,26,8,36,4,287
2020-02-29,부산,충남,125,4,7,25,71,3,235,124,5,15,50,112,1,307
2020-02-29,부산,충북,97,1,6,33,97,3,237,94,6,15,61,86,6,268
2020-02-29,서울,강원,1334,8,203,7,6,45,1603,794,5,257,5,10,26,1097
2020-02-29,서울,경기,112040,3704,5569,2363,2297,6434,132407,113682,4154,5387,2937,2652,6556,135368
2020-02-29,서울,경남,2081,34,386,121,73,75,2770,1555,18,350,129,53,50,2155
2020-02-29,서울,경북,2021,35,237,144,89,71,2597,1753,36,218,174,86,68,2335
2020-02-29,서울,광주,769,13,17,36,14,18,867,504,11,10,43,15,14,597
2020-02-29,서울,대구,748,18,57,69,27,25,944,1675,26,91,99,50,49,1990
2020-02-29,서울,대전,1928,12,182,28,8,81,2239,1641,26,179,16,10,83,1955
2020-02-29,서울,부산,252,1,14,55,28,9,359,192,6,8,37,22,9,274
2020-02-29,서울,서울,175,5,11,1,0,11,203,175,5,11,1,0,11,203
2020-02-29,서울,세종,17,0,0,4,0,0,21,31,1,0,1,0,2,35
2020-02-29,서울,울산,29,1,1,3,0,1,35,27,1,3,4,9,1,45
2020-02-29,서울,전남,995,5,14,21,23,34,1092,619,3,14,25,13,22,696
2020-02-29,서울,전북,1511,8,32,12,22,48,1633,1039,9,29,16,18,34,1145
2020-02-29,서울,충남,28509,272,1882,486,429,1134,32712,27272,310,1833,558,643,1091,31707
2020-02-29,서울,충북,13326,203,780,472,377,550,15708,12375,252,751,464,534,518,14894
2020-02-29,세종,강원,6,0,1,0,2,0,9,3,0,0,1,1,0,5
2020-02-29,세종,경기,47,2,1,4,1,1,56,31,1,3,0,0,1,36
2020-02-29,세종,경남,203,6,14,0,4,10,237,132,1,8,2,2,6,151
2020-02-29,세종,경북,236,3,8,5,7,8,267,225,2,4,17,6,7,261
2020-02-29,세종,광주,194,1,5,2,3,8,213,156,2,6,2,1,1,168
2020-02-29,세종,대구,75,0,0,3,1,3,82,148,1,7,1,0,8,165
2020-02-29,세종,대전,2208,76,52,16,39,164,2555,2320,79,67,24,35,153,2678
2020-02-29,세종,부산,27,0,1,1,2,1,32,18,1,0,1,3,1,24
2020-02-29,세종,서울,31,1,0,1,0,2,35,17,0,0,4,0,0,21
2020-02-29,세종,세종,163,24,1,0,0,14,202,163,24,1,0,0,14,202
2020-02-29,세종,울산,6,0,0,0,0,1,7,15,0,2,1,1,0,19
2020-02-29,세종,전남,201,1,5,6,12,4,229,114,0,0,3,5,2,124
2020-02-29,세종,전북,849,9,16,10,33,36,953,757,7,11,7,35,29,846
2020-02-29,세종,충남,4930,116,89,59,92,213,5499,3844,97,89,56,102,142,4330
2020-02-29,세종,충북,270,7,10,13,8,17,325,243,10,15,8,10,24,310
2020-02-29,울산,강원,3,0,0,0,0,0,3,1,0,0,0,0,0,1
2020-02-29,울산,경기,36,7,3,12,30,4,92,25,0,4,1,10,0,40
2020-02-29,울산,경남,6208,273,304,143,192,321,7441,7269,320,325,182,204,450,8750
2020-02-29,울산,경북,3815,59,147,137,678,236,5072,3680,62,135,186,628,198,4889
2020-02-29,울산,광주,41,1,7,2,3,0,54,36,1,7,0,2,1,47
2020-02-29,울산,대구,379,17,41,24,84,10,555,660,25,50,37,89,34,895
2020-02-29,울산,대전,95,2,7,5,12,7,128,73,1,8,9,7,4,102
2020-02-29,울산,부산,13180,187,160,165,1068,842,15602,12135,188,228,248,1078,768,14645
2020-02-29,울산,서울,27,1,3,4,9,1,45,29,1,1,3,0,1,35
2020-02-29,울산,세종,15,0,2,1,1,0,19,6,0,0,0,0,1,7
2020-02-29,울산,울산,4655,120,126,180,272,382,5735,4655,120,126,180,272,382,5735
2020-02-29,울산,전남,161,4,5,5,6,3,184,160,8,9,8,8,5,198
2020-02-29,울산,전북,35,1,5,0,8,4,53,28,0,6,1,0,1,36
2020-02-29,울산,충남,84,1,6,16,51,5,163,68,1,6,12,49,3,139
2020-02-29,울산,충북,7,1,2,2,20,2,34,7,1,0,4,22,0,34
2020-02-29,전남,강원,20,2,2,1,2,0,27,31,2,2,0,4,1,40
2020-02-29,전남,경기,611,14,52,58,54,17,806,889,11,81,94,100,22,1197
2020-02-29,전남,경남,4872,147,220,174,581,226,6220,5245,132,227,250,616,232,6702
2020-02-29,전남,경북,608,31,35,22,134,23,853,844,33,42,37,206,30,1192
2020-02-29,전남,광주,30067,607,756,361,991,1080,33862,32481,630,797,422,928,1149,36407
2020-02-29,전남,대구,299,8,32,11,12,13,375,414,8,31,15,16,10,494
2020-02-29,전남,대전,118,2,5,6,2,5,138,329,2,5,16,19,10,381
2020-02-29,전남,부산,1468,26,85,58,258,53,1948,1710,30,75,73,279,68,2235
2020-02-29,전남,서울,619,3,14,25,13,22,696,995,5,14,21,23,34,1092
2020-02-29,전남,세종,114,0,0,3,5,2,124,201,1,5,6,12,4,229
2020-02-29,전남,울산,160,8,9,8,8,5,198,161,4,5,5,6,3,184
2020-02-29,전남,전남,39298,797,938,791,2621,1313,45758,39298,797,938,791,2621,1313,45758
2020-02-29,전남,전북,7416,193,463,322,1135,219,9748,4978,129,249,311,753,141,6561
2020-02-29,전남,충남,1601,36,126,185,111,41,2100,4723,51,336,298,506,144,6058
2020-02-29,전남,충북,111,5,10,23,22,4,175,365,8,27,61,136,12,609
2020-02-29,전북,강원,145,4,9,14,12,1,185,102,1,5,9,7,2,126
2020-02-29,전북,경기,1298,20,108,109,99,44,1678,1601,23,118,74,110,53,1979
2020-02-29,전북,경남,896,24,71,33,81,36,1141,1050,19,73,38,63,43,1286
2020-02-29,전북,경북,1308,56,112,67,229,42,1814,1430,54,99,91,115,49,1838
2020-02-29,전북,광주,7273,278,267,157,234,220,8429,7276,231,283,139,199,215,8343
2020-02-29,전북,대구,156,1,9,10,8,6,190,210,4,14,7,11,7,253
2020-02-29,전북,대전,3107,59,56,38,34,135,3429,3098,45,59,52,24,137,3415
2020-02-29,전북,부산,207,6,26,8,36,4,287,249,3,27,11,49,11,350
2020-02-29,전북,서울,1039,9,29,16,18,34,1145,1511,8,32,12,22,48,1633
2020-02-29,전북,세종,757,7,11,7,35,29,846,849,9,16,10,33,36,953
2020-02-29,전북,울산,28,0,6,1,0,1,36,35,1,5,0,8,4,53
2020-02-29,전북,전남,4978,129,249,311,753,141,6561,7416,193,463,322,1135,219,9748
2020-02-29,전북,전북,14023,379,650,430,718,511,16711,14023,379,650,430,718,511,16711
2020-02-29,전북,충남,14733,280,1169,555,919,489,18145,14247,249,1058,534,752,529,17369
2020-02-29,전북,충북,1716,53,77,146,192,56,2240,1783,54,89,122,150,71,2269
2020-02-29,충남,강원,483,9,17,28,35,18,590,311,0,10,8,19,12,360
2020-02-29,충남,경기,31768,645,1664,1130,2024,1540,38771,35211,679,1687,1230,1963,1670,42440
2020-02-29,충남,경남,1214,21,73,175,235,54,1772,732,19,47,85,84,32,999
2020-02-29,충남,경북,2480,54,164,242,310,98,3348,2037,60,134,188,243,83,2745
2020-02-29,충남,광주,4313,60,451,358,177,124,5483,3837,38,433,220,105,112,4745
2020-02-29,충남,대구,375,17,26,67,62,13,560,707,28,47,76,81,22,961
2020-02-29,충남,대전,11007,244,317,125,114,645,12452,11763,241,319,140,105,660,13228
2020-02-29,충남,부산,124,5,15,50,112,1,307,125,4,7,25,71,3,235
2020-02-29,충남,서울,27272,310,1833,558,643,1091,31707,28509,272,1882,486,429,1134,32712
2020-02-29,충남,세종,3844,97,89,56,102,142,4330,4930,116,89,59,92,213,5499
2020-02-29,충남,울산,68,1,6,12,49,3,139,84,1,6,16,51,5,163
2020-02-29,충남,전남,4723,51,336,298,506,144,6058,1601,36,126,185,111,41,2100
2020-02-29,충남,전북,14247,249,1058,534,752,529,17369,14733,280,1169,555,919,489,18145
2020-02-29,충남,충남,81649,1796,5006,3188,4955,3449,100043,81649,1796,5006,3188,4955,3449,100043
2020-02-29,충남,충북,8836,313,472,482,797,458,11358,8172,301,437,389,771,437,10507
2020-02-29,충북,강원,3995,126,159,117,179,212,4788,3518,129,188,123,208,154,4320
2020-02-29,충북,경기,22139,914,1314,1425,2069,1033,28894,23774,957,1439,1648,1760,1127,30705
2020-02-29,충북,경남,1061,28,119,228,349,29,1814,806,17,82,127,145,24,1201
2020-02-29,충북,경북,3239,134,277,358,593,130,4731,3366,95,244,292,466,131,4594
2020-02-29,충북,광주,588,11,47,70,52,9,777,446,12,36,40,15,10,559
2020-02-29,충북,대구,553,27,58,129,60,12,839,983,32,81,112,157,28,1393
2020-02-29,충북,대전,7536,255,288,108,95,462,8744,8088,282,309,108,113,468,9368
2020-02-29,충북,부산,94,6,15,61,86,6,268,97,1,6,33,97,3,237
2020-02-29,충북,서울,12375,252,751,464,534,518,14894,13326,203,780,472,377,550,15708
2020-02-29,충북,세종,243,10,15,8,10,24,310,270,7,10,13,8,17,325
2020-02-29,충북,울산,7,1,0,4,22,0,34,7,1,2,2,20,2,34
2020-02-29,충북,전남,365,8,27,61,136,12,609,111,5,10,23,22,4,175
2020-02-29,충북,전북,1783,54,89,122,150,71,2269,1716,53,77,146,192,56,2240
2020-02-29,충북,충남,8172,301,437,389,771,437,10507,8836,313,472,482,797,458,11358
2020-02-29,충북,충북,25527,1019,1099,989,1819,1337,31790,25527,1019,1099,989,1819,1337,31790
2020-03-01,강원,강원,50900,598,1467,274,534,2815,56588,50900,598,1467,274,534,2815,56588
2020-03-01,강원,경기,33096,216,650,178,122,1288,35550,19915,154,627,129,166,939,21930
2020-03-01,강원,경남,182,2,6,2,1,8,201,89,2,2,5,1,3,102
2020-03-01,강원,경북,353,13,8,2,7,20,403,253,6,6,12,8,15,300
2020-03-01,강원,광주,70,3,13,5,0,2,93,66,0,11,0,2,3,82
2020-03-01,강원,대구,186,2,1,5,0,6,200,141,3,4,2,1,8,159
2020-03-01,강원,대전,168,2,24,0,0,6,200,149,1,24,1,1,9,185
2020-03-01,강원,부산,5,0,0,0,0,0,5,2,0,1,0,0,0,3
2020-03-01,강원,서울,1301,6,260,5,4,41,1617,731,8,195,7,2,23,966
2020-03-01,강원,세종,3,0,1,0,0,0,4,5,0,0,0,0,0,5
2020-03-01,강원,울산,1,0,0,0,0,0,1,1,0,0,0,0,0,1
2020-03-01,강원,전남,41,2,1,2,2,0,48,13,1,0,2,2,0,18
2020-03-01,강원,전북,146,0,3,0,2,3,154,122,2,4,7,10,3,148
2020-03-01,강원,충남,382,1,7,6,5,23,424,322,2,13,7,5,11,360
2020-03-01,강원,충북,3615,68,90,53,41,198,4065,3110,51,97,37,60,158,3513
2020-03-01,경기,강원,19915,154,627,129,166,939,21930,33096,216,650,178,122,1288,35550
2020-03-01,경기,경기,235146,4921,6614,3359,3765,14398,268203,235146,4921,6614,3359,3765,14398,268203
2020-03-01,경기,경남,2018,23,172,124,65,85,2487,1819,15,149,135,62,100,2280
2020-03-01,경기,경북,2406,33,123,169,66,90,2887,2328,50,98,205,81,94,2856
2020-03-01,경기,광주,565,6,85,41,16,21,734,805,12,61,35,24,24,961
2020-03-01,경기,대구,936,11,59,66,31,31,1134,1340,16,68,99,53,55,1631
2020-03-01,경기,대전,1677,27,145,23,4,94,1970,2104,36,148,18,9,125,2440
2020-03-01,경기,부산,219,3,9,38,27,3,299,290,1,7,31,33,14,376
2020-03-01,경기,서울,84423,1777,3890,1325,549,4794,96758,93430,1940,3925,1154,523,5485,106457
2020-03-01,경기,세종,22,2,1,2,0,1,28,30,0,2,4,0,1,37
2020-03-01,경기,울산,16,0,0,0,4,0,20,20,0,1,6,13,1,41
2020-03-01,경기,전남,626,5,59,34,37,27,788,922,8,63,47,19,27,1086
2020-03-01,경기,전북,1089,17,87,42,26,40,1301,1818,17,88,54,43,72,2092
2020-03-01,경기,충남,27726,302,1177,481,565,1376,31627,31077,351,1172,429,512,1466,35007
2020-03-01,경기,충북,19243,435,770,503,475,925,22351,21649,467,710,488,387,1069,24770
2020-03-01,경남,강원,89,2,2,5,1,3,102,182,2,6,2,1,8,201
2020-03-01,경남,경기,1819,15,149,135,62,100,2280,2018,23,172,124,65,85,2487
2020-03-01,경남,경남,111011,2077,2573,908,1657,7241,125467,111011,2077,2573,908,1657,7241,125467
2020-03-01,경남,경북,6903,128,262,148,184,371,7996,7976,196,324,226,197,432,9351
2020-03-01,경남,광주,859,11,45,44,12,30,1001,980,8,56,45,11,36,1136
2020-03-01,경남,대구,8212,148,315,274,312,406,9667,5406,92,239,89,49,242,6117
2020-03-01,경남,대전,730,8,66,27,13,34,878,963,8,72,11,9,41,1104
2020-03-01,경남,부산,52965,569,1091,261,645,3183,58714,50881,595,1123,268,633,3213,56713
2020-03-01,경남,서울,1642,16,347,137,57,52,2251,2198,14,385,45,21,71,2734
2020-03-01,경남,세종,177,1,3,1,4,7,193,226,2,15,0,4,9,256
2020-03-01,경남,울산,6671,136,192,52,55,381,7487,6334,111,207,47,71,360,7130
2020-03-01,경남,전남,4414,75,119,110,161,193,5072,4792,78,124,85,168,220,5467
2020-03-01,경남,전북,970,16,50,27,9,36,1108,1047,16,45,28,12,46,1194
2020-03-01,경남,충남,986,15,28,35,25,48,1137,1086,13,33,57,63,48,1300
2020-03-01,경남,충북,979,9,43,69,49,45,1194,1067,19,67,87,72,48,1360
2020-03-01,경북,강원,253,6,6,12,8,15,300,353,13,8,2,7,20,403
2020-03-01,경북,경기,2328,50,98,205,81,94,2856,2406,33,123,169,66,90,2887
2020-03-01,경북,경남,7976,196,324,226,197,432,9351,6903,128,262,148,184,371,7996
2020-03-01,경북,경북,45273,845,897,459,589,2096,50159,45273,845,897,459,589,2096,50159
2020-03-01,경북,광주,447,13,40,41,13,11,565,595,14,28,39,11,10,697
2020-03-01,경북,대구,37446,543,478,253,498,1521,40739,37555,555,629,304,373,1594,41010
2020-03-01,경북,대전,1176,9,34,29,19,66,1333,1342,11,40,15,3,57,1468
2020-03-01,경북,부산,3511,25,98,30,112,183,3959,3860,33,106,30,124,208,4361
2020-03-01,경북,서울,1757,22,206,134,32,63,2214,1881,19,199,51,21,81,2252
2020-03-01,경북,세종,225,3,3,7,1,9,248,209,1,7,6,0,10,233
2020-03-01,경북,울산,3763,40,71,75,305,182,4436,3462,28,67,62,297,166,4082
2020-03-01,경북,전남,720,13,26,21,92,28,900,681,10,29,12,39,21,792
2020-03-01,경북,전북,1202,18,47,28,32,36,1363,1412,29,31,35,87,42,1636
2020-03-01,경북,충남,2173,23,37,58,98,78,2467,2070,11,66,50,91,86,2374
2020-03-01,경북,충북,3245,58,133,158,155,144,3893,3287,62,133,123,118,136,3859
2020-03-01,광주,강원,66,0,11,0,2,3,82,70,3,13,5,0,2,93
2020-03-01,광주,경기,805,12,61,35,24,24,961,565,6,85,41,16,21,734
2020-03-01,광주,경남,980,8,56,45,11,36,1136,859,11,45,44,12,30,1001
2020-03-01,광주,경북,595,14,28,39,11,10,697,447,13,40,41,13,11,565
2020-03-01,광주,광주,9045,132,412,83,46,316,10034,9045,132,412,83,46,316,10034
2020-03-01,광주,대구,330,7,32,30,6,13,418,235,8,42,24,3,2,314
2020-03-01,광주,대전,394,4,3,3,6,25,435,439,5,3,0,5,26,478
2020-03-01,광주,부산,399,0,34,5,5,7,450,380,2,43,9,6,21,461
2020-03-01,광주,서울,724,9,10,10,6,19,778,623,12,8,6,7,16,672
2020-03-01,광주,세종,231,1,2,0,0,8,242,146,1,3,1,2,8,161
2020-03-01,광주,울산,70,0,6,0,1,0,77,41,1,5,0,1,2,50
2020-03-01,광주,전남,28089,267,635,155,126,913,30185,28573,278,558,201,137,979,30726
2020-03-01,광주,전북,6370,99,160,61,63,193,6946,6551,98,169,64,48,211,7141
2020-03-01,광주,충남,4508,51,378,119,100,127,5283,3646,43,386,120,52,110,4357
2020-03-01,광주,충북,582,8,21,15,7,20,653,471,5,25,23,14,10,548
2020-03-01,대구,강원,141,3,4,2,1,8,159,186,2,1,5,0,6,200
2020-03-01,대구,경기,1340,16,68,99,53,55,1631,936,11,59,66,31,31,1134
2020-03-01,대구,경남,5406,92,239,89,49,242,6117,8212,148,315,274,312,406,9667
2020-03-01,대구,경북,37555,555,629,304,373,1594,41010,37446,543,478,253,498,1521,40739
2020-03-01,대구,광주,235,8,42,24,3,2,314,330,7,32,30,6,13,418
2020-03-01,대구,대구,22387,370,346,122,148,1227,24600,22387,370,346,122,148,1227,24600
2020-03-01,대구,대전,471,2,15,10,6,29,533,318,0,6,12,2,17,355
2020-03-01,대구,부산,346,6,53,17,9,12,443,2012,20,99,24,25,66,2246
2020-03-01,대구,서울,1264,16,69,52,21,38,1460,1032,7,45,25,7,33,1149
2020-03-01,대구,세종,151,1,7,2,1,6,168,102,0,1,0,0,4,107
2020-03-01,대구,울산,560,9,37,8,48,29,691,616,3,33,4,34,36,726
2020-03-01,대구,전남,340,2,26,6,8,15,397,478,3,21,11,13,9,535
2020-03-01,대구,전북,151,3,5,4,1,9,173,183,4,4,4,1,11,207
2020-03-01,대구,충남,672,4,18,31,36,36,797,448,5,11,31,14,19,528
2020-03-01,대구,충북,777,24,47,52,56,39,995,665,12,23,46,19,28,793
2020-03-01,대전,강원,149,1,24,1,1,9,185,168,2,24,0,0,6,200
2020-03-01,대전,경기,2104,36,148,18,9,125,2440,1677,27,145,23,4,94,1970
2020-03-01,대전,경남,963,8,72,11,9,41,1104,730,8,66,27,13,34,878
2020-03-01,대전,경북,1342,11,40,15,3,57,1468,1176,9,34,29,19,66,1333
2020-03-01,대전,광주,439,5,3,0,5,26,478,394,4,3,3,6,25,435
2020-03-01,대전,대구,318,0,6,12,2,17,355,471,2,15,10,6,29,533
2020-03-01,대전,대전,7764,88,109,27,17,523,8528,7764,88,109,27,17,523,8528
2020-03-01,대전,부산,98,0,1,2,2,4,107,85,1,4,1,3,4,98
2020-03-01,대전,서울,1878,11,159,5,1,91,2145,1591,11,166,2,4,77,1851
2020-03-01,대전,세종,1748,35,28,5,5,116,1937,1541,30,32,4,10,103,1720
2020-03-01,대전,울산,108,0,8,4,5,9,134,85,1,8,1,3,3,101
2020-03-01,대전,전남,326,3,4,4,6,9,352,153,1,1,1,1,5,162
2020-03-01,대전,전북,2683,18,39,9,5,101,2855,3142,27,36,13,15,123,3356
2020-03-01,대전,충남,9554,80,192,51,38,577,10492,8985,93,185,45,38,531,9877
2020-03-01,대전,충북,6467,122,217,34,21,398,7259,5896,87,201,31,22,370,6607
2020-03-01,부산,강원,2,0,1,0,0,0,3,5,0,0,0,0,0,5
2020-03-01,부산,경기,290,1,7,31,33,14,376,219,3,9,38,27,3,299
2020-03-01,부산,경남,50881,595,1123,268,633,3213,56713,52965,569,1091,261,645,3183,58714
2020-03-01,부산,경북,3860,33,106,30,124,208,4361,3511,25,98,30,112,183,3959
2020-03-01,부산,광주,380,2,43,9,6,21,461,399,0,34,5,5,7,450
2020-03-01,부산,대구,2012,20,99,24,25,66,2246,346,6,53,17,9,12,443
2020-03-01,부산,대전,85,1,4,1,3,4,98,98,0,1,2,2,4,107
2020-03-01,부산,부산,35304,152,165,87,326,1992,38026,35304,152,165,87,326,1992,38026
2020-03-01,부산,서울,296,2,3,33,14,14,362,274,3,5,9,2,5,298
2020-03-01,부산,세종,26,0,0,0,0,1,27,25,0,0,0,0,1,26
2020-03-01,부산,울산,11694,67,94,72,343,721,12991,10639,72,44,57,324,688,11824
2020-03-01,부산,전남,1617,11,61,25,80,66,1860,1672,16,68,62,94,66,1978
2020-03-01,부산,전북,240,5,18,3,11,5,282,267,1,30,6,8,8,320
2020-03-01,부산,충남,179,3,7,2,20,12,223,124,1,3,5,31,4,168
2020-03-01,부산,충북,121,2,10,7,24,4,168,83,3,7,25,12,6,136
2020-03-01,서울,강원,731,8,195,7,2,23,966,1301,6,260,5,4,41,1617
2020-03-01,서울,경기,93430,1940,3925,1154,523,5485,106457,84423,1777,3890,1325,549,4794,96758
2020-03-01,서울,경남,2198,14,385,45,21,71,2734,1642,16,347,137,57,52,2251
2020-03-01,서울,경북,1881,19,199,51,21,81,2252,1757,22,206,134,32,63,2214
2020-03-01,서울,광주,623,12,8,6,7,16,672,724,9,10,10,6,19,778
2020-03-01,서울,대구,1032,7,45,25,7,33,1149,1264,16,69,52,21,38,1460
2020-03-01,서울,대전,1591,11,166,2,4,77,1851,1878,11,159,5,1,91,2145
2020-03-01,서울,부산,274,3,5,9,2,5,298,296,2,3,33,14,14,362
2020-03-01,서울,서울,181,2,4,0,1,9,197,181,2,4,0,1,9,197
2020-03-01,서울,세종,16,0,1,0,0,0,17,17,0,0,1,1,0,19
2020-03-01,서울,울산,22,0,1,1,0,1,25,22,0,2,1,1,0,26
2020-03-01,서울,전남,701,7,9,12,6,32,767,1134,5,16,54,18,21,1248
2020-03-01,서울,전북,1036,7,27,2,2,25,1099,1636,6,26,15,8,67,1758
2020-03-01,서울,충남,25863,143,1695,222,165,1069,29157,29170,181,1684,572,286,1112,33005
2020-03-01,서울,충북,11915,109,649,206,101,547,13527,12096,94,650,221,87,493,13641
2020-03-01,세종,강원,5,0,0,0,0,0,5,3,0,1,0,0,0,4
2020-03-01,세종,경기,30,0,2,4,0,1,37,22,2,1,2,0,1,28
2020-03-01,세종,경남,226,2,15,0,4,9,256,177,1,3,1,4,7,193
2020-03-01,세종,경북,209,1,7,6,0,10,233,225,3,3,7,1,9,248
2020-03-01,세종,광주,146,1,3,1,2,8,161,231,1,2,0,0,8,242
2020-03-01,세종,대구,102,0,1,0,0,4,107,151,1,7,2,1,6,168
2020-03-01,세종,대전,1541,30,32,4,10,103,1720,1748,35,28,5,5,116,1937
2020-03-01,세종,부산,25,0,0,0,0,1,26,26,0,0,0,0,1,27
2020-03-01,세종,서울,17,0,0,1,1,0,19,16,0,1,0,0,0,17
2020-03-01,세종,세종,154,5,1,1,1,2,164,154,5,1,1,1,2,164
2020-03-01,세종,울산,9,0,0,1,1,1,12,8,0,0,0,1,0,9
2020-03-01,세종,전남,151,0,3,1,3,5,163,139,0,1,7,1,4,152
2020-03-01,세종,전북,575,4,5,5,5,21,615,836,3,6,7,5,38,895
2020-03-01,세종,충남,4129,47,70,29,28,181,4484,3614,34,69,36,35,152,3940
2020-03-01,세종,충북,241,2,5,1,0,13,262,223,4,2,2,0,18,249
2020-03-01,울산,강원,1,0,0,0,0,0,1,1,0,0,0,0,0,1
2020-03-01,울산,경기,20,0,1,6,13,1,41,16,0,0,0,4,0,20
2020-03-01,울산,경남,6334,111,207,47,71,360,7130,6671,136,192,52,55,381,7487
2020-03-01,울산,경북,3462,28,67,62,297,166,4082,3763,40,71,75,305,182,4436
2020-03-01,울산,광주,41,1,5,0,1,2,50,70,0,6,0,1,0,77
2020-03-01,울산,대구,616,3,33,4,34,36,726,560,9,37,8,48,29,691
2020-03-01,울산,대전,85,1,8,1,3,3,101,108,0,8,4,5,9,134
2020-03-01,울산,부산,10639,72,44,57,324,688,11824,11694,67,94,72,343,721,12991
2020-03-01,울산,서울,22,0,2,1,1,0,26,22,0,1,1,0,1,25
2020-03-01,울산,세종,8,0,0,0,1,0,9,9,0,0,1,1,1,12
2020-03-01,울산,울산,3547,39,61,30,52,247,3976,3547,39,61,30,52,247,3976
2020-03-01,울산,전남,168,0,0,1,2,7,178,181,1,1,2,4,7,196
2020-03-01,울산,전북,30,0,3,0,3,2,38,64,0,3,0,1,0,68
2020-03-01,울산,충남,104,0,3,4,24,4,139,83,0,2,2,17,3,107
2020-03-01,울산,충북,11,2,0,2,5,0,20,7,0,0,2,9,0,18
2020-03-01,전남,강원,13,1,0,2,2,0,18,41,2,1,2,2,0,48
2020-03-01,전남,경기,922,8,63,47,19,27,1086,626,5,59,34,37,27,788
2020-03-01,전남,경남,4792,78,124,85,168,220,5467,4414,75,119,110,161,193,5072
2020-03-01,전남,경북,681,10,29,12,39,21,792,720,13,26,21,92,28,900
2020-03-01,전남,광주,28573,278,558,201,137,979,30726,28089,267,635,155,126,913,30185
2020-03-01,전남,대구,478,3,21,11,13,9,535,340,2,26,6,8,15,397
2020-03-01,전남,대전,153,1,1,1,1,5,162,326,3,4,4,6,9,352
2020-03-01,전남,부산,1672,16,68,62,94,66,1978,1617,11,61,25,80,66,1860
2020-03-01,전남,서울,1134,5,16,54,18,21,1248,701,7,9,12,6,32,767
2020-03-01,전남,세종,139,0,1,7,1,4,152,151,0,3,1,3,5,163
2020-03-01,전남,울산,181,1,1,2,4,7,196,168,0,0,1,2,7,178
2020-03-01,전남,전남,37524,474,688,475,815,1227,41203,37524,474,688,475,815,1227,41203
2020-03-01,전남,전북,8239,108,327,287,716,254,9931,4537,76,169,139,230,135,5286
2020-03-01,전남,충남,2335,26,131,323,110,64,2989,3725,27,278,109,221,134,4494
2020-03-01,전남,충북,131,1,7,16,6,1,162,342,8,23,26,58,15,472
2020-03-01,전북,강원,122,2,4,7,10,3,148,146,0,3,0,2,3,154
2020-03-01,전북,경기,1818,17,88,54,43,72,2092,1089,17,87,42,26,40,1301
2020-03-01,전북,경남,1047,16,45,28,12,46,1194,970,16,50,27,9,36,1108
2020-03-01,전북,경북,1412,29,31,35,87,42,1636,1202,18,47,28,32,36,1363
2020-03-01,전북,광주,6551,98,169,64,48,211,7141,6370,99,160,61,63,193,6946
2020-03-01,전북,대구,183,4,4,4,1,11,207,151,3,5,4,1,9,173
2020-03-01,전북,대전,3142,27,36,13,15,123,3356,2683,18,39,9,5,101,2855
2020-03-01,전북,부산,267,1,30,6,8,8,320,240,5,18,3,11,5,282
2020-03-01,전북,서울,1636,6,26,15,8,67,1758,1036,7,27,2,2,25,1099
2020-03-01,전북,세종,836,3,6,7,5,38,895,575,4,5,5,5,21,615
2020-03-01,전북,울산,64,0,3,0,1,0,68,30,0,3,0,3,2,38
2020-03-01,전북,전남,4537,76,169,139,230,135,5286,8239,108,327,287,716,254,9931
2020-03-01,전북,전북,12356,173,348,122,212,439,13650,12356,173,348,122,212,439,13650
2020-03-01,전북,충남,17739,166,1003,378,598,627,20511,11426,125,793,159,192,416,13111
2020-03-01,전북,충북,1993,42,48,138,76,78,2375,1416,49,59,71,26,50,1671
2020-03-01,충남,강원,322,2,13,7,5,11,360,382,1,7,6,5,23,424
2020-03-01,충남,경기,31077,351,1172,429,512,1466,35007,27726,302,1177,481,565,1376,31627
2020-03-01,충남,경남,1086,13,33,57,63,48,1300,986,15,28,35,25,48,1137
2020-03-01,충남,경북,2070,11,66,50,91,86,2374,2173,23,37,58,98,78,2467
2020-03-01,충남,광주,3646,43,386,120,52,110,4357,4508,51,378,119,100,127,5283
2020-03-01,충남,대구,448,5,11,31,14,19,528,672,4,18,31,36,36,797
2020-03-01,충남,대전,8985,93,185,45,38,531,9877,9554,80,192,51,38,577,10492
2020-03-01,충남,부산,124,1,3,5,31,4,168,179,3,7,2,20,12,223
2020-03-01,충남,서울,29170,181,1684,572,286,1112,33005,25863,143,1695,222,165,1069,29157
2020-03-01,충남,세종,3614,34,69,36,35,152,3940,4129,47,70,29,28,181,4484
2020-03-01,충남,울산,83,0,2,2,17,3,107,104,0,3,4,24,4,139
2020-03-01,충남,전남,3725,27,278,109,221,134,4494,2335,26,131,323,110,64,2989
2020-03-01,충남,전북,11426,125,793,159,192,416,13111,17739,166,1003,378,598,627,20511
2020-03-01,충남,충남,75083,861,3799,1579,1957,3200,86479,75083,861,3799,1579,1957,3200,86479
2020-03-01,충남,충북,7409,148,286,204,209,363,8619,7261,138,311,165,258,363,8496
2020-03-01,충북,강원,3110,51,97,37,60,158,3513,3615,68,90,53,41,198,4065
2020-03-01,충북,경기,21649,467,710,488,387,1069,24770,19243,435,770,503,475,925,22351
2020-03-01,충북,경남,1067,19,67,87,72,48,1360,979,9,43,69,49,45,1194
2020-03-01,충북,경북,3287,62,133,123,118,136,3859,3245,58,133,158,155,144,3893
2020-03-01,충북,광주,471,5,25,23,14,10,548,582,8,21,15,7,20,653
2020-03-01,충북,대구,665,12,23,46,19,28,793,777,24,47,52,56,39,995
2020-03-01,충북,대전,5896,87,201,31,22,370,6607,6467,122,217,34,21,398,7259
2020-03-01,충북,부산,83,3,7,25,12,6,136,121,2,10,7,24,4,168
2020-03-01,충북,서울,12096,94,650,221,87,493,13641,11915,109,649,206,101,547,13527
2020-03-01,충북,세종,223,4,2,2,0,18,249,241,2,5,1,0,13,262
2020-03-01,충북,울산,7,0,0,2,9,0,18,11,2,0,2,5,0,20
2020-03-01,충북,전남,342,8,23,26,58,15,472,131,1,7,16,6,1,162
2020-03-01,충북,전북,1416,49,59,71,26,50,1671,1993,42,48,138,76,78,2375
2020-03-01,충북,충남,7261,138,311,165,258,363,8496,7409,148,286,204,209,363,8619
2020-03-01,충북,충북,21393,432,609,356,434,1082,24306,21393,432,609,356,434,1082,24306
2020-03-02,강원,강원,50756,1965,2462,1263,2393,3672,62511,50756,1965,2462,1263,2393,3672,62511
2020-03-02,강원,경기,16504,551,1000,608,651,803,20117,16568,601,1050,572,778,850,20419
2020-03-02,강원,경남,155,5,5,7,19,5,196,78,3,4,17,17,1,120
2020-03-02,강원,경북,266,24,13,15,19,12,349,242,11,15,28,30,13,339
2020-03-02,강원,광주,54,1,15,8,8,0,86,84,1,10,9,3,0,107
2020-03-02,강원,대구,120,5,7,6,4,2,144,209,10,9,17,13,5,263
2020-03-02,강원,대전,118,3,31,5,2,4,163,150,7,23,4,1,8,193
2020-03-02,강원,부산,3,0,0,1,3,0,7,1,0,0,1,0,0,2
2020-03-02,강원,서울,526,15,201,8,16,26,792,588,16,172,17,9,22,824
2020-03-02,강원,세종,2,0,0,0,1,0,3,5,0,0,0,1,0,6
2020-03-02,강원,울산,0,0,0,0,1,0,1,1,0,0,0,1,0,2
2020-03-02,강원,전남,43,0,2,6,14,1,66,17,0,2,5,2,0,26
2020-03-02,강원,전북,91,3,11,11,12,4,132,111,6,11,17,33,1,179
2020-03-02,강원,충남,242,5,17,19,22,10,315,285,5,19,26,63,14,412
2020-03-02,강원,충북,3564,209,262,257,364,234,4890,3613,203,199,192,317,228,4752
2020-03-02,경기,강원,16568,601,1050,572,778,850,20419,16504,551,1000,608,651,803,20117
2020-03-02,경기,경기,397606,23150,24173,18552,21998,30011,515490,397606,23150,24173,18552,21998,30011,515490
2020-03-02,경기,경남,2019,74,278,404,364,87,3226,1390,57,235,393,344,61,2480
2020-03-02,경기,경북,2664,156,440,619,544,90,4513,2238,147,377,812,538,92,4204
2020-03-02,경기,광주,649,39,144,259,108,24,1223,578,29,124,218,113,19,1081
2020-03-02,경기,대구,954,59,140,230,146,36,1565,1530,89,159,351,388,58,2575
2020-03-02,경기,대전,1520,100,210,57,36,77,2000,1965,98,189,94,50,96,2492
2020-03-02,경기,부산,185,17,18,63,115,9,407,240,21,29,92,163,12,557
2020-03-02,경기,서울,137918,7399,8569,4643,3512,9282,171323,140610,6784,8996,4948,3214,9415,173967
2020-03-02,경기,세종,21,3,1,1,0,1,27,44,3,6,2,0,3,58
2020-03-02,경기,울산,19,0,2,2,11,0,34,23,2,8,21,46,2,102
2020-03-02,경기,전남,607,24,91,127,110,22,981,456,15,61,76,64,15,687
2020-03-02,경기,전북,996,46,151,89,161,35,1478,1121,41,147,204,205,46,1764
2020-03-02,경기,충남,33766,1535,2776,2340,3993,1844,46254,30698,1411,2593,2168,3704,1713,42287
2020-03-02,경기,충북,25037,2281,2909,2884,3214,1313,37638,22986,2163,2769,2652,3389,1233,35192
2020-03-02,경남,강원,78,3,4,17,17,1,120,155,5,5,7,19,5,196
2020-03-02,경남,경기,1390,57,235,393,344,61,2480,2019,74,278,404,364,87,3226
2020-03-02,경남,경남,168480,9749,9470,6486,13136,12909,220230,168480,9749,9470,6486,13136,12909,220230
2020-03-02,경남,경북,6977,599,858,817,1706,355,11312,8324,843,1000,1060,2401,388,14016
2020-03-02,경남,광주,756,54,131,138,115,22,1216,899,38,125,129,83,27,1301
2020-03-02,경남,대구,8102,680,725,878,1412,329,12126,6117,436,518,327,417,269,8084
2020-03-02,경남,대전,467,14,88,59,31,19,678,705,17,82,73,54,32,963
2020-03-02,경남,부산,74122,2547,2451,1483,4515,5305,90423,76292,2708,2727,1577,4732,5479,93515
2020-03-02,경남,서울,1406,32,360,230,96,47,2171,2116,40,348,88,66,60,2718
2020-03-02,경남,세종,104,1,9,14,16,6,150,190,1,14,15,14,5,239
2020-03-02,경남,울산,8088,604,659,472,628,541,10992,7634,551,677,430,609,517,10418
2020-03-02,경남,전남,4875,266,407,475,1320,204,7547,4503,264,431,379,1233,202,7012
2020-03-02,경남,전북,935,41,108,88,157,19,1348,847,35,96,92,125,24,1219
2020-03-02,경남,충남,839,43,95,229,208,37,1451,1137,53,138,232,339,37,1936
2020-03-02,경남,충북,828,38,113,226,275,33,1513,956,52,210,312,515,34,2079
2020-03-02,경북,강원,242,11,15,28,30,13,339,266,24,13,15,19,12,349
2020-03-02,경북,경기,2238,147,377,812,538,92,4204,2664,156,440,619,544,90,4513
2020-03-02,경북,경남,8324,843,1000,1060,2401,388,14016,6977,599,858,817,1706,355,11312
2020-03-02,경북,경북,54254,3498,3639,2634,4297,2988,71310,54254,3498,3639,2634,4297,2988,71310
2020-03-02,경북,광주,471,39,105,169,92,14,890,564,35,103,127,72,16,917
2020-03-02,경북,대구,51917,2737,2118,1382,2770,2801,63725,56914,2921,2413,1721,3326,2943,70238
2020-03-02,경북,대전,1194,38,102,101,73,64,1572,1391,32,84,83,45,62,1697
2020-03-02,경북,부산,2781,104,189,180,568,138,3960,3392,103,191,203,677,156,4722
2020-03-02,경북,서울,1452,92,262,369,153,50,2378,1970,79,272,210,82,57,2670
2020-03-02,경북,세종,185,3,24,24,8,6,250,219,4,14,17,3,7,264
2020-03-02,경북,울산,3691,169,301,346,1087,223,5817,3624,176,300,320,1247,222,5889
2020-03-02,경북,전남,667,42,80,109,373,20,1291,608,41,65,58,260,14,1046
2020-03-02,경북,전북,1443,76,178,172,195,53,2117,1325,85,184,159,413,49,2215
2020-03-02,경북,충남,2183,125,260,504,602,89,3763,2358,102,290,398,711,85,3944
2020-03-02,경북,충북,3270,187,435,678,910,148,5628,3306,212,487,592,906,149,5652
2020-03-02,광주,강원,84,1,10,9,3,0,107,54,1,15,8,8,0,86
2020-03-02,광주,경기,578,29,124,218,113,19,1081,649,39,144,259,108,24,1223
2020-03-02,광주,경남,899,38,125,129,83,27,1301,756,54,131,138,115,22,1216
2020-03-02,광주,경북,564,35,103,127,72,16,917,471,39,105,169,92,14,890
2020-03-02,광주,광주,12058,510,574,342,388,529,14401,12058,510,574,342,388,529,14401
2020-03-02,광주,대구,308,23,44,56,15,4,450,288,21,55,53,27,6,450
2020-03-02,광주,대전,320,12,13,16,10,13,384,403,7,16,13,13,15,467
2020-03-02,광주,부산,263,9,36,28,87,11,434,309,16,26,60,97,7,515
2020-03-02,광주,서울,491,17,21,66,21,23,639,561,19,11,27,21,15,654
2020-03-02,광주,세종,142,4,6,5,6,5,168,155,5,4,7,3,5,179
2020-03-02,광주,울산,42,1,5,2,2,4,56,38,1,5,6,4,1,55
2020-03-02,광주,전남,31204,1003,1177,666,1879,1233,37162,27770,928,992,579,1727,1119,33115
2020-03-02,광주,전북,7001,407,524,334,383,241,8890,6678,437,464,328,383,232,8522
2020-03-02,광주,충남,3506,101,476,445,275,108,4911,3416,117,483,470,274,120,4880
2020-03-02,광주,충북,522,20,63,112,76,12,805,495,32,77,152,86,9,851
2020-03-02,대구,강원,209,10,9,17,13,5,263,120,5,7,6,4,2,144
2020-03-02,대구,경기,1530,89,159,351,388,58,2575,954,59,140,230,146,36,1565
2020-03-02,대구,경남,6117,436,518,327,417,269,8084,8102,680,725,878,1412,329,12126
2020-03-02,대구,경북,56914,2921,2413,1721,3326,2943,70238,51917,2737,2118,1382,2770,2801,63725
2020-03-02,대구,광주,288,21,55,53,27,6,450,308,23,44,56,15,4,450
2020-03-02,대구,대구,48436,2070,1541,852,997,3177,57073,48436,2070,1541,852,997,3177,57073
2020-03-02,대구,대전,478,32,26,54,30,20,640,330,16,24,30,22,15,437
2020-03-02,대구,부산,415,34,84,52,112,16,713,1932,90,117,77,219,71,2506
2020-03-02,대구,서울,1523,61,80,179,91,46,1980,943,41,44,75,25,25,1153
2020-03-02,대구,세종,159,2,9,7,2,7,186,79,0,0,8,1,1,89
2020-03-02,대구,울산,740,62,69,66,148,43,1128,649,53,61,91,152,35,1041
2020-03-02,대구,전남,294,9,27,28,36,4,398,258,18,24,24,60,8,392
2020-03-02,대구,전북,154,13,23,16,25,5,236,159,10,26,16,19,5,235
2020-03-02,대구,충남,892,62,109,175,223,36,1497,505,52,90,113,156,24,940
2020-03-02,대구,충북,976,84,131,203,311,37,1742,593,69,96,161,122,31,1072
2020-03-02,대전,강원,150,7,23,4,1,8,193,118,3,31,5,2,4,163
2020-03-02,대전,경기,1965,98,189,94,50,96,2492,1520,100,210,57,36,77,2000
2020-03-02,대전,경남,705,17,82,73,54,32,963,467,14,88,59,31,19,678
2020-03-02,대전,경북,1391,32,84,83,45,62,1697,1194,38,102,101,73,64,1572
2020-03-02,대전,광주,403,7,16,13,13,15,467,320,12,13,16,10,13,384
2020-03-02,대전,대구,330,16,24,30,22,15,437,478,32,26,54,30,20,640
2020-03-02,대전,대전,13036,428,400,213,135,1012,15224,13036,428,400,213,135,1012,15224
2020-03-02,대전,부산,70,2,6,7,13,4,102,80,6,4,10,12,3,115
2020-03-02,대전,서울,1689,42,165,28,11,63,1998,1495,48,153,26,6,63,1791
2020-03-02,대전,세종,3105,107,73,22,42,258,3607,3180,105,70,32,57,255,3699
2020-03-02,대전,울산,93,3,11,6,15,4,132,81,2,7,13,23,3,129
2020-03-02,대전,전남,253,6,5,12,18,9,303,97,3,5,7,3,3,118
2020-03-02,대전,전북,2747,75,94,49,39,131,3135,2544,93,85,78,45,122,2967
2020-03-02,대전,충남,15149,446,500,223,206,1167,17691,12756,428,426,214,204,1044,15072
2020-03-02,대전,충북,10066,452,458,180,183,783,12122,8513,348,396,189,160,650,10256
2020-03-02,부산,강원,1,0,0,1,0,0,2,3,0,0,1,3,0,7
2020-03-02,부산,경기,240,21,29,92,163,12,557,185,17,18,63,115,9,407
2020-03-02,부산,경남,76292,2708,2727,1577,4732,5479,93515,74122,2547,2451,1483,4515,5305,90423
2020-03-02,부산,경북,3392,103,191,203,677,156,4722,2781,104,189,180,568,138,3960
2020-03-02,부산,광주,309,16,26,60,97,7,515,263,9,36,28,87,11,434
2020-03-02,부산,대구,1932,90,117,77,219,71,2506,415,34,84,52,112,16,713
2020-03-02,부산,대전,80,6,4,10,12,3,115,70,2,6,7,13,4,102
2020-03-02,부산,부산,36802,644,574,494,2014,2817,43345,36802,644,574,494,2014,2817,43345
2020-03-02,부산,서울,167,10,11,65,37,3,293,157,6,7,24,20,5,219
2020-03-02,부산,세종,19,1,0,5,2,1,28,20,1,1,0,0,1,23
2020-03-02,부산,울산,14080,360,486,618,2621,1023,19188,12859,372,397,403,2380,985,17396
2020-03-02,부산,전남,1679,84,101,180,505,84,2633,1416,71,100,122,528,54,2291
2020-03-02,부산,전북,268,11,21,38,67,7,412,177,10,26,38,63,7,321
2020-03-02,부산,충남,156,10,14,50,110,4,344,150,6,18,46,144,2,366
2020-03-02,부산,충북,98,7,16,83,151,9,364,89,9,22,81,154,3,358
2020-03-02,서울,강원,588,16,172,17,9,22,824,526,15,201,8,16,26,792
2020-03-02,서울,경기,140610,6784,8996,4948,3214,9415,173967,137918,7399,8569,4643,3512,9282,171323
2020-03-02,서울,경남,2116,40,348,88,66,60,2718,1406,32,360,230,96,47,2171
2020-03-02,서울,경북,1970,79,272,210,82,57,2670,1452,92,262,369,153,50,2378
2020-03-02,서울,광주,561,19,11,27,21,15,654,491,17,21,66,21,23,639
2020-03-02,서울,대구,943,41,44,75,25,25,1153,1523,61,80,179,91,46,1980
2020-03-02,서울,대전,1495,48,153,26,6,63,1791,1689,42,165,28,11,63,1998
2020-03-02,서울,부산,157,6,7,24,20,5,219,167,10,11,65,37,3,293
2020-03-02,서울,서울,220,2,8,1,1,13,245,220,2,8,1,1,13,245
2020-03-02,서울,세종,23,2,0,0,1,2,28,14,1,1,0,0,1,17
2020-03-02,서울,울산,19,1,0,2,1,1,24,22,0,4,3,9,0,38
2020-03-02,서울,전남,713,12,15,24,12,22,798,554,7,20,53,22,14,670
2020-03-02,서울,전북,964,20,43,18,19,41,1105,920,20,47,31,21,37,1076
2020-03-02,서울,충남,24475,513,2041,753,681,1037,29500,22264,628,2018,1191,1095,929,28125
2020-03-02,서울,충북,13425,552,1047,685,626,574,16909,11010,624,1061,758,780,520,14753
2020-03-02,세종,강원,5,0,0,0,1,0,6,2,0,0,0,1,0,3
2020-03-02,세종,경기,44,3,6,2,0,3,58,21,3,1,1,0,1,27
2020-03-02,세종,경남,190,1,14,15,14,5,239,104,1,9,14,16,6,150
2020-03-02,세종,경북,219,4,14,17,3,7,264,185,3,24,24,8,6,250
2020-03-02,세종,광주,155,5,4,7,3,5,179,142,4,6,5,6,5,168
2020-03-02,세종,대구,79,0,0,8,1,1,89,159,2,9,7,2,7,186
2020-03-02,세종,대전,3180,105,70,32,57,255,3699,3105,107,73,22,42,258,3607
2020-03-02,세종,부산,20,1,1,0,0,1,23,19,1,0,5,2,1,28
2020-03-02,세종,서울,14,1,1,0,0,1,17,23,2,0,0,1,2,28
2020-03-02,세종,세종,201,22,7,1,3,14,248,201,22,7,1,3,14,248
2020-03-02,세종,울산,6,0,0,1,4,0,11,3,0,0,1,4,0,8
2020-03-02,세종,전남,139,1,2,6,18,3,169,79,1,1,2,6,1,90
2020-03-02,세종,전북,669,23,33,14,42,30,811,613,14,27,25,48,21,748
2020-03-02,세종,충남,5589,160,161,112,166,308,6496,3656,132,137,105,141,187,4358
2020-03-02,세종,충북,327,13,26,9,10,34,419,269,19,22,6,11,24,351
2020-03-02,울산,강원,1,0,0,0,1,0,2,0,0,0,0,1,0,1
2020-03-02,울산,경기,23,2,8,21,46,2,102,19,0,2,2,11,0,34
2020-03-02,울산,경남,7634,551,677,430,609,517,10418,8088,604,659,472,628,541,10992
2020-03-02,울산,경북,3624,176,300,320,1247,222,5889,3691,169,301,346,1087,223,5817
2020-03-02,울산,광주,38,1,5,6,4,1,55,42,1,5,2,2,4,56
2020-03-02,울산,대구,649,53,61,91,152,35,1041,740,62,69,66,148,43,1128
2020-03-02,울산,대전,81,2,7,13,23,3,129,93,3,11,6,15,4,132
2020-03-02,울산,부산,12859,372,397,403,2380,985,17396,14080,360,486,618,2621,1023,19188
2020-03-02,울산,서울,22,0,4,3,9,0,38,19,1,0,2,1,1,24
2020-03-02,울산,세종,3,0,0,1,4,0,8,6,0,0,1,4,0,11
2020-03-02,울산,울산,6983,309,499,261,633,646,9331,6983,309,499,261,633,646,9331
2020-03-02,울산,전남,158,14,20,10,30,5,237,144,18,16,10,38,4,230
2020-03-02,울산,전북,34,0,4,2,11,1,52,33,1,6,3,3,1,47
2020-03-02,울산,충남,122,5,14,31,146,4,322,102,0,9,20,105,3,239
2020-03-02,울산,충북,18,1,4,9,36,0,68,11,0,2,10,27,1,51
2020-03-02,전남,강원,17,0,2,5,2,0,26,43,0,2,6,14,1,66
2020-03-02,전남,경기,456,15,61,76,64,15,687,607,24,91,127,110,22,981
2020-03-02,전남,경남,4503,264,431,379,1233,202,7012,4875,266,407,475,1320,204,7547
2020-03-02,전남,경북,608,41,65,58,260,14,1046,667,42,80,109,373,20,1291
2020-03-02,전남,광주,27770,928,992,579,1727,1119,33115,31204,1003,1177,666,1879,1233,37162
2020-03-02,전남,대구,258,18,24,24,60,8,392,294,9,27,28,36,4,398
2020-03-02,전남,대전,97,3,5,7,3,3,118,253,6,5,12,18,9,303
2020-03-02,전남,부산,1416,71,100,122,528,54,2291,1679,84,101,180,505,84,2633
2020-03-02,전남,서울,554,7,20,53,22,14,670,713,12,15,24,12,22,798
2020-03-02,전남,세종,79,1,1,2,6,1,90,139,1,2,6,18,3,169
2020-03-02,전남,울산,144,18,16,10,38,4,230,158,14,20,10,30,5,237
2020-03-02,전남,전남,38611,1179,1428,1521,4234,1585,48558,38611,1179,1428,1521,4234,1585,48558
2020-03-02,전남,전북,5606,333,646,833,2650,169,10237,4048,243,403,532,1169,132,6527
2020-03-02,전남,충남,1438,57,181,387,233,41,2337,3623,94,381,429,917,97,5541
2020-03-02,전남,충북,114,9,10,37,52,3,225,303,16,54,99,221,9,702
2020-03-02,전북,강원,111,6,11,17,33,1,179,91,3,11,11,12,4,132
2020-03-02,전북,경기,1121,41,147,204,205,46,1764,996,46,151,89,161,35,1478
2020-03-02,전북,경남,847,35,96,92,125,24,1219,935,41,108,88,157,19,1348
2020-03-02,전북,경북,1325,85,184,159,413,49,2215,1443,76,178,172,195,53,2117
2020-03-02,전북,광주,6678,437,464,328,383,232,8522,7001,407,524,334,383,241,8890
2020-03-02,전북,대구,159,10,26,16,19,5,235,154,13,23,16,25,5,236
2020-03-02,전북,대전,2544,93,85,78,45,122,2967,2747,75,94,49,39,131,3135
2020-03-02,전북,부산,177,10,26,38,63,7,321,268,11,21,38,67,7,412
2020-03-02,전북,서울,920,20,47,31,21,37,1076,964,20,43,18,19,41,1105
2020-03-02,전북,세종,613,14,27,25,48,21,748,669,23,33,14,42,30,811
2020-03-02,전북,울산,33,1,6,3,3,1,47,34,0,4,2,11,1,52
2020-03-02,전북,전남,4048,243,403,532,1169,132,6527,5606,333,646,833,2650,169,10237
2020-03-02,전북,전북,14994,636,956,684,1158,567,18995,14994,636,956,684,1158,567,18995
2020-03-02,전북,충남,12646,538,1585,1305,2268,473,18815,10964,465,1394,841,1247,408,15319
2020-03-02,전북,충북,1654,137,191,327,411,61,2781,1453,125,216,264,231,39,2328
2020-03-02,충남,강원,285,5,19,26,63,14,412,242,5,17,19,22,10,315
2020-03-02,충남,경기,30698,1411,2593,2168,3704,1713,42287,33766,1535,2776,2340,3993,1844,46254
2020-03-02,충남,경남,1137,53,138,232,339,37,1936,839,43,95,229,208,37,1451
2020-03-02,충남,경북,2358,102,290,398,711,85,3944,2183,125,260,504,602,89,3763
2020-03-02,충남,광주,3416,117,483,470,274,120,4880,3506,101,476,445,275,108,4911
2020-03-02,충남,대구,505,52,90,113,156,24,940,892,62,109,175,223,36,1497
2020-03-02,충남,대전,12756,428,426,214,204,1044,15072,15149,446,500,223,206,1167,17691
2020-03-02,충남,부산,150,6,18,46,144,2,366,156,10,14,50,110,4,344
2020-03-02,충남,서울,22264,628,2018,1191,1095,929,28125,24475,513,2041,753,681,1037,29500
2020-03-02,충남,세종,3656,132,137,105,141,187,4358,5589,160,161,112,166,308,6496
2020-03-02,충남,울산,102,0,9,20,105,3,239,122,5,14,31,146,4,322
2020-03-02,충남,전남,3623,94,381,429,917,97,5541,1438,57,181,387,233,41,2337
2020-03-02,충남,전북,10964,465,1394,841,1247,408,15319,12646,538,1585,1305,2268,473,18815
2020-03-02,충남,충남,82555,3489,7291,6505,9438,3977,113255,82555,3489,7291,6505,9438,3977,113255
2020-03-02,충남,충북,11660,651,914,829,1306,702,16062,10639,653,857,754,1327,653,14883
2020-03-02,충북,강원,3613,203,199,192,317,228,4752,3564,209,262,257,364,234,4890
2020-03-02,충북,경기,22986,2163,2769,2652,3389,1233,35192,25037,2281,2909,2884,3214,1313,37638
2020-03-02,충북,경남,956,52,210,312,515,34,2079,828,38,113,226,275,33,1513
2020-03-02,충북,경북,3306,212,487,592,906,149,5652,3270,187,435,678,910,148,5628
2020-03-02,충북,광주,495,32,77,152,86,9,851,522,20,63,112,76,12,805
2020-03-02,충북,대구,593,69,96,161,122,31,1072,976,84,131,203,311,37,1742
2020-03-02,충북,대전,8513,348,396,189,160,650,10256,10066,452,458,180,183,783,12122
2020-03-02,충북,부산,89,9,22,81,154,3,358,98,7,16,83,151,9,364
2020-03-02,충북,서울,11010,624,1061,758,780,520,14753,13425,552,1047,685,626,574,16909
2020-03-02,충북,세종,269,19,22,6,11,24,351,327,13,26,9,10,34,419
2020-03-02,충북,울산,11,0,2,10,27,1,51,18,1,4,9,36,0,68
2020-03-02,충북,전남,303,16,54,99,221,9,702,114,9,10,37,52,3,225
2020-03-02,충북,전북,1453,125,216,264,231,39,2328,1654,137,191,327,411,61,2781
2020-03-02,충북,충남,10639,653,857,754,1327,653,14883,11660,651,914,829,1306,702,16062
2020-03-02,충북,충북,31100,1908,2275,2049,2974,1932,42238,31100,1908,2275,2049,2974,1932,42238
2020-03-03,강원,강원,49124,2133,2567,1251,2528,3476,61079,49124,2133,2567,1251,2528,3476,61079
2020-03-03,강원,경기,14385,585,1040,645,736,698,18089,15295,627,1024,747,893,787,19373
2020-03-03,강원,경남,97,3,4,15,16,2,137,58,1,3,19,13,1,95
2020-03-03,강원,경북,221,15,21,23,28,9,317,215,16,13,40,41,6,331
2020-03-03,강원,광주,57,1,13,11,8,1,91,47,5,12,15,6,1,86
2020-03-03,강원,대구,97,5,10,12,8,3,135,144,5,13,14,16,3,195
2020-03-03,강원,대전,91,2,27,5,2,4,131,98,6,23,6,3,4,140
2020-03-03,강원,부산,5,0,0,2,4,0,11,1,2,0,4,1,0,8
2020-03-03,강원,서울,491,16,191,7,13,20,738,588,15,141,6,11,18,779
2020-03-03,강원,세종,3,0,0,0,2,0,5,5,0,0,0,2,0,7
2020-03-03,강원,울산,0,0,0,0,1,0,1,1,0,0,1,1,0,3
2020-03-03,강원,전남,33,1,1,2,18,0,55,15,4,2,2,5,0,28
2020-03-03,강원,전북,73,3,8,15,23,1,123,96,8,12,23,37,1,177
2020-03-03,강원,충남,185,7,20,27,34,9,282,280,10,16,48,69,8,431
2020-03-03,강원,충북,3226,226,294,277,386,227,4636,3383,212,240,250,346,217,4648
2020-03-03,경기,강원,15295,627,1024,747,893,787,19373,14385,585,1040,645,736,698,18089
2020-03-03,경기,경기,395092,23977,25206,20573,24286,29774,518908,395092,23977,25206,20573,24286,29774,518908
2020-03-03,경기,경남,1841,105,306,802,597,58,3709,1235,75,262,581,454,50,2657
2020-03-03,경기,경북,2154,193,475,782,631,80,4315,2060,201,425,969,613,68,4336
2020-03-03,경기,광주,566,26,165,374,174,14,1319,462,25,127,269,142,5,1030
2020-03-03,경기,대구,872,109,195,399,208,23,1806,1302,107,188,509,476,38,2620
2020-03-03,경기,대전,1498,91,218,148,54,68,2077,1526,112,198,112,46,66,2060
2020-03-03,경기,부산,142,29,38,228,181,3,621,167,20,41,196,302,8,734
2020-03-03,경기,서울,136709,7405,8857,5528,3976,9198,171673,136942,7106,9335,5202,3649,9222,171456
2020-03-03,경기,세종,29,2,5,0,2,1,39,27,5,2,2,6,2,44
2020-03-03,경기,울산,16,0,2,11,12,0,41,22,4,12,47,86,0,171
2020-03-03,경기,전남,566,24,88,204,153,18,1053,470,16,72,119,93,18,788
2020-03-03,경기,전북,949,43,164,138,193,31,1518,957,59,174,240,257,35,1722
2020-03-03,경기,충남,30364,1705,2949,2709,4505,1632,43864,29261,1605,2764,2594,4381,1578,42183
2020-03-03,경기,충북,22043,2317,3018,3319,3538,1128,35363,21421,2246,2893,2956,3723,1088,34327
2020-03-03,경남,강원,58,1,3,19,13,1,95,97,3,4,15,16,2,137
2020-03-03,경남,경기,1235,75,262,581,454,50,2657,1841,105,306,802,597,58,3709
2020-03-03,경남,경남,165677,10051,9747,7793,14463,12874,220605,165677,10051,9747,7793,14463,12874,220605
2020-03-03,경남,경북,6271,615,905,913,1866,269,10839,7827,834,1127,1256,2681,344,14069
2020-03-03,경남,광주,678,43,123,164,136,22,1166,692,37,127,150,102,16,1124
2020-03-03,경남,대구,7551,666,776,996,1673,318,11980,5732,444,544,407,463,289,7879
2020-03-03,경남,대전,421,15,93,87,37,21,674,624,35,99,147,85,33,1023
2020-03-03,경남,부산,73455,2607,2531,1727,4704,5370,90394,73687,2673,2748,1811,4802,5322,91043
2020-03-03,경남,서울,1266,37,350,309,149,39,2150,1909,59,358,214,117,47,2704
2020-03-03,경남,세종,87,6,6,11,5,2,117,139,8,14,11,15,4,191
2020-03-03,경남,울산,7666,607,718,511,673,498,10673,7351,586,742,473,633,476,10261
2020-03-03,경남,전남,4474,291,435,497,1364,210,7271,4556,307,445,410,1277,191,7186
2020-03-03,경남,전북,748,53,121,91,171,23,1207,732,61,99,101,184,23,1200
2020-03-03,경남,충남,647,49,127,249,246,19,1337,1012,68,159,351,551,33,2174
2020-03-03,경남,충북,705,68,140,299,318,31,1561,848,80,194,485,651,40,2298
2020-03-03,경북,강원,215,16,13,40,41,6,331,221,15,21,23,28,9,317
2020-03-03,경북,경기,2060,201,425,969,613,68,4336,2154,193,475,782,631,80,4315
2020-03-03,경북,경남,7827,834,1127,1256,2681,344,14069,6271,615,905,913,1866,269,10839
2020-03-03,경북,경북,52680,3670,3752,3031,4823,2931,70887,52680,3670,3752,3031,4823,2931,70887
2020-03-03,경북,광주,430,53,99,201,149,14,946,467,37,81,155,84,11,835
2020-03-03,경북,대구,52091,2832,2357,1644,3078,2849,64851,54821,3005,2714,1975,3610,2823,68948
2020-03-03,경북,대전,1032,63,99,107,88,41,1430,1095,68,109,160,75,51,1558
2020-03-03,경북,부산,2833,131,194,211,657,129,4155,2941,121,207,228,761,126,4384
2020-03-03,경북,서울,1405,110,276,464,162,46,2463,1528,87,282,261,121,60,2339
2020-03-03,경북,세종,173,4,9,28,17,4,235,184,13,18,14,9,4,242
2020-03-03,경북,울산,3300,176,310,382,1151,204,5523,3406,167,305,354,1382,192,5806
2020-03-03,경북,전남,675,42,69,109,430,16,1341,532,43,74,65,337,12,1063
2020-03-03,경북,전북,1307,89,178,188,260,50,2072,1318,106,178,160,501,40,2303
2020-03-03,경북,충남,1894,147,324,567,655,70,3657,1948,136,362,509,824,78,3857
2020-03-03,경북,충북,3074,237,499,728,978,116,5632,3026,242,494,682,1069,101,5614
2020-03-03,광주,강원,47,5,12,15,6,1,86,57,1,13,11,8,1,91
2020-03-03,광주,경기,462,25,127,269,142,5,1030,566,26,165,374,174,14,1319
2020-03-03,광주,경남,692,37,127,150,102,16,1124,678,43,123,164,136,22,1166
2020-03-03,광주,경북,467,37,81,155,84,11,835,430,53,99,201,149,14,946
2020-03-03,광주,광주,12090,546,599,393,381,535,14544,12090,546,599,393,381,535,14544
2020-03-03,광주,대구,270,21,69,91,24,6,481,327,27,67,78,34,5,538
2020-03-03,광주,대전,312,23,21,22,17,11,406,337,20,23,27,24,13,444
2020-03-03,광주,부산,294,13,37,47,75,10,476,268,21,52,85,128,6,560
2020-03-03,광주,서울,431,26,32,82,26,14,611,553,33,29,56,33,12,716
2020-03-03,광주,세종,116,1,8,7,4,3,139,128,9,8,8,6,4,163
2020-03-03,광주,울산,48,0,7,4,5,3,67,28,5,7,5,11,1,57
2020-03-03,광주,전남,29133,1041,1161,778,1937,1161,35211,28135,1038,976,659,1835,1114,33757
2020-03-03,광주,전북,6188,413,551,378,377,242,8149,6348,441,512,341,406,241,8289
2020-03-03,광주,충남,3009,111,442,491,289,71,4413,3192,152,459,675,389,74,4941
2020-03-03,광주,충북,409,26,59,133,77,5,709,459,38,98,213,119,4,931
2020-03-03,대구,강원,144,5,13,14,16,3,195,97,5,10,12,8,3,135
2020-03-03,대구,경기,1302,107,188,509,476,38,2620,872,109,195,399,208,23,1806
2020-03-03,대구,경남,5732,444,544,407,463,289,7879,7551,666,776,996,1673,318,11980
2020-03-03,대구,경북,54821,3005,2714,1975,3610,2823,68948,52091,2832,2357,1644,3078,2849,64851
2020-03-03,대구,광주,327,27,67,78,34,5,538,270,21,69,91,24,6,481
2020-03-03,대구,대구,47748,2073,1623,1054,1082,3226,56806,47748,2073,1623,1054,1082,3226,56806
2020-03-03,대구,대전,460,27,31,82,49,12,661,288,22,20,69,25,9,433
2020-03-03,대구,부산,369,48,87,55,118,9,686,1543,97,158,100,264,88,2250
2020-03-03,대구,서울,1310,73,112,254,126,40,1915,762,49,59,148,49,27,1094
2020-03-03,대구,세종,118,4,8,9,7,4,150,66,3,3,5,5,3,85
2020-03-03,대구,울산,611,62,81,66,172,31,1023,609,52,81,81,185,31,1039
2020-03-03,대구,전남,257,13,38,20,36,11,375,272,14,42,20,73,9,430
2020-03-03,대구,전북,156,12,27,14,25,5,239,135,10,25,20,19,5,214
2020-03-03,대구,충남,710,73,137,205,252,23,1400,460,49,128,165,176,14,992
2020-03-03,대구,충북,818,96,157,274,368,25,1738,555,81,141,234,139,23,1173
2020-03-03,대전,강원,98,6,23,6,3,4,140,91,2,27,5,2,4,131
2020-03-03,대전,경기,1526,112,198,112,46,66,2060,1498,91,218,148,54,68,2077
2020-03-03,대전,경남,624,35,99,147,85,33,1023,421,15,93,87,37,21,674
2020-03-03,대전,경북,1095,68,109,160,75,51,1558,1032,63,99,107,88,41,1430
2020-03-03,대전,광주,337,20,23,27,24,13,444,312,23,21,22,17,11,406
2020-03-03,대전,대구,288,22,20,69,25,9,433,460,27,31,82,49,12,661
2020-03-03,대전,대전,12995,446,411,302,146,918,15218,12995,446,411,302,146,918,15218
2020-03-03,대전,부산,43,3,13,20,23,1,103,43,2,13,17,19,3,97
2020-03-03,대전,서울,1393,48,154,51,3,43,1692,1396,46,169,44,7,57,1719
2020-03-03,대전,세종,3075,94,83,37,48,268,3605,3075,103,81,56,65,260,3640
2020-03-03,대전,울산,54,0,9,21,28,3,115,55,5,11,13,18,4,106
2020-03-03,대전,전남,192,3,5,32,32,5,269,71,0,3,5,4,4,87
2020-03-03,대전,전북,2414,84,94,99,55,121,2867,2497,110,95,88,71,115,2976
2020-03-03,대전,충남,14337,524,520,346,191,1061,16979,12888,499,469,339,212,988,15395
2020-03-03,대전,충북,9775,495,451,219,189,700,11829,8813,435,415,183,161,645,10652
2020-03-03,부산,강원,1,2,0,4,1,0,8,5,0,0,2,4,0,11
2020-03-03,부산,경기,167,20,41,196,302,8,734,142,29,38,228,181,3,621
2020-03-03,부산,경남,73687,2673,2748,1811,4802,5322,91043,73455,2607,2531,1727,4704,5370,90394
2020-03-03,부산,경북,2941,121,207,228,761,126,4384,2833,131,194,211,657,129,4155
2020-03-03,부산,광주,268,21,52,85,128,6,560,294,13,37,47,75,10,476
2020-03-03,부산,대구,1543,97,158,100,264,88,2250,369,48,87,55,118,9,686
2020-03-03,부산,대전,43,2,13,17,19,3,97,43,3,13,20,23,1,103
2020-03-03,부산,부산,36457,690,590,648,2060,2720,43165,36457,690,590,648,2060,2720,43165
2020-03-03,부산,서울,156,13,25,81,99,7,381,163,17,21,70,34,2,307
2020-03-03,부산,세종,11,0,1,4,4,0,20,9,2,0,4,1,0,16
2020-03-03,부산,울산,12819,368,457,653,2663,949,17909,12711,382,402,449,2493,989,17426
2020-03-03,부산,전남,1515,77,117,189,561,61,2520,1368,85,110,145,560,60,2328
2020-03-03,부산,전북,176,17,21,45,101,8,368,168,4,28,46,67,6,319
2020-03-03,부산,충남,101,14,19,75,168,3,380,82,11,34,91,146,5,369
2020-03-03,부산,충북,85,12,27,95,239,2,460,64,14,33,138,181,6,436
2020-03-03,서울,강원,588,15,141,6,11,18,779,491,16,191,7,13,20,738
2020-03-03,서울,경기,136942,7106,9335,5202,3649,9222,171456,136709,7405,8857,5528,3976,9198,171673
2020-03-03,서울,경남,1909,59,358,214,117,47,2704,1266,37,350,309,149,39,2150
2020-03-03,서울,경북,1528,87,282,261,121,60,2339,1405,110,276,464,162,46,2463
2020-03-03,서울,광주,553,33,29,56,33,12,716,431,26,32,82,26,14,611
2020-03-03,서울,대구,762,49,59,148,49,27,1094,1310,73,112,254,126,40,1915
2020-03-03,서울,대전,1396,46,169,44,7,57,1719,1393,48,154,51,3,43,1692
2020-03-03,서울,부산,163,17,21,70,34,2,307,156,13,25,81,99,7,381
2020-03-03,서울,서울,186,10,7,1,1,5,210,186,10,7,1,1,5,210
2020-03-03,서울,세종,18,1,0,0,0,1,20,21,0,1,1,0,0,23
2020-03-03,서울,울산,19,0,6,2,3,0,30,14,3,5,10,16,0,48
2020-03-03,서울,전남,667,15,28,51,20,20,801,533,11,20,73,35,15,687
2020-03-03,서울,전북,942,20,50,22,21,34,1089,847,22,46,45,27,28,1015
2020-03-03,서울,충남,21161,578,2074,913,764,895,26385,20686,702,2010,1516,1293,829,27036
2020-03-03,서울,충북,11206,549,1032,836,696,463,14782,10551,661,1045,924,814,403,14398
2020-03-03,세종,강원,5,0,0,0,2,0,7,3,0,0,0,2,0,5
2020-03-03,세종,경기,27,5,2,2,6,2,44,29,2,5,0,2,1,39
2020-03-03,세종,경남,139,8,14,11,15,4,191,87,6,6,11,5,2,117
2020-03-03,세종,경북,184,13,18,14,9,4,242,173,4,9,28,17,4,235
2020-03-03,세종,광주,128,9,8,8,6,4,163,116,1,8,7,4,3,139
2020-03-03,세종,대구,66,3,3,5,5,3,85,118,4,8,9,7,4,150
2020-03-03,세종,대전,3075,103,81,56,65,260,3640,3075,94,83,37,48,268,3605
2020-03-03,세종,부산,9,2,0,4,1,0,16,11,0,1,4,4,0,20
2020-03-03,세종,서울,21,0,1,1,0,0,23,18,1,0,0,0,1,20
2020-03-03,세종,세종,199,21,1,2,3,13,239,199,21,1,2,3,13,239
2020-03-03,세종,울산,7,0,0,3,4,0,14,5,0,2,1,5,0,13
2020-03-03,세종,전남,103,4,3,12,24,10,156,70,1,3,7,15,2,98
2020-03-03,세종,전북,504,21,35,13,27,27,627,480,14,16,15,33,28,586
2020-03-03,세종,충남,4904,157,150,106,189,275,5781,3746,140,155,108,147,203,4499
2020-03-03,세종,충북,338,23,11,21,15,27,435,295,15,17,15,13,27,382
2020-03-03,울산,강원,1,0,0,1,1,0,3,0,0,0,0,1,0,1
2020-03-03,울산,경기,22,4,12,47,86,0,171,16,0,2,11,12,0,41
2020-03-03,울산,경남,7351,586,742,473,633,476,10261,7666,607,718,511,673,498,10673
2020-03-03,울산,경북,3406,167,305,354,1382,192,5806,3300,176,310,382,1151,204,5523
2020-03-03,울산,광주,28,5,7,5,11,1,57,48,0,7,4,5,3,67
2020-03-03,울산,대구,609,52,81,81,185,31,1039,611,62,81,66,172,31,1023
2020-03-03,울산,대전,55,5,11,13,18,4,106,54,0,9,21,28,3,115
2020-03-03,울산,부산,12711,382,402,449,2493,989,17426,12819,368,457,653,2663,949,17909
2020-03-03,울산,서울,14,3,5,10,16,0,48,19,0,6,2,3,0,30
2020-03-03,울산,세종,5,0,2,1,5,0,13,7,0,0,3,4,0,14
2020-03-03,울산,울산,6891,322,511,293,658,674,9349,6891,322,511,293,658,674,9349
2020-03-03,울산,전남,131,8,19,13,27,4,202,143,18,16,7,46,6,236
2020-03-03,울산,전북,27,1,4,3,11,1,47,27,3,2,4,7,1,44
2020-03-03,울산,충남,72,4,15,47,142,1,281,77,4,11,36,125,0,253
2020-03-03,울산,충북,9,1,5,25,46,0,86,10,2,5,14,25,0,56
2020-03-03,전남,강원,15,4,2,2,5,0,28,33,1,1,2,18,0,55
2020-03-03,전남,경기,470,16,72,119,93,18,788,566,24,88,204,153,18,1053
2020-03-03,전남,경남,4556,307,445,410,1277,191,7186,4474,291,435,497,1364,210,7271
2020-03-03,전남,경북,532,43,74,65,337,12,1063,675,42,69,109,430,16,1341
2020-03-03,전남,광주,28135,1038,976,659,1835,1114,33757,29133,1041,1161,778,1937,1161,35211
2020-03-03,전남,대구,272,14,42,20,73,9,430,257,13,38,20,36,11,375
2020-03-03,전남,대전,71,0,3,5,4,4,87,192,3,5,32,32,5,269
2020-03-03,전남,부산,1368,85,110,145,560,60,2328,1515,77,117,189,561,61,2520
2020-03-03,전남,서울,533,11,20,73,35,15,687,667,15,28,51,20,20,801
2020-03-03,전남,세종,70,1,3,7,15,2,98,103,4,3,12,24,10,156
2020-03-03,전남,울산,143,18,16,7,46,6,236,131,8,19,13,27,4,202
2020-03-03,전남,전남,37864,1364,1579,1671,4992,1584,49054,37864,1364,1579,1671,4992,1584,49054
2020-03-03,전남,전북,5378,340,766,950,2793,137,10364,3917,239,461,599,1291,102,6609
2020-03-03,전남,충남,1268,51,205,492,298,35,2349,3239,91,441,564,1064,93,5492
2020-03-03,전남,충북,117,11,16,55,61,1,261,265,23,65,127,266,4,750
2020-03-03,전북,강원,96,8,12,23,37,1,177,73,3,8,15,23,1,123
2020-03-03,전북,경기,957,59,174,240,257,35,1722,949,43,164,138,193,31,1518
2020-03-03,전북,경남,732,61,99,101,184,23,1200,748,53,121,91,171,23,1207
2020-03-03,전북,경북,1318,106,178,160,501,40,2303,1307,89,178,188,260,50,2072
2020-03-03,전북,광주,6348,441,512,341,406,241,8289,6188,413,551,378,377,242,8149
2020-03-03,전북,대구,135,10,25,20,19,5,214,156,12,27,14,25,5,239
2020-03-03,전북,대전,2497,110,95,88,71,115,2976,2414,84,94,99,55,121,2867
2020-03-03,전북,부산,168,4,28,46,67,6,319,176,17,21,45,101,8,368
2020-03-03,전북,서울,847,22,46,45,27,28,1015,942,20,50,22,21,34,1089
2020-03-03,전북,세종,480,14,16,15,33,28,586,504,21,35,13,27,27,627
2020-03-03,전북,울산,27,3,2,4,7,1,44,27,1,4,3,11,1,47
2020-03-03,전북,전남,3917,239,461,599,1291,102,6609,5378,340,766,950,2793,137,10364
2020-03-03,전북,전북,14317,703,998,660,1272,498,18448,14317,703,998,660,1272,498,18448
2020-03-03,전북,충남,11664,596,1622,1567,2467,376,18292,10239,548,1402,1004,1478,355,15026
2020-03-03,전북,충북,1452,127,223,365,492,44,2703,1282,139,240,306,290,38,2295
2020-03-03,충남,강원,280,10,16,48,69,8,431,185,7,20,27,34,9,282
2020-03-03,충남,경기,29261,1605,2764,2594,4381,1578,42183,30364,1705,2949,2709,4505,1632,43864
2020-03-03,충남,경남,1012,68,159,351,551,33,2174,647,49,127,249,246,19,1337
2020-03-03,충남,경북,1948,136,362,509,824,78,3857,1894,147,324,567,655,70,3657
2020-03-03,충남,광주,3192,152,459,675,389,74,4941,3009,111,442,491,289,71,4413
2020-03-03,충남,대구,460,49,128,165,176,14,992,710,73,137,205,252,23,1400
2020-03-03,충남,대전,12888,499,469,339,212,988,15395,14337,524,520,346,191,1061,16979
2020-03-03,충남,부산,82,11,34,91,146,5,369,101,14,19,75,168,3,380
2020-03-03,충남,서울,20686,702,2010,1516,1293,829,27036,21161,578,2074,913,764,895,26385
2020-03-03,충남,세종,3746,140,155,108,147,203,4499,4904,157,150,106,189,275,5781
2020-03-03,충남,울산,77,4,11,36,125,0,253,72,4,15,47,142,1,281
2020-03-03,충남,전남,3239,91,441,564,1064,93,5492,1268,51,205,492,298,35,2349
2020-03-03,충남,전북,10239,548,1402,1004,1478,355,15026,11664,596,1622,1567,2467,376,18292
2020-03-03,충남,충남,77322,3659,7565,7740,10942,3841,111069,77322,3659,7565,7740,10942,3841,111069
2020-03-03,충남,충북,11035,666,895,1051,1577,653,15877,10135,651,853,876,1607,607,14729
2020-03-03,충북,강원,3383,212,240,250,346,217,4648,3226,226,294,277,386,227,4636
2020-03-03,충북,경기,21421,2246,2893,2956,3723,1088,34327,22043,2317,3018,3319,3538,1128,35363
2020-03-03,충북,경남,848,80,194,485,651,40,2298,705,68,140,299,318,31,1561
2020-03-03,충북,경북,3026,242,494,682,1069,101,5614,3074,237,499,728,978,116,5632
2020-03-03,충북,광주,459,38,98,213,119,4,931,409,26,59,133,77,5,709
2020-03-03,충북,대구,555,81,141,234,139,23,1173,818,96,157,274,368,25,1738
2020-03-03,충북,대전,8813,435,415,183,161,645,10652,9775,495,451,219,189,700,11829
2020-03-03,충북,부산,64,14,33,138,181,6,436,85,12,27,95,239,2,460
2020-03-03,충북,서울,10551,661,1045,924,814,403,14398,11206,549,1032,836,696,463,14782
2020-03-03,충북,세종,295,15,17,15,13,27,382,338,23,11,21,15,27,435
2020-03-03,충북,울산,10,2,5,14,25,0,56,9,1,5,25,46,0,86
2020-03-03,충북,전남,265,23,65,127,266,4,750,117,11,16,55,61,1,261
2020-03-03,충북,전북,1282,139,240,306,290,38,2295,1452,127,223,365,492,44,2703
2020-03-03,충북,충남,10135,651,853,876,1607,607,14729,11035,666,895,1051,1577,653,15877
2020-03-03,충북,충북,30445,2032,2429,2134,3203,1912,42155,30445,2032,2429,2134,3203,1912,42155
2020-03-04,강원,강원,49313,2116,2560,1287,2472,3506,61254,49313,2116,2560,1287,2472,3506,61254
2020-03-04,강원,경기,14158,546,1024,633,733,678,17772,15013,576,1015,723,889,754,18970
2020-03-04,강원,경남,101,5,8,14,17,3,148,64,1,1,19,8,1,94
2020-03-04,강원,경북,213,22,20,19,19,7,300,203,17,13,35,23,7,298
2020-03-04,강원,광주,70,6,17,11,14,0,118,38,3,12,12,5,3,73
2020-03-04,강원,대구,99,5,3,13,11,2,133,146,6,8,26,17,7,210
2020-03-04,강원,대전,99,2,18,7,2,6,134,106,3,20,7,1,4,141
2020-03-04,강원,부산,5,0,0,1,5,0,11,4,0,1,1,3,0,9
2020-03-04,강원,서울,473,15,169,12,16,17,702,592,16,123,17,9,23,780
2020-03-04,강원,세종,2,0,0,0,0,0,2,4,0,1,0,0,1,6
2020-03-04,강원,울산,1,0,0,0,0,0,1,1,0,0,0,0,0,1
2020-03-04,강원,전남,25,1,4,5,21,0,56,6,2,5,5,7,0,25
2020-03-04,강원,전북,63,4,7,16,15,0,105,93,6,15,20,31,1,166
2020-03-04,강원,충남,161,7,13,24,30,4,239,277,5,22,42,65,10,421
2020-03-04,강원,충북,3336,214,263,228,361,210,4612,3407,218,223,234,305,224,4611
2020-03-04,경기,강원,15013,576,1015,723,889,754,18970,14158,546,1024,633,733,678,17772
2020-03-04,경기,경기,391674,23294,24576,19291,24180,29462,512477,391674,23294,24576,19291,24180,29462,512477
2020-03-04,경기,경남,1791,93,313,740,600,57,3594,1195,58,245,519,418,45,2480
2020-03-04,경기,경북,2074,170,434,776,637,63,4154,2061,190,412,947,577,69,4256
2020-03-04,경기,광주,598,40,141,327,162,9,1277,492,26,114,256,126,16,1030
2020-03-04,경기,대구,854,77,167,335,218,33,1684,1413,107,175,450,446,52,2643
2020-03-04,경기,대전,1446,109,211,123,51,77,2017,1508,105,193,119,42,74,2041
2020-03-04,경기,부산,156,20,47,200,162,6,591,151,29,36,153,263,10,642
2020-03-04,경기,서울,135297,7292,8769,5399,3897,9289,169943,136928,6956,9239,5069,3515,9391,171098
2020-03-04,경기,세종,28,3,2,4,2,0,39,37,4,5,1,0,2,49
2020-03-04,경기,울산,20,2,2,13,15,0,52,19,2,11,19,82,0,133
2020-03-04,경기,전남,551,13,90,159,188,18,1019,453,15,63,115,94,22,762
2020-03-04,경기,전북,947,52,159,135,213,33,1539,964,50,154,219,252,32,1671
2020-03-04,경기,충남,29466,1582,2876,2577,4604,1587,42692,29209,1504,2718,2465,4237,1565,41698
2020-03-04,경기,충북,21674,2246,3054,3294,3331,1069,34668,21390,2166,2886,2859,3587,1058,33946
2020-03-04,경남,강원,64,1,1,19,8,1,94,101,5,8,14,17,3,148
2020-03-04,경남,경기,1195,58,245,519,418,45,2480,1791,93,313,740,600,57,3594
2020-03-04,경남,경남,168931,9878,9633,7153,14160,12779,222534,168931,9878,9633,7153,14160,12779,222534
2020-03-04,경남,경북,6451,579,881,867,1862,305,10945,7938,811,1110,1210,2598,334,14001
2020-03-04,경남,광주,708,46,123,168,149,13,1207,699,39,115,158,101,13,1125
2020-03-04,경남,대구,7818,681,716,964,1702,283,12164,5802,489,538,376,494,232,7931
2020-03-04,경남,대전,482,18,86,63,38,17,704,616,18,88,125,69,20,936
2020-03-04,경남,부산,75665,2527,2627,1744,4612,5459,92634,75114,2629,2837,1739,4717,5426,92462
2020-03-04,경남,서울,1408,38,320,297,133,42,2238,1864,34,350,180,121,47,2596
2020-03-04,경남,세종,98,1,9,12,13,3,136,127,1,21,13,12,10,184
2020-03-04,경남,울산,7833,637,655,480,710,509,10824,7691,568,713,436,654,473,10535
2020-03-04,경남,전남,4682,281,448,512,1383,216,7522,4659,323,443,437,1361,206,7429
2020-03-04,경남,전북,751,40,122,112,176,23,1224,744,38,113,107,180,28,1210
2020-03-04,경남,충남,654,41,91,250,241,22,1299,1012,69,142,358,550,28,2159
2020-03-04,경남,충북,643,49,131,271,269,16,1379,923,58,189,507,600,34,2311
2020-03-04,경북,강원,203,17,13,35,23,7,298,213,22,20,19,19,7,300
2020-03-04,경북,경기,2061,190,412,947,577,69,4256,2074,170,434,776,637,63,4154
2020-03-04,경북,경남,7938,811,1110,1210,2598,334,14001,6451,579,881,867,1862,305,10945
2020-03-04,경북,경북,53416,3670,3725,2976,5045,2806,71638,53416,3670,3725,2976,5045,2806,71638
2020-03-04,경북,광주,439,53,111,187,150,10,950,428,45,88,146,85,9,801
2020-03-04,경북,대구,52437,2807,2247,1499,2933,2726,64649,54856,3042,2648,1845,3519,2813,68723
2020-03-04,경북,대전,1102,64,83,115,99,45,1508,1102,68,91,134,74,51,1520
2020-03-04,경북,부산,2718,116,194,221,628,130,4007,2909,135,221,208,740,147,4360
2020-03-04,경북,서울,1487,99,246,444,154,40,2470,1538,74,263,246,118,46,2285
2020-03-04,경북,세종,142,5,16,25,25,2,215,170,7,13,22,12,3,227
2020-03-04,경북,울산,3568,174,301,416,1016,196,5671,3491,163,303,339,1278,191,5765
2020-03-04,경북,전남,628,39,63,118,459,19,1326,486,38,70,74,341,13,1022
2020-03-04,경북,전북,1316,97,178,213,244,32,2080,1258,110,181,160,488,33,2230
2020-03-04,경북,충남,1953,161,341,555,551,66,3627,1994,140,377,495,744,85,3835
2020-03-04,경북,충북,3093,229,474,711,969,108,5584,3004,240,519,659,987,120,5529
2020-03-04,광주,강원,38,3,12,12,5,3,73,70,6,17,11,14,0,118
2020-03-04,광주,경기,492,26,114,256,126,16,1030,598,40,141,327,162,9,1277
2020-03-04,광주,경남,699,39,115,158,101,13,1125,708,46,123,168,149,13,1207
2020-03-04,광주,경북,428,45,88,146,85,9,801,439,53,111,187,150,10,950
2020-03-04,광주,광주,12080,495,588,373,485,515,14536,12080,495,588,373,485,515,14536
2020-03-04,광주,대구,258,18,67,93,26,8,470,276,27,73,80,30,8,494
2020-03-04,광주,대전,307,17,9,21,16,4,374,327,14,23,31,17,6,418
2020-03-04,광주,부산,244,14,35,34,82,7,416,264,17,33,82,131,11,538
2020-03-04,광주,서울,420,17,21,79,25,15,577,509,18,15,45,20,14,621
2020-03-04,광주,세종,109,1,8,2,7,6,133,124,4,4,10,7,4,153
2020-03-04,광주,울산,32,1,7,3,6,0,49,21,3,6,1,5,2,38
2020-03-04,광주,전남,29225,1005,1126,830,1939,1153,35278,28361,949,1039,694,1857,1145,34045
2020-03-04,광주,전북,6217,426,528,374,371,241,8157,6326,443,445,351,395,231,8191
2020-03-04,광주,충남,3038,129,436,476,254,90,4423,3120,132,439,640,389,91,4811
2020-03-04,광주,충북,424,30,64,118,60,12,708,459,39,95,180,108,9,890
2020-03-04,대구,강원,146,6,8,26,17,7,210,99,5,3,13,11,2,133
2020-03-04,대구,경기,1413,107,175,450,446,52,2643,854,77,167,335,218,33,1684
2020-03-04,대구,경남,5802,489,538,376,494,232,7931,7818,681,716,964,1702,283,12164
2020-03-04,대구,경북,54856,3042,2648,1845,3519,2813,68723,52437,2807,2247,1499,2933,2726,64649
2020-03-04,대구,광주,276,27,73,80,30,8,494,258,18,67,93,26,8,470
2020-03-04,대구,대구,48454,2077,1596,1171,1149,3223,57670,48454,2077,1596,1171,1149,3223,57670
2020-03-04,대구,대전,465,32,35,73,49,22,676,300,24,20,57,20,14,435
2020-03-04,대구,부산,363,59,89,62,126,16,715,1549,87,159,84,253,73,2205
2020-03-04,대구,서울,1351,49,79,218,119,30,1846,794,52,59,124,53,17,1099
2020-03-04,대구,세종,106,1,8,8,7,5,135,70,5,1,3,5,3,87
2020-03-04,대구,울산,596,52,69,83,151,29,980,606,46,75,78,184,30,1019
2020-03-04,대구,전남,286,11,29,33,50,3,412,301,11,26,24,67,4,433
2020-03-04,대구,전북,139,15,19,15,28,6,222,131,10,23,22,18,4,208
2020-03-04,대구,충남,701,79,122,200,232,15,1349,504,58,101,145,192,7,1007
2020-03-04,대구,충북,859,65,135,269,389,35,1752,583,73,134,213,136,20,1159
2020-03-04,대전,강원,106,3,20,7,1,4,141,99,2,18,7,2,6,134
2020-03-04,대전,경기,1508,105,193,119,42,74,2041,1446,109,211,123,51,77,2017
2020-03-04,대전,경남,616,18,88,125,69,20,936,482,18,86,63,38,17,704
2020-03-04,대전,경북,1102,68,91,134,74,51,1520,1102,64,83,115,99,45,1508
2020-03-04,대전,광주,327,14,23,31,17,6,418,307,17,9,21,16,4,374
2020-03-04,대전,대구,300,24,20,57,20,14,435,465,32,35,73,49,22,676
2020-03-04,대전,대전,12805,402,384,250,150,970,14961,12805,402,384,250,150,970,14961
2020-03-04,대전,부산,47,3,6,17,21,2,96,45,8,5,15,24,4,101
2020-03-04,대전,서울,1334,56,144,35,8,56,1633,1425,46,151,41,7,70,1740
2020-03-04,대전,세종,3101,105,72,33,75,265,3651,3050,110,79,31,76,250,3596
2020-03-04,대전,울산,57,2,9,17,32,1,118,71,5,13,8,30,2,129
2020-03-04,대전,전남,184,6,8,18,29,5,250,82,3,7,8,6,0,106
2020-03-04,대전,전북,2457,75,110,103,50,118,2913,2567,94,100,106,61,124,3052
2020-03-04,대전,충남,14068,454,521,275,202,1074,16594,12632,486,464,243,201,1001,15027
2020-03-04,대전,충북,9595,447,439,215,194,713,11603,8951,395,437,180,156,665,10784
2020-03-04,부산,강원,4,0,1,1,3,0,9,5,0,0,1,5,0,11
2020-03-04,부산,경기,151,29,36,153,263,10,642,156,20,47,200,162,6,591
2020-03-04,부산,경남,75114,2629,2837,1739,4717,5426,92462,75665,2527,2627,1744,4612,5459,92634
2020-03-04,부산,경북,2909,135,221,208,740,147,4360,2718,116,194,221,628,130,4007
2020-03-04,부산,광주,264,17,33,82,131,11,538,244,14,35,34,82,7,416
2020-03-04,부산,대구,1549,87,159,84,253,73,2205,363,59,89,62,126,16,715
2020-03-04,부산,대전,45,8,5,15,24,4,101,47,3,6,17,21,2,96
2020-03-04,부산,부산,37395,680,617,827,2165,2888,44572,37395,680,617,827,2165,2888,44572
2020-03-04,부산,서울,142,12,15,91,61,5,326,146,10,19,63,30,6,274
2020-03-04,부산,세종,11,0,3,4,3,0,21,14,1,1,0,5,0,21
2020-03-04,부산,울산,12969,359,475,643,2642,981,18069,13126,371,407,432,2585,991,17912
2020-03-04,부산,전남,1446,81,115,194,596,63,2495,1328,72,93,149,540,62,2244
2020-03-04,부산,전북,165,8,27,34,84,5,323,155,13,27,39,56,6,296
2020-03-04,부산,충남,86,13,22,67,166,5,359,78,16,23,84,230,3,434
2020-03-04,부산,충북,70,14,20,101,231,3,439,96,13,28,112,187,2,438
2020-03-04,서울,강원,592,16,123,17,9,23,780,473,15,169,12,16,17,702
2020-03-04,서울,경기,136928,6956,9239,5069,3515,9391,171098,135297,7292,8769,5399,3897,9289,169943
2020-03-04,서울,경남,1864,34,350,180,121,47,2596,1408,38,320,297,133,42,2238
2020-03-04,서울,경북,1538,74,263,246,118,46,2285,1487,99,246,444,154,40,2470
2020-03-04,서울,광주,509,18,15,45,20,14,621,420,17,21,79,25,15,577
2020-03-04,서울,대구,794,52,59,124,53,17,1099,1351,49,79,218,119,30,1846
2020-03-04,서울,대전,1425,46,151,41,7,70,1740,1334,56,144,35,8,56,1633
2020-03-04,서울,부산,146,10,19,63,30,6,274,142,12,15,91,61,5,326
2020-03-04,서울,서울,185,4,10,0,1,5,205,185,4,10,0,1,5,205
2020-03-04,서울,세종,16,1,0,0,0,0,17,17,0,1,2,0,0,20
2020-03-04,서울,울산,23,0,1,2,2,2,30,25,0,4,9,11,1,50
2020-03-04,서울,전남,631,15,22,42,26,19,755,553,9,18,74,40,18,712
2020-03-04,서울,전북,901,14,37,23,23,34,1032,901,24,31,48,41,38,1083
2020-03-04,서울,충남,20248,512,2008,810,727,837,25142,20414,631,1975,1337,1160,820,26337
2020-03-04,서울,충북,10960,522,1025,764,688,483,14442,10813,662,1036,891,817,442,14661
2020-03-04,세종,강원,4,0,1,0,0,1,6,2,0,0,0,0,0,2
2020-03-04,세종,경기,37,4,5,1,0,2,49,28,3,2,4,2,0,39
2020-03-04,세종,경남,127,1,21,13,12,10,184,98,1,9,12,13,3,136
2020-03-04,세종,경북,170,7,13,22,12,3,227,142,5,16,25,25,2,215
2020-03-04,세종,광주,124,4,4,10,7,4,153,109,1,8,2,7,6,133
2020-03-04,세종,대구,70,5,1,3,5,3,87,106,1,8,8,7,5,135
2020-03-04,세종,대전,3050,110,79,31,76,250,3596,3101,105,72,33,75,265,3651
2020-03-04,세종,부산,14,1,1,0,5,0,21,11,0,3,4,3,0,21
2020-03-04,세종,서울,17,0,1,2,0,0,20,16,1,0,0,0,0,17
2020-03-04,세종,세종,227,29,1,1,1,10,269,227,29,1,1,1,10,269
2020-03-04,세종,울산,5,0,0,2,2,0,9,5,0,0,1,8,0,14
2020-03-04,세종,전남,102,2,3,2,10,6,125,73,1,2,5,18,5,104
2020-03-04,세종,전북,481,23,27,13,32,24,600,488,10,14,16,29,23,580
2020-03-04,세종,충남,4832,181,157,101,156,280,5707,3694,147,138,128,144,176,4427
2020-03-04,세종,충북,343,10,15,17,22,29,436,292,14,12,13,22,22,375
2020-03-04,울산,강원,1,0,0,0,0,0,1,1,0,0,0,0,0,1
2020-03-04,울산,경기,19,2,11,19,82,0,133,20,2,2,13,15,0,52
2020-03-04,울산,경남,7691,568,713,436,654,473,10535,7833,637,655,480,710,509,10824
2020-03-04,울산,경북,3491,163,303,339,1278,191,5765,3568,174,301,416,1016,196,5671
2020-03-04,울산,광주,21,3,6,1,5,2,38,32,1,7,3,6,0,49
2020-03-04,울산,대구,606,46,75,78,184,30,1019,596,52,69,83,151,29,980
2020-03-04,울산,대전,71,5,13,8,30,2,129,57,2,9,17,32,1,118
2020-03-04,울산,부산,13126,371,407,432,2585,991,17912,12969,359,475,643,2642,981,18069
2020-03-04,울산,서울,25,0,4,9,11,1,50,23,0,1,2,2,2,30
2020-03-04,울산,세종,5,0,0,1,8,0,14,5,0,0,2,2,0,9
2020-03-04,울산,울산,7119,336,483,252,655,624,9469,7119,336,483,252,655,624,9469
2020-03-04,울산,전남,140,12,21,15,23,3,214,127,17,23,13,47,7,234
2020-03-04,울산,전북,33,0,7,2,18,1,61,15,0,5,1,2,1,24
2020-03-04,울산,충남,74,4,16,59,117,3,273,69,4,8,32,119,2,234
2020-03-04,울산,충북,13,3,2,17,47,0,82,8,2,2,8,27,1,48
2020-03-04,전남,강원,6,2,5,5,7,0,25,25,1,4,5,21,0,56
2020-03-04,전남,경기,453,15,63,115,94,22,762,551,13,90,159,188,18,1019
2020-03-04,전남,경남,4659,323,443,437,1361,206,7429,4682,281,448,512,1383,216,7522
2020-03-04,전남,경북,486,38,70,74,341,13,1022,628,39,63,118,459,19,1326
2020-03-04,전남,광주,28361,949,1039,694,1857,1145,34045,29225,1005,1126,830,1939,1153,35278
2020-03-04,전남,대구,301,11,26,24,67,4,433,286,11,29,33,50,3,412
2020-03-04,전남,대전,82,3,7,8,6,0,106,184,6,8,18,29,5,250
2020-03-04,전남,부산,1328,72,93,149,540,62,2244,1446,81,115,194,596,63,2495
2020-03-04,전남,서울,553,9,18,74,40,18,712,631,15,22,42,26,19,755
2020-03-04,전남,세종,73,1,2,5,18,5,104,102,2,3,2,10,6,125
2020-03-04,전남,울산,127,17,23,13,47,7,234,140,12,21,15,23,3,214
2020-03-04,전남,전남,37811,1419,1504,2141,5141,1493,49509,37811,1419,1504,2141,5141,1493,49509
2020-03-04,전남,전북,5569,338,654,850,2878,148,10437,3742,247,420,562,1403,101,6475
2020-03-04,전남,충남,1344,52,182,422,281,35,2316,3193,104,413,563,1006,101,5380
2020-03-04,전남,충북,119,11,19,56,64,1,270,247,25,43,112,236,7,670
2020-03-04,전북,강원,93,6,15,20,31,1,166,63,4,7,16,15,0,105
2020-03-04,전북,경기,964,50,154,219,252,32,1671,947,52,159,135,213,33,1539
2020-03-04,전북,경남,744,38,113,107,180,28,1210,751,40,122,112,176,23,1224
2020-03-04,전북,경북,1258,110,181,160,488,33,2230,1316,97,178,213,244,32,2080
2020-03-04,전북,광주,6326,443,445,351,395,231,8191,6217,426,528,374,371,241,8157
2020-03-04,전북,대구,131,10,23,22,18,4,208,139,15,19,15,28,6,222
2020-03-04,전북,대전,2567,94,100,106,61,124,3052,2457,75,110,103,50,118,2913
2020-03-04,전북,부산,155,13,27,39,56,6,296,165,8,27,34,84,5,323
2020-03-04,전북,서울,901,24,31,48,41,38,1083,901,14,37,23,23,34,1032
2020-03-04,전북,세종,488,10,14,16,29,23,580,481,23,27,13,32,24,600
2020-03-04,전북,울산,15,0,5,1,2,1,24,33,0,7,2,18,1,61
2020-03-04,전북,전남,3742,247,420,562,1403,101,6475,5569,338,654,850,2878,148,10437
2020-03-04,전북,전북,14206,669,1021,851,1331,519,18597,14206,669,1021,851,1331,519,18597
2020-03-04,전북,충남,11745,574,1640,1399,2424,368,18150,10109,554,1460,964,1409,362,14858
2020-03-04,전북,충북,1376,131,184,359,449,48,2547,1323,118,221,286,280,45,2273
2020-03-04,충남,강원,277,5,22,42,65,10,421,161,7,13,24,30,4,239
2020-03-04,충남,경기,29209,1504,2718,2465,4237,1565,41698,29466,1582,2876,2577,4604,1587,42692
2020-03-04,충남,경남,1012,69,142,358,550,28,2159,654,41,91,250,241,22,1299
2020-03-04,충남,경북,1994,140,377,495,744,85,3835,1953,161,341,555,551,66,3627
2020-03-04,충남,광주,3120,132,439,640,389,91,4811,3038,129,436,476,254,90,4423
2020-03-04,충남,대구,504,58,101,145,192,7,1007,701,79,122,200,232,15,1349
2020-03-04,충남,대전,12632,486,464,243,201,1001,15027,14068,454,521,275,202,1074,16594
2020-03-04,충남,부산,78,16,23,84,230,3,434,86,13,22,67,166,5,359
2020-03-04,충남,서울,20414,631,1975,1337,1160,820,26337,20248,512,2008,810,727,837,25142
2020-03-04,충남,세종,3694,147,138,128,144,176,4427,4832,181,157,101,156,280,5707
2020-03-04,충남,울산,69,4,8,32,119,2,234,74,4,16,59,117,3,273
2020-03-04,충남,전남,3193,104,413,563,1006,101,5380,1344,52,182,422,281,35,2316
2020-03-04,충남,전북,10109,554,1460,964,1409,362,14858,11745,574,1640,1399,2424,368,18150
2020-03-04,충남,충남,77234,3645,7401,7161,10380,3781,109602,77234,3645,7401,7161,10380,3781,109602
2020-03-04,충남,충북,11206,688,939,981,1573,616,16003,10224,634,868,846,1562,590,14724
2020-03-04,충북,강원,3407,218,223,234,305,224,4611,3336,214,263,228,361,210,4612
2020-03-04,충북,경기,21390,2166,2886,2859,3587,1058,33946,21674,2246,3054,3294,3331,1069,34668
2020-03-04,충북,경남,923,58,189,507,600,34,2311,643,49,131,271,269,16,1379
2020-03-04,충북,경북,3004,240,519,659,987,120,5529,3093,229,474,711,969,108,5584
2020-03-04,충북,광주,459,39,95,180,108,9,890,424,30,64,118,60,12,708
2020-03-04,충북,대구,583,73,134,213,136,20,1159,859,65,135,269,389,35,1752
2020-03-04,충북,대전,8951,395,437,180,156,665,10784,9595,447,439,215,194,713,11603
2020-03-04,충북,부산,96,13,28,112,187,2,438,70,14,20,101,231,3,439
2020-03-04,충북,서울,10813,662,1036,891,817,442,14661,10960,522,1025,764,688,483,14442
2020-03-04,충북,세종,292,14,12,13,22,22,375,343,10,15,17,22,29,436
2020-03-04,충북,울산,8,2,2,8,27,1,48,13,3,2,17,47,0,82
2020-03-04,충북,전남,247,25,43,112,236,7,670,119,11,19,56,64,1,270
2020-03-04,충북,전북,1323,118,221,286,280,45,2273,1376,131,184,359,449,48,2547
2020-03-04,충북,충남,10224,634,868,846,1562,590,14724,11206,688,939,981,1573,616,16003
2020-03-04,충북,충북,29998,1922,2246,2151,3081,1843,41241,29998,1922,2246,2151,3081,1843,41241
2020-03-05,강원,강원,52212,2208,2526,1373,2564,3635,64518,52212,2208,2526,1373,2564,3635,64518
2020-03-05,강원,경기,15457,567,1035,637,698,770,19164,16774,626,991,713,891,832,20827
2020-03-05,강원,경남,98,1,12,16,31,2,160,64,1,7,17,7,2,98
2020-03-05,강원,경북,253,22,19,18,25,11,348,248,17,19,25,42,6,357
2020-03-05,강원,광주,41,0,20,7,14,1,83,41,3,14,10,8,3,79
2020-03-05,강원,대구,91,3,4,13,8,2,121,126,8,12,13,14,6,179
2020-03-05,강원,대전,118,1,22,3,1,5,150,135,6,27,2,0,7,177
2020-03-05,강원,부산,1,0,0,0,4,0,5,5,0,1,0,3,0,9
2020-03-05,강원,서울,606,9,160,13,13,24,825,643,14,126,13,11,27,834
2020-03-05,강원,세종,2,0,1,0,1,0,4,7,0,1,0,2,0,10
2020-03-05,강원,울산,0,0,0,0,0,0,0,0,0,0,0,0,0,0
2020-03-05,강원,전남,20,1,1,1,17,0,40,12,2,0,5,4,0,23
2020-03-05,강원,전북,78,5,14,17,19,3,136,110,7,17,21,37,5,197
2020-03-05,강원,충남,184,9,15,22,38,9,277,258,12,18,39,73,12,412
2020-03-05,강원,충북,3487,241,275,243,416,228,4890,3595,195,236,218,327,229,4800
2020-03-05,경기,강원,16774,626,991,713,891,832,20827,15457,567,1035,637,698,770,19164
2020-03-05,경기,경기,400564,23656,24933,19735,24213,29432,522533,400564,23656,24933,19735,24213,29432,522533
2020-03-05,경기,경남,1947,82,318,723,575,51,3696,1395,69,244,563,452,44,2767
2020-03-05,경기,경북,2167,178,458,812,639,76,4330,2194,194,412,947,614,67,4428
2020-03-05,경기,광주,616,33,164,308,143,15,1279,480,25,125,257,137,21,1045
2020-03-05,경기,대구,912,76,190,366,231,24,1799,1475,98,159,463,428,50,2673
2020-03-05,경기,대전,1538,89,199,106,46,87,2065,1612,108,194,104,48,72,2138
2020-03-05,경기,부산,159,24,46,178,160,3,570,165,15,41,156,315,5,697
2020-03-05,경기,서울,138587,7303,8839,5407,3839,9403,173378,139914,6981,9162,4970,3518,9527,174072
2020-03-05,경기,세종,27,1,2,5,5,2,42,33,7,3,4,3,1,51
2020-03-05,경기,울산,20,0,1,13,18,0,52,37,1,9,45,75,1,168
2020-03-05,경기,전남,625,19,106,149,172,23,1094,559,21,71,112,91,16,870
2020-03-05,경기,전북,989,53,166,143,194,34,1579,1061,58,157,219,258,36,1789
2020-03-05,경기,충남,31125,1602,2862,2535,4499,1573,44196,30304,1511,2667,2498,4241,1558,42779
2020-03-05,경기,충북,22544,2220,2953,3291,3397,1167,35572,22109,2101,2859,2852,3593,1075,34589
2020-03-05,경남,강원,64,1,7,17,7,2,98,98,1,12,16,31,2,160
2020-03-05,경남,경기,1395,69,244,563,452,44,2767,1947,82,318,723,575,51,3696
2020-03-05,경남,경남,169640,9820,9812,7269,14660,12916,224117,169640,9820,9812,7269,14660,12916,224117
2020-03-05,경남,경북,6344,581,833,921,1776,292,10747,8157,853,1120,1252,2534,388,14304
2020-03-05,경남,광주,773,47,124,221,154,24,1343,721,45,148,177,116,17,1224
2020-03-05,경남,대구,8015,710,807,1036,1722,298,12588,5871,467,573,375,512,214,8012
2020-03-05,경남,대전,481,24,88,85,39,19,736,666,35,96,124,72,26,1019
2020-03-05,경남,부산,75647,2574,2551,1787,4922,5337,92818,75572,2679,2735,1837,4961,5353,93137
2020-03-05,경남,서울,1441,44,327,281,145,44,2282,1996,44,338,201,126,58,2763
2020-03-05,경남,세종,155,2,11,12,5,6,191,187,2,14,16,16,4,239
2020-03-05,경남,울산,7954,605,640,477,696,520,10892,7643,565,676,455,677,462,10478
2020-03-05,경남,전남,4789,269,412,488,1414,175,7547,4807,301,436,432,1378,217,7571
2020-03-05,경남,전북,789,44,118,108,190,27,1276,826,53,110,102,175,27,1293
2020-03-05,경남,충남,766,53,112,237,214,16,1398,1108,64,165,380,516,52,2285
2020-03-05,경남,충북,716,61,139,299,296,26,1537,936,78,199,492,661,33,2399
2020-03-05,경북,강원,248,17,19,25,42,6,357,253,22,19,18,25,11,348
2020-03-05,경북,경기,2194,194,412,947,614,67,4428,2167,178,458,812,639,76,4330
2020-03-05,경북,경남,8157,853,1120,1252,2534,388,14304,6344,581,833,921,1776,292,10747
2020-03-05,경북,경북,53451,3733,3727,2857,4963,2835,71566,53451,3733,3727,2857,4963,2835,71566
2020-03-05,경북,광주,513,50,105,195,159,11,1033,429,38,94,147,98,16,822
2020-03-05,경북,대구,52411,2760,2202,1539,2970,2739,64621,55092,2956,2562,1845,3511,2839,68805
2020-03-05,경북,대전,1095,50,103,115,79,47,1489,1106,49,95,123,80,49,1502
2020-03-05,경북,부산,2843,129,181,206,707,120,4186,2987,119,209,237,840,131,4523
2020-03-05,경북,서울,1514,96,243,426,154,58,2491,1558,78,250,245,117,47,2295
2020-03-05,경북,세종,176,6,19,21,18,6,246,153,5,11,15,4,3,191
2020-03-05,경북,울산,3428,174,306,394,999,225,5526,3603,166,291,310,1232,219,5821
2020-03-05,경북,전남,687,38,82,126,467,20,1420,519,39,59,64,269,13,963
2020-03-05,경북,전북,1446,83,178,184,241,32,2164,1284,105,170,172,491,35,2257
2020-03-05,경북,충남,1992,128,309,618,612,67,3726,2150,110,337,516,744,75,3932
2020-03-05,경북,충북,3297,205,480,712,997,127,5818,3136,245,489,680,1037,132,5719
2020-03-05,광주,강원,41,3,14,10,8,3,79,41,0,20,7,14,1,83
2020-03-05,광주,경기,480,25,125,257,137,21,1045,616,33,164,308,143,15,1279
2020-03-05,광주,경남,721,45,148,177,116,17,1224,773,47,124,221,154,24,1343
2020-03-05,광주,경북,429,38,94,147,98,16,822,513,50,105,195,159,11,1033
2020-03-05,광주,광주,12321,548,610,490,559,524,15052,12321,548,610,490,559,524,15052
2020-03-05,광주,대구,279,25,64,82,28,9,487,302,31,65,80,32,8,518
2020-03-05,광주,대전,289,18,13,20,13,7,360,338,15,17,30,14,9,423
2020-03-05,광주,부산,286,11,42,55,78,5,477,291,22,50,61,115,13,552
2020-03-05,광주,서울,502,21,29,88,13,18,671,604,20,26,54,19,15,738
2020-03-05,광주,세종,101,2,9,3,3,3,121,137,6,6,6,1,3,159
2020-03-05,광주,울산,41,3,9,6,1,0,60,37,1,7,6,10,0,61
2020-03-05,광주,전남,29517,981,1094,806,1813,1114,35325,28225,966,959,684,1815,1061,33710
2020-03-05,광주,전북,6391,430,563,362,372,246,8364,6565,462,506,347,425,237,8542
2020-03-05,광주,충남,3180,113,448,496,261,79,4577,3318,140,473,609,378,86,5004
2020-03-05,광주,충북,413,36,60,115,67,14,705,497,39,102,189,122,11,960
2020-03-05,대구,강원,126,8,12,13,14,6,179,91,3,4,13,8,2,121
2020-03-05,대구,경기,1475,98,159,463,428,50,2673,912,76,190,366,231,24,1799
2020-03-05,대구,경남,5871,467,573,375,512,214,8012,8015,710,807,1036,1722,298,12588
2020-03-05,대구,경북,55092,2956,2562,1845,3511,2839,68805,52411,2760,2202,1539,2970,2739,64621
2020-03-05,대구,광주,302,31,65,80,32,8,518,279,25,64,82,28,9,487
2020-03-05,대구,대구,47971,2010,1559,816,1054,3208,56618,47971,2010,1559,816,1054,3208,56618
2020-03-05,대구,대전,483,27,45,71,38,18,682,284,18,27,54,17,10,410
2020-03-05,대구,부산,395,51,92,57,144,7,746,1600,90,155,94,266,68,2273
2020-03-05,대구,서울,1461,62,100,226,106,47,2002,793,57,73,121,50,16,1110
2020-03-05,대구,세종,123,3,7,7,7,5,152,68,2,4,4,4,2,84
2020-03-05,대구,울산,674,48,65,70,154,34,1045,639,50,79,66,172,32,1038
2020-03-05,대구,전남,321,13,36,34,37,9,450,295,15,29,17,54,6,416
2020-03-05,대구,전북,162,16,18,12,25,3,236,146,7,22,14,29,4,222
2020-03-05,대구,충남,788,66,131,214,220,25,1444,546,63,95,164,192,14,1074
2020-03-05,대구,충북,901,86,152,266,389,27,1821,579,61,111,217,138,17,1123
2020-03-05,대전,강원,135,6,27,2,0,7,177,118,1,22,3,1,5,150
2020-03-05,대전,경기,1612,108,194,104,48,72,2138,1538,89,199,106,46,87,2065
2020-03-05,대전,경남,666,35,96,124,72,26,1019,481,24,88,85,39,19,736
2020-03-05,대전,경북,1106,49,95,123,80,49,1502,1095,50,103,115,79,47,1489
2020-03-05,대전,광주,338,15,17,30,14,9,423,289,18,13,20,13,7,360
2020-03-05,대전,대구,284,18,27,54,17,10,410,483,27,45,71,38,18,682
2020-03-05,대전,대전,12741,406,383,271,191,912,14904,12741,406,383,271,191,912,14904
2020-03-05,대전,부산,50,3,7,13,20,1,94,70,1,11,22,21,1,126
2020-03-05,대전,서울,1456,51,147,35,7,66,1762,1489,56,140,41,7,48,1781
2020-03-05,대전,세종,3049,97,75,33,44,237,3535,3071,107,72,38,40,233,3561
2020-03-05,대전,울산,63,3,12,18,21,2,119,82,1,14,14,26,2,139
2020-03-05,대전,전남,216,10,4,28,36,6,300,87,4,5,3,5,3,107
2020-03-05,대전,전북,2494,87,88,91,58,129,2947,2570,99,84,88,60,133,3034
2020-03-05,대전,충남,14028,475,495,253,260,1040,16551,12763,456,479,251,226,925,15100
2020-03-05,대전,충북,9933,459,428,216,186,730,11952,8822,385,399,189,169,675,10639
2020-03-05,부산,강원,5,0,1,0,3,0,9,1,0,0,0,4,0,5
2020-03-05,부산,경기,165,15,41,156,315,5,697,159,24,46,178,160,3,570
2020-03-05,부산,경남,75572,2679,2735,1837,4961,5353,93137,75647,2574,2551,1787,4922,5337,92818
2020-03-05,부산,경북,2987,119,209,237,840,131,4523,2843,129,181,206,707,120,4186
2020-03-05,부산,광주,291,22,50,61,115,13,552,286,11,42,55,78,5,477
2020-03-05,부산,대구,1600,90,155,94,266,68,2273,395,51,92,57,144,7,746
2020-03-05,부산,대전,70,1,11,22,21,1,126,50,3,7,13,20,1,94
2020-03-05,부산,부산,37798,643,548,675,2260,2919,44843,37798,643,548,675,2260,2919,44843
2020-03-05,부산,서울,156,18,18,104,68,5,369,168,13,23,70,55,2,331
2020-03-05,부산,세종,11,1,1,1,3,1,18,8,1,0,0,0,1,10
2020-03-05,부산,울산,13295,357,477,641,2754,954,18478,13153,395,447,410,2533,1005,17943
2020-03-05,부산,전남,1558,81,136,200,563,57,2595,1388,68,114,152,596,56,2374
2020-03-05,부산,전북,196,6,14,32,102,7,357,178,8,23,36,70,4,319
2020-03-05,부산,충남,108,14,24,65,195,5,411,107,14,23,80,198,2,424
2020-03-05,부산,충북,93,13,21,98,195,1,421,73,20,20,117,187,5,422
2020-03-05,서울,강원,643,14,126,13,11,27,834,606,9,160,13,13,24,825
2020-03-05,서울,경기,139914,6981,9162,4970,3518,9527,174072,138587,7303,8839,5407,3839,9403,173378
2020-03-05,서울,경남,1996,44,338,201,126,58,2763,1441,44,327,281,145,44,2282
2020-03-05,서울,경북,1558,78,250,245,117,47,2295,1514,96,243,426,154,58,2491
2020-03-05,서울,광주,604,20,26,54,19,15,738,502,21,29,88,13,18,671
2020-03-05,서울,대구,793,57,73,121,50,16,1110,1461,62,100,226,106,47,2002
2020-03-05,서울,대전,1489,56,140,41,7,48,1781,1456,51,147,35,7,66,1762
2020-03-05,서울,부산,168,13,23,70,55,2,331,156,18,18,104,68,5,369
2020-03-05,서울,서울,172,8,16,4,1,9,210,172,8,16,4,1,9,210
2020-03-05,서울,세종,24,0,0,1,0,2,27,42,1,1,2,0,2,48
2020-03-05,서울,울산,23,0,2,0,2,1,28,23,2,8,9,12,0,54
2020-03-05,서울,전남,714,12,22,40,23,26,837,633,13,23,77,33,18,797
2020-03-05,서울,전북,965,24,42,21,18,46,1116,926,24,40,53,37,35,1115
2020-03-05,서울,충남,21489,535,1985,816,727,878,26430,21727,671,1971,1366,1188,845,27768
2020-03-05,서울,충북,11189,525,989,778,700,470,14651,11178,677,1027,846,817,505,15050
2020-03-05,세종,강원,7,0,1,0,2,0,10,2,0,1,0,1,0,4
2020-03-05,세종,경기,33,7,3,4,3,1,51,27,1,2,5,5,2,42
2020-03-05,세종,경남,187,2,14,16,16,4,239,155,2,11,12,5,6,191
2020-03-05,세종,경북,153,5,11,15,4,3,191,176,6,19,21,18,6,246
2020-03-05,세종,광주,137,6,6,6,1,3,159,101,2,9,3,3,3,121
2020-03-05,세종,대구,68,2,4,4,4,2,84,123,3,7,7,7,5,152
2020-03-05,세종,대전,3071,107,72,38,40,233,3561,3049,97,75,33,44,237,3535
2020-03-05,세종,부산,8,1,0,0,0,1,10,11,1,1,1,3,1,18
2020-03-05,세종,서울,42,1,1,2,0,2,48,24,0,0,1,0,2,27
2020-03-05,세종,세종,210,21,6,2,1,12,252,210,21,6,2,1,12,252
2020-03-05,세종,울산,9,0,1,1,4,2,17,4,0,0,1,2,1,8
2020-03-05,세종,전남,142,2,6,9,13,5,177,84,0,3,2,9,2,100
2020-03-05,세종,전북,545,15,28,13,36,19,656,555,15,18,11,36,17,652
2020-03-05,세종,충남,5019,150,157,103,167,275,5871,3694,135,151,134,140,210,4464
2020-03-05,세종,충북,331,14,22,19,13,28,427,261,12,24,11,18,21,347
2020-03-05,울산,강원,0,0,0,0,0,0,0,0,0,0,0,0,0,0
2020-03-05,울산,경기,37,1,9,45,75,1,168,20,0,1,13,18,0,52
2020-03-05,울산,경남,7643,565,676,455,677,462,10478,7954,605,640,477,696,520,10892
2020-03-05,울산,경북,3603,166,291,310,1232,219,5821,3428,174,306,394,999,225,5526
2020-03-05,울산,광주,37,1,7,6,10,0,61,41,3,9,6,1,0,60
2020-03-05,울산,대구,639,50,79,66,172,32,1038,674,48,65,70,154,34,1045
2020-03-05,울산,대전,82,1,14,14,26,2,139,63,3,12,18,21,2,119
2020-03-05,울산,부산,13153,395,447,410,2533,1005,17943,13295,357,477,641,2754,954,18478
2020-03-05,울산,서울,23,2,8,9,12,0,54,23,0,2,0,2,1,28
2020-03-05,울산,세종,4,0,0,1,2,1,8,9,0,1,1,4,2,17
2020-03-05,울산,울산,7292,283,484,285,694,612,9650,7292,283,484,285,694,612,9650
2020-03-05,울산,전남,141,12,22,21,30,6,232,145,18,19,8,51,6,247
2020-03-05,울산,전북,29,2,4,4,12,1,52,15,0,7,4,4,1,31
2020-03-05,울산,충남,89,5,17,53,131,1,296,99,1,12,29,108,2,251
2020-03-05,울산,충북,6,0,5,22,40,0,73,15,0,3,17,35,0,70
2020-03-05,전남,강원,12,2,0,5,4,0,23,20,1,1,1,17,0,40
2020-03-05,전남,경기,559,21,71,112,91,16,870,625,19,106,149,172,23,1094
2020-03-05,전남,경남,4807,301,436,432,1378,217,7571,4789,269,412,488,1414,175,7547
2020-03-05,전남,경북,519,39,59,64,269,13,963,687,38,82,126,467,20,1420
2020-03-05,전남,광주,28225,966,959,684,1815,1061,33710,29517,981,1094,806,1813,1114,35325
2020-03-05,전남,대구,295,15,29,17,54,6,416,321,13,36,34,37,9,450
2020-03-05,전남,대전,87,4,5,3,5,3,107,216,10,4,28,36,6,300
2020-03-05,전남,부산,1388,68,114,152,596,56,2374,1558,81,136,200,563,57,2595
2020-03-05,전남,서울,633,13,23,77,33,18,797,714,12,22,40,23,26,837
2020-03-05,전남,세종,84,0,3,2,9,2,100,142,2,6,9,13,5,177
2020-03-05,전남,울산,145,18,19,8,51,6,247,141,12,22,21,30,6,232
2020-03-05,전남,전남,38189,1286,1539,1521,4945,1594,49074,38189,1286,1539,1521,4945,1594,49074
2020-03-05,전남,전북,5637,354,696,879,2805,162,10533,3646,206,420,538,1361,110,6281
2020-03-05,전남,충남,1471,58,198,464,294,35,2520,3501,78,390,530,993,103,5595
2020-03-05,전남,충북,113,16,20,42,69,8,268,271,31,48,104,238,12,704
2020-03-05,전북,강원,110,7,17,21,37,5,197,78,5,14,17,19,3,136
2020-03-05,전북,경기,1061,58,157,219,258,36,1789,989,53,166,143,194,34,1579
2020-03-05,전북,경남,826,53,110,102,175,27,1293,789,44,118,108,190,27,1276
2020-03-05,전북,경북,1284,105,170,172,491,35,2257,1446,83,178,184,241,32,2164
2020-03-05,전북,광주,6565,462,506,347,425,237,8542,6391,430,563,362,372,246,8364
2020-03-05,전북,대구,146,7,22,14,29,4,222,162,16,18,12,25,3,236
2020-03-05,전북,대전,2570,99,84,88,60,133,3034,2494,87,88,91,58,129,2947
2020-03-05,전북,부산,178,8,23,36,70,4,319,196,6,14,32,102,7,357
2020-03-05,전북,서울,926,24,40,53,37,35,1115,965,24,42,21,18,46,1116
2020-03-05,전북,세종,555,15,18,11,36,17,652,545,15,28,13,36,19,656
2020-03-05,전북,울산,15,0,7,4,4,1,31,29,2,4,4,12,1,52
2020-03-05,전북,전남,3646,206,420,538,1361,110,6281,5637,354,696,879,2805,162,10533
2020-03-05,전북,전북,14830,656,966,685,1320,566,19023,14830,656,966,685,1320,566,19023
2020-03-05,전북,충남,12439,605,1603,1457,2341,451,18896,10518,494,1397,995,1411,381,15196
2020-03-05,전북,충북,1567,142,207,342,488,42,2788,1322,125,207,256,289,31,2230
2020-03-05,충남,강원,258,12,18,39,73,12,412,184,9,15,22,38,9,277
2020-03-05,충남,경기,30304,1511,2667,2498,4241,1558,42779,31125,1602,2862,2535,4499,1573,44196
2020-03-05,충남,경남,1108,64,165,380,516,52,2285,766,53,112,237,214,16,1398
2020-03-05,충남,경북,2150,110,337,516,744,75,3932,1992,128,309,618,612,67,3726
2020-03-05,충남,광주,3318,140,473,609,378,86,5004,3180,113,448,496,261,79,4577
2020-03-05,충남,대구,546,63,95,164,192,14,1074,788,66,131,214,220,25,1444
2020-03-05,충남,대전,12763,456,479,251,226,925,15100,14028,475,495,253,260,1040,16551
2020-03-05,충남,부산,107,14,23,80,198,2,424,108,14,24,65,195,5,411
2020-03-05,충남,서울,21727,671,1971,1366,1188,845,27768,21489,535,1985,816,727,878,26430
2020-03-05,충남,세종,3694,135,151,134,140,210,4464,5019,150,157,103,167,275,5871
2020-03-05,충남,울산,99,1,12,29,108,2,251,89,5,17,53,131,1,296
2020-03-05,충남,전남,3501,78,390,530,993,103,5595,1471,58,198,464,294,35,2520
2020-03-05,충남,전북,10518,494,1397,995,1411,381,15196,12439,605,1603,1457,2341,451,18896
2020-03-05,충남,충남,80788,3677,7488,7768,10546,3979,114246,80788,3677,7488,7768,10546,3979,114246
2020-03-05,충남,충북,11553,687,923,994,1496,628,16281,10537,631,908,859,1629,582,15146
2020-03-05,충북,강원,3595,195,236,218,327,229,4800,3487,241,275,243,416,228,4890
2020-03-05,충북,경기,22109,2101,2859,2852,3593,1075,34589,22544,2220,2953,3291,3397,1167,35572
2020-03-05,충북,경남,936,78,199,492,661,33,2399,716,61,139,299,296,26,1537
2020-03-05,충북,경북,3136,245,489,680,1037,132,5719,3297,205,480,712,997,127,5818
2020-03-05,충북,광주,497,39,102,189,122,11,960,413,36,60,115,67,14,705
2020-03-05,충북,대구,579,61,111,217,138,17,1123,901,86,152,266,389,27,1821
2020-03-05,충북,대전,8822,385,399,189,169,675,10639,9933,459,428,216,186,730,11952
2020-03-05,충북,부산,73,20,20,117,187,5,422,93,13,21,98,195,1,421
2020-03-05,충북,서울,11178,677,1027,846,817,505,15050,11189,525,989,778,700,470,14651
2020-03-05,충북,세종,261,12,24,11,18,21,347,331,14,22,19,13,28,427
2020-03-05,충북,울산,15,0,3,17,35,0,70,6,0,5,22,40,0,73
2020-03-05,충북,전남,271,31,48,104,238,12,704,113,16,20,42,69,8,268
2020-03-05,충북,전북,1322,125,207,256,289,31,2230,1567,142,207,342,488,42,2788
2020-03-05,충북,충남,10537,631,908,859,1629,582,15146,11553,687,923,994,1496,628,16281
2020-03-05,충북,충북,30718,1924,2269,2180,3308,1884,42283,30718,1924,2269,2180,3308,1884,42283
2020-03-06,강원,강원,63243,2244,2529,1388,2445,4168,76017,63243,2244,2529,1388,2445,4168,76017
2020-03-06,강원,경기,19176,577,981,653,748,930,23065,25867,630,982,708,863,1110,30160
2020-03-06,강원,경남,136,7,11,13,18,5,190,97,3,5,14,12,2,133
2020-03-06,강원,경북,263,24,24,17,25,18,371,326,13,17,28,32,18,434
2020-03-06,강원,광주,89,3,12,5,11,3,123,75,1,10,3,6,5,100
2020-03-06,강원,대구,135,5,5,13,9,4,171,226,6,7,13,13,6,271
2020-03-06,강원,대전,129,2,24,5,1,6,167,150,3,23,4,2,6,188
2020-03-06,강원,부산,2,0,0,1,2,0,5,2,0,0,1,3,0,6
2020-03-06,강원,서울,611,14,200,11,21,26,883,910,10,164,12,12,22,1130
2020-03-06,강원,세종,4,0,0,0,0,0,4,6,1,0,0,0,0,7
2020-03-06,강원,울산,2,0,0,0,0,0,2,0,0,0,0,0,0,0
2020-03-06,강원,전남,35,0,2,5,6,1,49,23,2,1,8,4,1,39
2020-03-06,강원,전북,108,6,6,9,13,1,143,157,8,11,28,31,4,239
2020-03-06,강원,충남,281,3,16,26,32,12,370,468,9,24,46,74,31,652
2020-03-06,강원,충북,4191,232,231,263,373,235,5525,4575,197,221,211,330,252,5786
2020-03-06,경기,강원,25867,630,982,708,863,1110,30160,19176,577,981,653,748,930,23065
2020-03-06,경기,경기,427865,23645,25152,19934,24852,31237,552685,427865,23645,25152,19934,24852,31237,552685
2020-03-06,경기,경남,2801,86,315,709,589,99,4599,2161,68,266,589,387,77,3548
2020-03-06,경기,경북,2857,163,461,748,605,111,4945,3419,185,432,922,606,105,5669
2020-03-06,경기,광주,1062,32,157,325,151,34,1761,686,29,113,253,115,20,1216
2020-03-06,경기,대구,1169,75,151,347,192,43,1977,1910,95,165,437,422,64,3093
2020-03-06,경기,대전,2339,99,206,117,50,107,2918,1889,109,179,105,46,82,2410
2020-03-06,경기,부산,236,20,56,212,162,4,690,247,17,44,159,265,10,742
2020-03-06,경기,서울,148946,7256,8985,5242,3783,10060,184272,142174,6909,9148,4965,3480,9701,176377
2020-03-06,경기,세종,39,5,2,2,2,1,51,53,5,3,5,2,5,73
2020-03-06,경기,울산,28,3,4,11,12,0,58,38,1,7,34,72,1,153
2020-03-06,경기,전남,929,22,92,166,188,29,1426,665,17,72,103,80,21,958
2020-03-06,경기,전북,1718,41,175,113,197,62,2306,1408,50,157,199,258,63,2135
2020-03-06,경기,충남,38909,1528,2888,2556,4646,2023,52550,38491,1500,2691,2497,4381,1950,51510
2020-03-06,경기,충북,28242,2300,3069,3293,3530,1438,41872,27669,2220,2874,2913,3696,1365,40737
2020-03-06,경남,강원,97,3,5,14,12,2,133,136,7,11,13,18,5,190
2020-03-06,경남,경기,2161,68,266,589,387,77,3548,2801,86,315,709,589,99,4599
2020-03-06,경남,경남,187003,9693,9593,7867,14510,13927,242593,187003,9693,9593,7867,14510,13927,242593
2020-03-06,경남,경북,8206,616,910,904,1793,385,12814,11166,863,1132,1307,2548,511,17527
2020-03-06,경남,광주,1212,51,135,162,126,35,1721,996,46,133,146,103,27,1451
2020-03-06,경남,대구,9570,715,827,1046,1525,394,14077,7546,478,559,416,498,329,9826
2020-03-06,경남,대전,882,15,90,66,42,33,1128,982,20,87,122,49,40,1300
2020-03-06,경남,부산,83871,2628,2623,1851,4791,5852,101616,81609,2774,2769,1861,4980,5753,99746
2020-03-06,경남,서울,1976,38,381,297,130,57,2879,2506,55,383,201,121,77,3343
2020-03-06,경남,세종,233,1,10,8,14,8,274,302,5,16,12,12,15,362
2020-03-06,경남,울산,9171,654,663,497,714,578,12277,8848,581,681,461,683,550,11804
2020-03-06,경남,전남,5694,253,416,490,1363,253,8469,6080,300,439,404,1331,289,8843
2020-03-06,경남,전북,1136,38,109,107,153,41,1584,1070,45,128,94,161,36,1534
2020-03-06,경남,충남,1051,51,122,263,206,45,1738,1907,66,161,346,612,72,3164
2020-03-06,경남,충북,1052,63,118,301,299,23,1856,1486,70,204,455,713,54,2982
2020-03-06,경북,강원,326,13,17,28,32,18,434,263,24,24,17,25,18,371
2020-03-06,경북,경기,3419,185,432,922,606,105,5669,2857,163,461,748,605,111,4945
2020-03-06,경북,경남,11166,863,1132,1307,2548,511,17527,8206,616,910,904,1793,385,12814
2020-03-06,경북,경북,60939,3766,3848,2945,5331,3187,80016,60939,3766,3848,2945,5331,3187,80016
2020-03-06,경북,광주,833,46,113,183,151,24,1350,535,43,107,145,94,15,939
2020-03-06,경북,대구,58171,2792,2286,1604,3271,2953,71077,59799,2930,2631,1896,3811,3009,74076
2020-03-06,경북,대전,1652,57,92,105,107,78,2091,1388,49,97,121,77,81,1813
2020-03-06,경북,부산,3992,109,204,183,695,194,5377,3670,118,210,211,857,203,5269
2020-03-06,경북,서울,2251,90,288,381,163,87,3260,2061,71,265,253,119,75,2844
2020-03-06,경북,세종,278,7,21,21,15,8,350,244,5,9,17,21,7,303
2020-03-06,경북,울산,4340,186,317,408,1072,261,6584,4342,163,353,342,1286,237,6723
2020-03-06,경북,전남,974,48,79,107,448,19,1675,707,33,65,74,330,17,1226
2020-03-06,경북,전북,1589,97,199,199,277,65,2426,1573,101,186,187,479,44,2570
2020-03-06,경북,충남,2571,177,370,590,605,98,4411,2905,162,399,494,806,116,4882
2020-03-06,경북,충북,4222,225,497,710,979,166,6799,3783,230,541,629,1044,141,6368
2020-03-06,광주,강원,75,1,10,3,6,5,100,89,3,12,5,11,3,123
2020-03-06,광주,경기,686,29,113,253,115,20,1216,1062,32,157,325,151,34,1761
2020-03-06,광주,경남,996,46,133,146,103,27,1451,1212,51,135,162,126,35,1721
2020-03-06,광주,경북,535,43,107,145,94,15,939,833,46,113,183,151,24,1350
2020-03-06,광주,광주,13578,506,599,417,349,535,15984,13578,506,599,417,349,535,15984
2020-03-06,광주,대구,375,25,63,72,24,12,571,431,31,71,73,32,12,650
2020-03-06,광주,대전,421,16,11,21,10,12,491,470,14,20,23,13,21,561
2020-03-06,광주,부산,332,10,28,33,77,11,491,437,22,36,68,99,14,676
2020-03-06,광주,서울,672,18,20,77,23,15,825,985,20,29,46,28,24,1132
2020-03-06,광주,세종,167,3,9,3,2,3,187,252,4,4,11,2,6,279
2020-03-06,광주,울산,38,0,6,0,4,1,49,69,3,3,4,10,1,90
2020-03-06,광주,전남,32951,990,1061,791,2036,1216,39045,33337,918,975,644,2045,1247,39166
2020-03-06,광주,전북,7216,421,541,367,373,241,9159,7943,461,481,332,377,292,9886
2020-03-06,광주,충남,4312,117,476,489,239,111,5744,5010,140,501,601,328,147,6727
2020-03-06,광주,충북,510,17,63,94,68,13,765,736,29,78,186,71,19,1119
2020-03-06,대구,강원,226,6,7,13,13,6,271,135,5,5,13,9,4,171
2020-03-06,대구,경기,1910,95,165,437,422,64,3093,1169,75,151,347,192,43,1977
2020-03-06,대구,경남,7546,478,559,416,498,329,9826,9570,715,827,1046,1525,394,14077
2020-03-06,대구,경북,59799,2930,2631,1896,3811,3009,74076,58171,2792,2286,1604,3271,2953,71077
2020-03-06,대구,광주,431,31,71,73,32,12,650,375,25,63,72,24,12,571
2020-03-06,대구,대구,50354,1998,1647,739,1117,3269,59124,50354,1998,1647,739,1117,3269,59124
2020-03-06,대구,대전,663,33,33,75,37,30,871,404,20,18,55,20,16,533
2020-03-06,대구,부산,472,49,103,64,159,16,863,2013,85,164,93,265,85,2705
2020-03-06,대구,서울,1938,62,104,207,110,57,2478,995,63,78,110,51,33,1330
2020-03-06,대구,세종,201,9,9,5,6,12,242,108,5,1,6,6,5,131
2020-03-06,대구,울산,817,46,73,78,147,38,1199,845,44,76,68,180,37,1250
2020-03-06,대구,전남,355,7,25,32,39,9,467,408,17,34,28,61,10,558
2020-03-06,대구,전북,212,9,25,8,19,10,283,201,7,32,19,24,10,293
2020-03-06,대구,충남,880,66,157,214,252,27,1596,668,43,120,158,190,25,1204
2020-03-06,대구,충북,1113,97,137,280,389,47,2063,778,82,121,224,139,26,1370
2020-03-06,대전,강원,150,3,23,4,2,6,188,129,2,24,5,1,6,167
2020-03-06,대전,경기,1889,109,179,105,46,82,2410,2339,99,206,117,50,107,2918
2020-03-06,대전,경남,982,20,87,122,49,40,1300,882,15,90,66,42,33,1128
2020-03-06,대전,경북,1388,49,97,121,77,81,1813,1652,57,92,105,107,78,2091
2020-03-06,대전,광주,470,14,20,23,13,21,561,421,16,11,21,10,12,491
2020-03-06,대전,대구,404,20,18,55,20,16,533,663,33,33,75,37,30,871
2020-03-06,대전,대전,13306,382,400,552,232,987,15859,13306,382,400,552,232,987,15859
2020-03-06,대전,부산,78,1,3,22,17,1,122,82,1,10,13,21,3,130
2020-03-06,대전,서울,1787,44,156,30,11,76,2104,1967,32,167,33,11,81,2291
2020-03-06,대전,세종,3226,94,65,26,36,248,3695,3301,95,78,23,46,243,3786
2020-03-06,대전,울산,91,2,12,14,25,2,146,146,1,13,10,22,4,196
2020-03-06,대전,전남,308,3,6,29,23,11,380,145,4,6,7,5,3,170
2020-03-06,대전,전북,3062,73,106,87,56,138,3522,3258,95,99,94,67,119,3732
2020-03-06,대전,충남,15325,456,502,281,262,1145,17971,14606,460,434,234,222,1080,17036
2020-03-06,대전,충북,10414,441,450,207,187,761,12460,9741,395,395,181,177,708,11597
2020-03-06,부산,강원,2,0,0,1,3,0,6,2,0,0,1,2,0,5
2020-03-06,부산,경기,247,17,44,159,265,10,742,236,20,56,212,162,4,690
2020-03-06,부산,경남,81609,2774,2769,1861,4980,5753,99746,83871,2628,2623,1851,4791,5852,101616
2020-03-06,부산,경북,3670,118,210,211,857,203,5269,3992,109,204,183,695,194,5377
2020-03-06,부산,광주,437,22,36,68,99,14,676,332,10,28,33,77,11,491
2020-03-06,부산,대구,2013,85,164,93,265,85,2705,472,49,103,64,159,16,863
2020-03-06,부산,대전,82,1,10,13,21,3,130,78,1,3,22,17,1,122
2020-03-06,부산,부산,41590,672,635,567,2138,3067,48669,41590,672,635,567,2138,3067,48669
2020-03-06,부산,서울,237,15,11,83,55,4,405,195,8,20,75,50,9,357
2020-03-06,부산,세종,34,0,3,3,4,4,48,26,1,1,3,1,0,32
2020-03-06,부산,울산,14421,373,472,600,2688,1035,19589,16014,388,422,426,2532,1151,20933
2020-03-06,부산,전남,1834,78,116,182,554,63,2827,1725,77,112,110,574,82,2680
2020-03-06,부산,전북,279,10,29,43,88,8,457,219,8,26,34,73,4,364
2020-03-06,부산,충남,162,11,16,59,140,3,391,158,20,36,94,185,7,500
2020-03-06,부산,충북,117,9,26,100,208,8,468,132,8,26,113,195,4,478
2020-03-06,서울,강원,910,10,164,12,12,22,1130,611,14,200,11,21,26,883
2020-03-06,서울,경기,142174,6909,9148,4965,3480,9701,176377,148946,7256,8985,5242,3783,10060,184272
2020-03-06,서울,경남,2506,55,383,201,121,77,3343,1976,38,381,297,130,57,2879
2020-03-06,서울,경북,2061,71,265,253,119,75,2844,2251,90,288,381,163,87,3260
2020-03-06,서울,광주,985,20,29,46,28,24,1132,672,18,20,77,23,15,825
2020-03-06,서울,대구,995,63,78,110,51,33,1330,1938,62,104,207,110,57,2478
2020-03-06,서울,대전,1967,32,167,33,11,81,2291,1787,44,156,30,11,76,2104
2020-03-06,서울,부산,195,8,20,75,50,9,357,237,15,11,83,55,4,405
2020-03-06,서울,서울,223,6,7,3,6,15,260,223,6,7,3,6,15,260
2020-03-06,서울,세종,24,1,1,2,0,2,30,38,0,1,3,0,3,45
2020-03-06,서울,울산,27,0,2,3,2,0,34,28,0,3,6,11,0,48
2020-03-06,서울,전남,977,9,16,31,22,24,1079,702,8,22,47,30,27,836
2020-03-06,서울,전북,1585,18,32,32,17,58,1742,1341,24,36,33,36,42,1512
2020-03-06,서울,충남,27779,543,2040,828,707,1107,33004,28085,614,2102,1245,1211,1167,34424
2020-03-06,서울,충북,13856,518,1001,775,666,592,17408,14630,649,1038,834,874,591,18616
2020-03-06,세종,강원,6,1,0,0,0,0,7,4,0,0,0,0,0,4
2020-03-06,세종,경기,53,5,3,5,2,5,73,39,5,2,2,2,1,51
2020-03-06,세종,경남,302,5,16,12,12,15,362,233,1,10,8,14,8,274
2020-03-06,세종,경북,244,5,9,17,21,7,303,278,7,21,21,15,8,350
2020-03-06,세종,광주,252,4,4,11,2,6,279,167,3,9,3,2,3,187
2020-03-06,세종,대구,108,5,1,6,6,5,131,201,9,9,5,6,12,242
2020-03-06,세종,대전,3301,95,78,23,46,243,3786,3226,94,65,26,36,248,3695
2020-03-06,세종,부산,26,1,1,3,1,0,32,34,0,3,3,4,4,48
2020-03-06,세종,서울,38,0,1,3,0,3,45,24,1,1,2,0,2,30
2020-03-06,세종,세종,225,29,4,1,1,15,275,225,29,4,1,1,15,275
2020-03-06,세종,울산,10,0,0,0,2,0,12,18,0,0,3,8,0,29
2020-03-06,세종,전남,229,2,9,6,19,3,268,137,2,3,9,9,5,165
2020-03-06,세종,전북,822,19,27,14,46,31,959,802,13,24,25,56,29,949
2020-03-06,세종,충남,5783,146,165,118,158,319,6689,4873,138,155,143,154,238,5701
2020-03-06,세종,충북,336,12,16,19,15,24,422,312,16,28,12,13,23,404
2020-03-06,울산,강원,0,0,0,0,0,0,0,2,0,0,0,0,0,2
2020-03-06,울산,경기,38,1,7,34,72,1,153,28,3,4,11,12,0,58
2020-03-06,울산,경남,8848,581,681,461,683,550,11804,9171,654,663,497,714,578,12277
2020-03-06,울산,경북,4342,163,353,342,1286,237,6723,4340,186,317,408,1072,261,6584
2020-03-06,울산,광주,69,3,3,4,10,1,90,38,0,6,0,4,1,49
2020-03-06,울산,대구,845,44,76,68,180,37,1250,817,46,73,78,147,38,1199
2020-03-06,울산,대전,146,1,13,10,22,4,196,91,2,12,14,25,2,146
2020-03-06,울산,부산,16014,388,422,426,2532,1151,20933,14421,373,472,600,2688,1035,19589
2020-03-06,울산,서울,28,0,3,6,11,0,48,27,0,2,3,2,0,34
2020-03-06,울산,세종,18,0,0,3,8,0,29,10,0,0,0,2,0,12
2020-03-06,울산,울산,7480,335,507,275,567,684,9848,7480,335,507,275,567,684,9848
2020-03-06,울산,전남,163,10,29,11,21,4,238,226,17,24,8,49,7,331
2020-03-06,울산,전북,50,1,10,2,12,1,76,41,1,7,3,3,1,56
2020-03-06,울산,충남,101,4,11,50,114,5,285,139,5,9,39,121,4,317
2020-03-06,울산,충북,15,3,4,14,49,0,85,13,2,1,13,38,0,67
2020-03-06,전남,강원,23,2,1,8,4,1,39,35,0,2,5,6,1,49
2020-03-06,전남,경기,665,17,72,103,80,21,958,929,22,92,166,188,29,1426
2020-03-06,전남,경남,6080,300,439,404,1331,289,8843,5694,253,416,490,1363,253,8469
2020-03-06,전남,경북,707,33,65,74,330,17,1226,974,48,79,107,448,19,1675
2020-03-06,전남,광주,33337,918,975,644,2045,1247,39166,32951,990,1061,791,2036,1216,39045
2020-03-06,전남,대구,408,17,34,28,61,10,558,355,7,25,32,39,9,467
2020-03-06,전남,대전,145,4,6,7,5,3,170,308,3,6,29,23,11,380
2020-03-06,전남,부산,1725,77,112,110,574,82,2680,1834,78,116,182,554,63,2827
2020-03-06,전남,서울,702,8,22,47,30,27,836,977,9,16,31,22,24,1079
2020-03-06,전남,세종,137,2,3,9,9,5,165,229,2,9,6,19,3,268
2020-03-06,전남,울산,226,17,24,8,49,7,331,163,10,29,11,21,4,238
2020-03-06,전남,전남,45589,1375,1561,1695,4977,1732,56929,45589,1375,1561,1695,4977,1732,56929
2020-03-06,전남,전북,7917,289,648,770,2566,235,12425,4893,215,440,531,1323,159,7561
2020-03-06,전남,충남,1961,56,208,387,271,66,2949,5299,90,391,517,1033,125,7455
2020-03-06,전남,충북,176,12,26,37,68,6,325,439,20,30,100,242,13,844
2020-03-06,전북,강원,157,8,11,28,31,4,239,108,6,6,9,13,1,143
2020-03-06,전북,경기,1408,50,157,199,258,63,2135,1718,41,175,113,197,62,2306
2020-03-06,전북,경남,1070,45,128,94,161,36,1534,1136,38,109,107,153,41,1584
2020-03-06,전북,경북,1573,101,186,187,479,44,2570,1589,97,199,199,277,65,2426
2020-03-06,전북,광주,7943,461,481,332,377,292,9886,7216,421,541,367,373,241,9159
2020-03-06,전북,대구,201,7,32,19,24,10,293,212,9,25,8,19,10,283
2020-03-06,전북,대전,3258,95,99,94,67,119,3732,3062,73,106,87,56,138,3522
2020-03-06,전북,부산,219,8,26,34,73,4,364,279,10,29,43,88,8,457
2020-03-06,전북,서울,1341,24,36,33,36,42,1512,1585,18,32,32,17,58,1742
2020-03-06,전북,세종,802,13,24,25,56,29,949,822,19,27,14,46,31,959
2020-03-06,전북,울산,41,1,7,3,3,1,56,50,1,10,2,12,1,76
2020-03-06,전북,전남,4893,215,440,531,1323,159,7561,7917,289,648,770,2566,235,12425
2020-03-06,전북,전북,16381,734,972,676,1191,646,20600,16381,734,972,676,1191,646,20600
2020-03-06,전북,충남,16252,570,1602,1387,2201,572,22584,15488,521,1390,954,1394,517,20264
2020-03-06,전북,충북,1923,125,199,331,428,77,3083,1840,126,203,262,278,66,2775
2020-03-06,충남,강원,468,9,24,46,74,31,652,281,3,16,26,32,12,370
2020-03-06,충남,경기,38491,1500,2691,2497,4381,1950,51510,38909,1528,2888,2556,4646,2023,52550
2020-03-06,충남,경남,1907,66,161,346,612,72,3164,1051,51,122,263,206,45,1738
2020-03-06,충남,경북,2905,162,399,494,806,116,4882,2571,177,370,590,605,98,4411
2020-03-06,충남,광주,5010,140,501,601,328,147,6727,4312,117,476,489,239,111,5744
2020-03-06,충남,대구,668,43,120,158,190,25,1204,880,66,157,214,252,27,1596
2020-03-06,충남,대전,14606,460,434,234,222,1080,17036,15325,456,502,281,262,1145,17971
2020-03-06,충남,부산,158,20,36,94,185,7,500,162,11,16,59,140,3,391
2020-03-06,충남,서울,28085,614,2102,1245,1211,1167,34424,27779,543,2040,828,707,1107,33004
2020-03-06,충남,세종,4873,138,155,143,154,238,5701,5783,146,165,118,158,319,6689
2020-03-06,충남,울산,139,5,9,39,121,4,317,101,4,11,50,114,5,285
2020-03-06,충남,전남,5299,90,391,517,1033,125,7455,1961,56,208,387,271,66,2949
2020-03-06,충남,전북,15488,521,1390,954,1394,517,20264,16252,570,1602,1387,2201,572,22584
2020-03-06,충남,충남,99303,3601,7680,7140,10436,4673,132833,99303,3601,7680,7140,10436,4673,132833
2020-03-06,충남,충북,13112,662,911,1065,1463,697,17910,11456,670,879,912,1463,646,16026
2020-03-06,충북,강원,4575,197,221,211,330,252,5786,4191,232,231,263,373,235,5525
2020-03-06,충북,경기,27669,2220,2874,2913,3696,1365,40737,28242,2300,3069,3293,3530,1438,41872
2020-03-06,충북,경남,1486,70,204,455,713,54,2982,1052,63,118,301,299,23,1856
2020-03-06,충북,경북,3783,230,541,629,1044,141,6368,4222,225,497,710,979,166,6799
2020-03-06,충북,광주,736,29,78,186,71,19,1119,510,17,63,94,68,13,765
2020-03-06,충북,대구,778,82,121,224,139,26,1370,1113,97,137,280,389,47,2063
2020-03-06,충북,대전,9741,395,395,181,177,708,11597,10414,441,450,207,187,761,12460
2020-03-06,충북,부산,132,8,26,113,195,4,478,117,9,26,100,208,8,468
2020-03-06,충북,서울,14630,649,1038,834,874,591,18616,13856,518,1001,775,666,592,17408
2020-03-06,충북,세종,312,16,28,12,13,23,404,336,12,16,19,15,24,422
2020-03-06,충북,울산,13,2,1,13,38,0,67,15,3,4,14,49,0,85
2020-03-06,충북,전남,439,20,30,100,242,13,844,176,12,26,37,68,6,325
2020-03-06,충북,전북,1840,126,203,262,278,66,2775,1923,125,199,331,428,77,3083
2020-03-06,충북,충남,11456,670,879,912,1463,646,16026,13112,662,911,1065,1463,697,17910
2020-03-06,충북,충북,34569,1989,2239,2307,3277,2035,46416,34569,1989,2239,2307,3277,2035,46416
2020-03-07,강원,강원,74813,1449,1862,768,2243,3717,84852,74813,1449,1862,768,2243,3717,84852
2020-03-07,강원,경기,27754,306,691,362,389,1091,30593,37467,359,673,413,559,1472,40943
2020-03-07,강원,경남,114,1,7,4,7,1,134,90,0,2,6,5,6,109
2020-03-07,강원,경북,276,10,6,10,16,13,331,346,11,6,13,16,13,405
2020-03-07,강원,광주,61,1,14,7,8,1,92,66,1,12,8,3,1,91
2020-03-07,강원,대구,108,3,5,2,2,2,122,232,4,4,9,2,3,254
2020-03-07,강원,대전,117,8,19,1,0,7,152,186,2,21,6,1,9,225
2020-03-07,강원,부산,3,0,0,2,1,0,6,6,0,0,0,1,0,7
2020-03-07,강원,서울,789,7,170,10,15,25,1016,1473,3,160,12,4,52,1704
2020-03-07,강원,세종,7,0,0,0,1,1,9,4,0,0,0,1,0,5
2020-03-07,강원,울산,0,0,0,0,0,0,0,2,0,0,0,0,0,2
2020-03-07,강원,전남,26,0,3,1,3,1,34,11,2,1,3,0,2,19
2020-03-07,강원,전북,114,2,7,6,8,4,141,153,6,6,10,18,4,197
2020-03-07,강원,충남,261,4,13,11,19,20,328,501,10,13,35,34,22,615
2020-03-07,강원,충북,3883,156,146,133,232,202,4752,4426,141,142,120,235,223,5287
2020-03-07,경기,강원,37467,359,673,413,559,1472,40943,27754,306,691,362,389,1091,30593
2020-03-07,경기,경기,335679,10512,12028,8739,12201,20885,400044,335679,10512,12028,8739,12201,20885,400044
2020-03-07,경기,경남,2174,44,234,450,327,90,3319,1435,27,166,251,191,50,2120
2020-03-07,경기,경북,2636,69,237,388,335,109,3774,2377,57,189,421,311,107,3462
2020-03-07,경기,광주,861,9,103,153,79,24,1229,616,11,66,127,46,15,881
2020-03-07,경기,대구,901,35,101,228,128,35,1428,1461,49,79,229,161,56,2035
2020-03-07,경기,대전,2483,49,170,74,35,137,2948,1887,48,155,48,22,120,2280
2020-03-07,경기,부산,241,4,30,138,76,10,499,189,5,17,89,119,7,426
2020-03-07,경기,서울,120356,4009,4890,2870,2596,6905,141626,118225,3568,5003,2113,2403,6848,138160
2020-03-07,경기,세종,40,1,4,3,1,1,50,35,1,2,3,1,3,45
2020-03-07,경기,울산,23,1,3,8,5,0,40,33,1,3,11,47,1,96
2020-03-07,경기,전남,972,10,61,96,115,22,1276,622,9,45,60,37,22,795
2020-03-07,경기,전북,1773,27,122,68,106,68,2164,1422,24,88,83,101,53,1771
2020-03-07,경기,충남,39360,754,1606,1084,2099,1873,46776,35450,671,1566,1061,2081,1746,42575
2020-03-07,경기,충북,26162,983,1380,1438,1782,1275,33020,24186,894,1281,1355,1946,1135,30797
2020-03-07,경남,강원,90,0,2,6,5,6,109,114,1,7,4,7,1,134
2020-03-07,경남,경기,1435,27,166,251,191,50,2120,2174,44,234,450,327,90,3319
2020-03-07,경남,경남,145391,5231,4925,3445,8009,9839,176840,145391,5231,4925,3445,8009,9839,176840
2020-03-07,경남,경북,7608,251,475,373,874,351,9932,9801,354,568,571,1224,430,12948
2020-03-07,경남,광주,978,13,75,89,55,29,1239,924,19,72,64,38,34,1151
2020-03-07,경남,대구,8454,319,467,426,599,394,10659,7267,221,318,206,196,312,8520
2020-03-07,경남,대전,724,13,65,24,18,22,866,980,12,74,78,34,41,1219
2020-03-07,경남,부산,70222,1374,1575,1028,2267,4482,80948,68876,1349,1566,940,2299,4443,79473
2020-03-07,경남,서울,1679,16,290,112,58,50,2205,2309,27,353,139,80,87,2995
2020-03-07,경남,세종,161,1,5,5,9,7,188,261,4,12,6,7,7,297
2020-03-07,경남,울산,8040,331,356,239,354,508,9828,8120,303,410,226,278,464,9801
2020-03-07,경남,전남,5239,130,207,222,650,228,6676,5218,150,238,176,731,228,6741
2020-03-07,경남,전북,1160,26,87,53,151,48,1525,983,27,83,42,144,31,1310
2020-03-07,경남,충남,827,10,55,93,90,36,1111,1328,20,61,185,239,55,1888
2020-03-07,경남,충북,877,12,55,129,166,41,1280,1151,20,96,263,445,41,2016
2020-03-07,경북,강원,346,11,6,13,16,13,405,276,10,6,10,16,13,331
2020-03-07,경북,경기,2377,57,189,421,311,107,3462,2636,69,237,388,335,109,3774
2020-03-07,경북,경남,9801,354,568,571,1224,430,12948,7608,251,475,373,874,351,9932
2020-03-07,경북,경북,54077,2114,2164,1547,3495,2538,65935,54077,2114,2164,1547,3495,2538,65935
2020-03-07,경북,광주,532,20,57,86,71,15,781,475,19,36,62,51,16,659
2020-03-07,경북,대구,45366,1608,1356,864,2108,2104,53406,49351,1620,1446,995,2195,2199,57806
2020-03-07,경북,대전,1565,28,61,56,40,75,1825,1514,25,57,89,37,80,1802
2020-03-07,경북,부산,3938,62,139,96,246,183,4664,4246,68,162,94,289,204,5063
2020-03-07,경북,서울,1793,32,184,158,84,58,2309,2089,39,223,125,89,72,2637
2020-03-07,경북,세종,196,1,10,9,16,13,245,253,1,5,6,7,6,278
2020-03-07,경북,울산,4098,58,163,232,656,217,5424,4177,64,159,161,781,217,5559
2020-03-07,경북,전남,993,18,53,40,247,20,1371,704,19,50,27,155,21,976
2020-03-07,경북,전북,1496,41,96,92,140,50,1915,1362,50,80,84,243,43,1862
2020-03-07,경북,충남,2355,65,120,250,263,86,3139,2676,60,164,298,352,89,3639
2020-03-07,경북,충북,3740,98,239,326,558,152,5113,3742,137,276,350,645,119,5269
2020-03-07,광주,강원,66,1,12,8,3,1,91,61,1,14,7,8,1,92
2020-03-07,광주,경기,616,11,66,127,46,15,881,861,9,103,153,79,24,1229
2020-03-07,광주,경남,924,19,72,64,38,34,1151,978,13,75,89,55,29,1239
2020-03-07,광주,경북,475,19,36,62,51,16,659,532,20,57,86,71,15,781
2020-03-07,광주,광주,10218,318,431,175,186,378,11706,10218,318,431,175,186,378,11706
2020-03-07,광주,대구,303,12,38,42,10,5,410,358,11,45,33,5,7,459
2020-03-07,광주,대전,438,13,3,12,7,17,490,497,2,5,15,9,11,539
2020-03-07,광주,부산,361,4,40,18,38,10,471,416,4,42,28,35,13,538
2020-03-07,광주,서울,558,11,14,40,13,14,650,851,13,13,30,6,16,929
2020-03-07,광주,세종,140,2,4,2,0,3,151,207,4,1,3,0,5,220
2020-03-07,광주,울산,34,0,5,2,2,0,43,37,2,6,3,1,1,50
2020-03-07,광주,전남,31246,568,758,386,911,1068,34937,29366,595,697,356,974,962,32950
2020-03-07,광주,전북,7148,231,269,168,180,232,8228,7146,278,270,181,258,233,8366
2020-03-07,광주,충남,3948,46,378,200,138,113,4823,4471,69,407,319,204,129,5599
2020-03-07,광주,충북,447,14,30,48,20,11,570,597,14,43,76,51,21,802
2020-03-07,대구,강원,232,4,4,9,2,3,254,108,3,5,2,2,2,122
2020-03-07,대구,경기,1461,49,79,229,161,56,2035,901,35,101,228,128,35,1428
2020-03-07,대구,경남,7267,221,318,206,196,312,8520,8454,319,467,426,599,394,10659
2020-03-07,대구,경북,49351,1620,1446,995,2195,2199,57806,45366,1608,1356,864,2108,2104,53406
2020-03-07,대구,광주,358,11,45,33,5,7,459,303,12,38,42,10,5,410
2020-03-07,대구,대구,34673,1103,884,486,782,2120,40048,34673,1103,884,486,782,2120,40048
2020-03-07,대구,대전,608,16,13,41,25,28,731,337,12,19,37,11,16,432
2020-03-07,대구,부산,522,27,75,28,52,22,726,2145,34,127,38,67,81,2492
2020-03-07,대구,서울,1593,26,68,112,65,56,1920,869,19,48,100,43,23,1102
2020-03-07,대구,세종,149,1,3,9,0,6,168,101,1,1,2,1,4,110
2020-03-07,대구,울산,783,23,42,36,78,36,998,756,21,42,31,100,26,976
2020-03-07,대구,전남,425,6,19,16,19,18,503,426,8,21,20,18,18,511
2020-03-07,대구,전북,203,3,15,4,16,3,244,197,5,15,7,17,7,248
2020-03-07,대구,충남,814,29,66,79,82,30,1100,554,17,44,95,100,21,831
2020-03-07,대구,충북,1041,37,59,133,183,46,1499,698,36,53,147,92,23,1049
2020-03-07,대전,강원,186,2,21,6,1,9,225,117,8,19,1,0,7,152
2020-03-07,대전,경기,1887,48,155,48,22,120,2280,2483,49,170,74,35,137,2948
2020-03-07,대전,경남,980,12,74,78,34,41,1219,724,13,65,24,18,22,866
2020-03-07,대전,경북,1514,25,57,89,37,80,1802,1565,28,61,56,40,75,1825
2020-03-07,대전,광주,497,2,5,15,9,11,539,438,13,3,12,7,17,490
2020-03-07,대전,대구,337,12,19,37,11,16,432,608,16,13,41,25,28,731
2020-03-07,대전,대전,10389,216,292,124,146,644,11811,10389,216,292,124,146,644,11811
2020-03-07,대전,부산,85,0,3,8,8,2,106,101,0,9,10,26,5,151
2020-03-07,대전,서울,1806,27,159,19,3,83,2097,2040,12,158,18,8,99,2335
2020-03-07,대전,세종,2453,75,38,18,45,147,2776,2426,72,37,18,50,137,2740
2020-03-07,대전,울산,79,0,7,12,12,6,116,96,0,7,2,11,7,123
2020-03-07,대전,전남,415,4,2,18,18,8,465,145,0,5,4,5,5,164
2020-03-07,대전,전북,3400,54,74,58,27,144,3757,3399,58,68,38,44,131,3738
2020-03-07,대전,충남,12704,277,306,141,131,761,14320,11745,260,306,121,157,761,13350
2020-03-07,대전,충북,8901,253,289,121,106,579,10249,8185,235,300,106,82,489,9397
2020-03-07,부산,강원,6,0,0,0,1,0,7,3,0,0,2,1,0,6
2020-03-07,부산,경기,189,5,17,89,119,7,426,241,4,30,138,76,10,499
2020-03-07,부산,경남,68876,1349,1566,940,2299,4443,79473,70222,1374,1575,1028,2267,4482,80948
2020-03-07,부산,경북,4246,68,162,94,289,204,5063,3938,62,139,96,246,183,4664
2020-03-07,부산,광주,416,4,42,28,35,13,538,361,4,40,18,38,10,471
2020-03-07,부산,대구,2145,34,127,38,67,81,2492,522,27,75,28,52,22,726
2020-03-07,부산,대전,101,0,9,10,26,5,151,85,0,3,8,8,2,106
2020-03-07,부산,부산,40456,335,260,433,1308,2459,45251,40456,335,260,433,1308,2459,45251
2020-03-07,부산,서울,224,6,6,26,24,4,290,217,13,20,40,24,9,323
2020-03-07,부산,세종,25,1,2,1,2,0,31,27,2,1,1,0,1,32
2020-03-07,부산,울산,13651,165,230,247,1248,898,16439,14781,178,187,174,1210,958,17488
2020-03-07,부산,전남,1821,25,75,67,244,65,2297,1611,34,76,55,209,57,2042
2020-03-07,부산,전북,278,7,22,9,44,7,367,216,7,20,15,20,8,286
2020-03-07,부산,충남,101,2,9,11,52,3,178,123,4,10,45,70,4,256
2020-03-07,부산,충북,96,1,12,37,98,1,245,100,4,15,62,94,2,277
2020-03-07,서울,강원,1473,3,160,12,4,52,1704,789,7,170,10,15,25,1016
2020-03-07,서울,경기,118225,3568,5003,2113,2403,6848,138160,120356,4009,4890,2870,2596,6905,141626
2020-03-07,서울,경남,2309,27,353,139,80,87,2995,1679,16,290,112,58,50,2205
2020-03-07,서울,경북,2089,39,223,125,89,72,2637,1793,32,184,158,84,58,2309
2020-03-07,서울,광주,851,13,13,30,6,16,929,558,11,14,40,13,14,650
2020-03-07,서울,대구,869,19,48,100,43,23,1102,1593,26,68,112,65,56,1920
2020-03-07,서울,대전,2040,12,158,18,8,99,2335,1806,27,159,19,3,83,2097
2020-03-07,서울,부산,217,13,20,40,24,9,323,224,6,6,26,24,4,290
2020-03-07,서울,서울,172,5,7,2,3,14,203,172,5,7,2,3,14,203
2020-03-07,서울,세종,31,0,1,0,1,5,38,22,0,0,0,0,1,23
2020-03-07,서울,울산,17,1,1,1,1,0,21,21,0,0,4,11,0,36
2020-03-07,서울,전남,1140,5,19,18,13,37,1232,680,6,11,21,13,28,759
2020-03-07,서울,전북,1759,13,28,9,9,55,1873,1209,12,25,20,12,44,1322
2020-03-07,서울,충남,31483,235,1720,435,415,1230,35518,29319,297,1657,556,593,1136,33558
2020-03-07,서울,충북,14389,194,734,435,338,625,16715,13553,221,727,474,422,547,15944
2020-03-07,세종,강원,4,0,0,0,1,0,5,7,0,0,0,1,1,9
2020-03-07,세종,경기,35,1,2,3,1,3,45,40,1,4,3,1,1,50
2020-03-07,세종,경남,261,4,12,6,7,7,297,161,1,5,5,9,7,188
2020-03-07,세종,경북,253,1,5,6,7,6,278,196,1,10,9,16,13,245
2020-03-07,세종,광주,207,4,1,3,0,5,220,140,2,4,2,0,3,151
2020-03-07,세종,대구,101,1,1,2,1,4,110,149,1,3,9,0,6,168
2020-03-07,세종,대전,2426,72,37,18,50,137,2740,2453,75,38,18,45,147,2776
2020-03-07,세종,부산,27,2,1,1,0,1,32,25,1,2,1,2,0,31
2020-03-07,세종,서울,22,0,0,0,0,1,23,31,0,1,0,1,5,38
2020-03-07,세종,세종,195,23,3,1,3,15,240,195,23,3,1,3,15,240
2020-03-07,세종,울산,4,0,1,0,2,0,7,11,0,0,0,0,0,11
2020-03-07,세종,전남,221,1,3,4,8,7,244,83,0,0,0,4,3,90
2020-03-07,세종,전북,989,8,15,11,24,32,1079,885,7,9,8,29,34,972
2020-03-07,세종,충남,5507,120,97,57,112,246,6139,4215,104,79,61,113,175,4747
2020-03-07,세종,충북,304,5,16,13,10,20,368,265,10,15,6,7,15,318
2020-03-07,울산,강원,2,0,0,0,0,0,2,0,0,0,0,0,0,0
2020-03-07,울산,경기,33,1,3,11,47,1,96,23,1,3,8,5,0,40
2020-03-07,울산,경남,8120,303,410,226,278,464,9801,8040,331,356,239,354,508,9828
2020-03-07,울산,경북,4177,64,159,161,781,217,5559,4098,58,163,232,656,217,5424
2020-03-07,울산,광주,37,2,6,3,1,1,50,34,0,5,2,2,0,43
2020-03-07,울산,대구,756,21,42,31,100,26,976,783,23,42,36,78,36,998
2020-03-07,울산,대전,96,0,7,2,11,7,123,79,0,7,12,12,6,116
2020-03-07,울산,부산,14781,178,187,174,1210,958,17488,13651,165,230,247,1248,898,16439
2020-03-07,울산,서울,21,0,0,4,11,0,36,17,1,1,1,1,0,21
2020-03-07,울산,세종,11,0,0,0,0,0,11,4,0,1,0,2,0,7
2020-03-07,울산,울산,4947,116,188,107,310,417,6085,4947,116,188,107,310,417,6085
2020-03-07,울산,전남,174,7,9,2,10,8,210,159,10,11,11,12,3,206
2020-03-07,울산,전북,32,1,4,2,8,1,48,43,0,4,0,0,0,47
2020-03-07,울산,충남,78,0,13,19,42,2,154,82,1,6,16,51,3,159
2020-03-07,울산,충북,5,1,0,8,25,2,41,15,1,0,10,22,2,50
2020-03-07,전남,강원,11,2,1,3,0,2,19,26,0,3,1,3,1,34
2020-03-07,전남,경기,622,9,45,60,37,22,795,972,10,61,96,115,22,1276
2020-03-07,전남,경남,5218,150,238,176,731,228,6741,5239,130,207,222,650,228,6676
2020-03-07,전남,경북,704,19,50,27,155,21,976,993,18,53,40,247,20,1371
2020-03-07,전남,광주,29366,595,697,356,974,962,32950,31246,568,758,386,911,1068,34937
2020-03-07,전남,대구,426,8,21,20,18,18,511,425,6,19,16,19,18,503
2020-03-07,전남,대전,145,0,5,4,5,5,164,415,4,2,18,18,8,465
2020-03-07,전남,부산,1611,34,76,55,209,57,2042,1821,25,75,67,244,65,2297
2020-03-07,전남,서울,680,6,11,21,13,28,759,1140,5,19,18,13,37,1232
2020-03-07,전남,세종,83,0,0,0,4,3,90,221,1,3,4,8,7,244
2020-03-07,전남,울산,159,10,11,11,12,3,206,174,7,9,2,10,8,210
2020-03-07,전남,전남,40279,747,922,703,2678,1326,46655,40279,747,922,703,2678,1326,46655
2020-03-07,전남,전북,7848,181,449,344,1079,239,10140,5376,126,268,321,711,172,6974
2020-03-07,전남,충남,1819,26,134,151,107,39,2276,5545,44,324,274,484,146,6817
2020-03-07,전남,충북,129,5,4,27,22,4,191,406,8,14,49,126,18,621
2020-03-07,전북,강원,153,6,6,10,18,4,197,114,2,7,6,8,4,141
2020-03-07,전북,경기,1422,24,88,83,101,53,1771,1773,27,122,68,106,68,2164
2020-03-07,전북,경남,983,27,83,42,144,31,1310,1160,26,87,53,151,48,1525
2020-03-07,전북,경북,1362,50,80,84,243,43,1862,1496,41,96,92,140,50,1915
2020-03-07,전북,광주,7146,278,270,181,258,233,8366,7148,231,269,168,180,232,8228
2020-03-07,전북,대구,197,5,15,7,17,7,248,203,3,15,4,16,3,244
2020-03-07,전북,대전,3399,58,68,38,44,131,3738,3400,54,74,58,27,144,3757
2020-03-07,전북,부산,216,7,20,15,20,8,286,278,7,22,9,44,7,367
2020-03-07,전북,서울,1209,12,25,20,12,44,1322,1759,13,28,9,9,55,1873
2020-03-07,전북,세종,885,7,9,8,29,34,972,989,8,15,11,24,32,1079
2020-03-07,전북,울산,43,0,4,0,0,0,47,32,1,4,2,8,1,48
2020-03-07,전북,전남,5376,126,268,321,711,172,6974,7848,181,449,344,1079,239,10140
2020-03-07,전북,전북,14934,392,644,457,647,517,17591,14934,392,644,457,647,517,17591
2020-03-07,전북,충남,16600,277,1088,511,912,571,19959,16201,271,1000,513,754,618,19357
2020-03-07,전북,충북,1814,63,105,157,196,55,2390,1903,64,107,136,150,66,2426
2020-03-07,충남,강원,501,10,13,35,34,22,615,261,4,13,11,19,20,328
2020-03-07,충남,경기,35450,671,1566,1061,2081,1746,42575,39360,754,1606,1084,2099,1873,46776
2020-03-07,충남,경남,1328,20,61,185,239,55,1888,827,10,55,93,90,36,1111
2020-03-07,충남,경북,2676,60,164,298,352,89,3639,2355,65,120,250,263,86,3139
2020-03-07,충남,광주,4471,69,407,319,204,129,5599,3948,46,378,200,138,113,4823
2020-03-07,충남,대구,554,17,44,95,100,21,831,814,29,66,79,82,30,1100
2020-03-07,충남,대전,11745,260,306,121,157,761,13350,12704,277,306,141,131,761,14320
2020-03-07,충남,부산,123,4,10,45,70,4,256,101,2,9,11,52,3,178
2020-03-07,충남,서울,29319,297,1657,556,593,1136,33558,31483,235,1720,435,415,1230,35518
2020-03-07,충남,세종,4215,104,79,61,113,175,4747,5507,120,97,57,112,246,6139
2020-03-07,충남,울산,82,1,6,16,51,3,159,78,0,13,19,42,2,154
2020-03-07,충남,전남,5545,44,324,274,484,146,6817,1819,26,134,151,107,39,2276
2020-03-07,충남,전북,16201,271,1000,513,754,618,19357,16600,277,1088,511,912,571,19959
2020-03-07,충남,충남,90287,1735,4723,3004,5094,3778,108621,90287,1735,4723,3004,5094,3778,108621
2020-03-07,충남,충북,9799,321,432,521,822,480,12375,9035,341,408,392,852,448,11476
2020-03-07,충북,강원,4426,141,142,120,235,223,5287,3883,156,146,133,232,202,4752
2020-03-07,충북,경기,24186,894,1281,1355,1946,1135,30797,26162,983,1380,1438,1782,1275,33020
2020-03-07,충북,경남,1151,20,96,263,445,41,2016,877,12,55,129,166,41,1280
2020-03-07,충북,경북,3742,137,276,350,645,119,5269,3740,98,239,326,558,152,5113
2020-03-07,충북,광주,597,14,43,76,51,21,802,447,14,30,48,20,11,570
2020-03-07,충북,대구,698,36,53,147,92,23,1049,1041,37,59,133,183,46,1499
2020-03-07,충북,대전,8185,235,300,106,82,489,9397,8901,253,289,121,106,579,10249
2020-03-07,충북,부산,100,4,15,62,94,2,277,96,1,12,37,98,1,245
2020-03-07,충북,서울,13553,221,727,474,422,547,15944,14389,194,734,435,338,625,16715
2020-03-07,충북,세종,265,10,15,6,7,15,318,304,5,16,13,10,20,368
2020-03-07,충북,울산,15,1,0,10,22,2,50,5,1,0,8,25,2,41
2020-03-07,충북,전남,406,8,14,49,126,18,621,129,5,4,27,22,4,191
2020-03-07,충북,전북,1903,64,107,136,150,66,2426,1814,63,105,157,196,55,2390
2020-03-07,충북,충남,9035,341,408,392,852,448,11476,9799,321,432,521,822,480,12375
2020-03-07,충북,충북,27585,1024,1166,1005,1943,1492,34215,27585,1024,1166,1005,1943,1492,34215
2020-03-08,강원,강원,65452,631,1335,259,499,3427,71603,65452,631,1335,259,499,3427,71603
2020-03-08,강원,경기,39648,208,505,185,183,1564,42293,26091,146,474,131,213,1128,28183
2020-03-08,강원,경남,191,2,2,2,3,6,206,77,0,3,5,1,2,88
2020-03-08,강원,경북,461,20,8,6,3,19,517,325,11,6,4,6,18,370
2020-03-08,강원,광주,84,0,12,1,2,1,100,67,0,12,0,0,3,82
2020-03-08,강원,대구,252,1,3,4,1,5,266,170,4,3,4,0,4,185
2020-03-08,강원,대전,175,0,19,0,0,5,199,152,1,22,1,1,7,184
2020-03-08,강원,부산,6,1,0,0,1,0,8,1,0,0,0,0,0,1
2020-03-08,강원,서울,1686,7,200,4,6,69,1972,867,6,147,2,3,33,1058
2020-03-08,강원,세종,7,0,0,0,0,0,7,3,0,1,0,0,0,4
2020-03-08,강원,울산,2,0,0,0,0,0,2,2,0,0,0,1,0,3
2020-03-08,강원,전남,43,0,2,1,1,0,47,17,0,2,0,2,1,22
2020-03-08,강원,전북,120,1,3,3,0,3,130,157,3,8,6,5,4,183
2020-03-08,강원,충남,416,1,4,1,7,28,457,369,4,12,4,7,15,411
2020-03-08,강원,충북,4290,60,90,46,39,192,4717,3791,48,80,43,44,189,4195
2020-03-08,경기,강원,26091,146,474,131,213,1128,28183,39648,208,505,185,183,1564,42293
2020-03-08,경기,경기,280577,4575,5774,3028,2860,16204,313018,280577,4575,5774,3028,2860,16204,313018
2020-03-08,경기,경남,2078,21,150,134,72,87,2542,1990,11,119,121,50,80,2371
2020-03-08,경기,경북,2678,36,130,148,51,98,3141,2610,37,102,195,71,122,3137
2020-03-08,경기,광주,573,5,67,30,11,22,708,842,2,48,30,25,21,968
2020-03-08,경기,대구,1033,11,37,76,18,31,1206,1438,9,45,83,64,51,1690
2020-03-08,경기,대전,1739,10,131,7,4,102,1993,2414,20,123,17,8,140,2722
2020-03-08,경기,부산,207,4,11,36,17,9,284,347,2,8,28,53,13,451
2020-03-08,경기,서울,95432,1530,3363,1166,597,5344,107432,104607,1681,3404,1158,582,5971,117403
2020-03-08,경기,세종,34,0,1,1,1,0,37,52,0,1,1,0,2,56
2020-03-08,경기,울산,23,1,0,6,1,0,31,27,0,0,5,4,1,37
2020-03-08,경기,전남,673,3,48,32,35,28,819,1003,4,44,38,23,31,1143
2020-03-08,경기,전북,1159,11,52,23,28,49,1322,2138,15,56,39,50,79,2377
2020-03-08,경기,충남,33452,269,1019,463,624,1645,37472,37679,300,1014,402,555,1767,41717
2020-03-08,경기,충북,22257,446,647,471,467,1106,25394,25483,448,634,463,427,1229,28684
2020-03-08,경남,강원,77,0,3,5,1,2,88,191,2,2,2,3,6,206
2020-03-08,경남,경기,1990,11,119,121,50,80,2371,2078,21,150,134,72,87,2542
2020-03-08,경남,경남,139328,1962,2273,902,1310,8787,154562,139328,1962,2273,902,1310,8787,154562
2020-03-08,경남,경북,8605,125,242,153,159,436,9720,10133,186,314,191,218,503,11545
2020-03-08,경남,광주,1038,14,48,25,13,42,1180,1284,11,55,20,9,55,1434
2020-03-08,경남,대구,10271,132,180,257,369,430,11639,7766,90,114,83,50,333,8436
2020-03-08,경남,대전,883,5,59,30,7,35,1019,1124,6,57,10,6,33,1236
2020-03-08,경남,부산,65996,531,966,238,522,3899,72152,63234,543,987,230,482,3919,69395
2020-03-08,경남,서울,1938,15,279,131,63,72,2498,2359,14,329,39,23,89,2853
2020-03-08,경남,세종,249,0,4,2,0,10,265,269,2,9,1,0,15,296
2020-03-08,경남,울산,8516,132,188,41,57,500,9434,8281,104,190,44,66,470,9155
2020-03-08,경남,전남,5985,69,111,86,186,272,6709,6602,79,118,91,176,256,7322
2020-03-08,경남,전북,1232,19,43,19,27,37,1377,1358,14,67,28,19,55,1541
2020-03-08,경남,충남,1178,8,35,39,26,68,1354,1146,9,30,71,57,58,1371
2020-03-08,경남,충북,1135,12,42,61,52,48,1350,1215,12,51,98,90,46,1512
2020-03-08,경북,강원,325,11,6,4,6,18,370,461,20,8,6,3,19,517
2020-03-08,경북,경기,2610,37,102,195,71,122,3137,2678,36,130,148,51,98,3141
2020-03-08,경북,경남,10133,186,314,191,218,503,11545,8605,125,242,153,159,436,9720
2020-03-08,경북,경북,60820,887,855,537,519,2684,66302,60820,887,855,537,519,2684,66302
2020-03-08,경북,광주,502,20,35,40,12,15,624,731,12,30,27,13,25,838
2020-03-08,경북,대구,47859,564,452,250,290,2048,51463,48714,592,556,267,338,2008,52475
2020-03-08,경북,대전,1410,7,27,37,17,71,1569,1591,6,28,10,10,68,1713
2020-03-08,경북,부산,4459,15,83,29,85,229,4900,5055,23,95,37,96,234,5540
2020-03-08,경북,서울,2128,16,169,125,47,82,2567,2151,20,157,41,11,83,2463
2020-03-08,경북,세종,223,0,2,6,3,8,242,212,3,1,3,0,8,227
2020-03-08,경북,울산,4867,28,77,65,175,225,5437,4486,23,72,46,187,221,5035
2020-03-08,경북,전남,1119,19,28,27,84,36,1313,1029,17,17,12,47,25,1147
2020-03-08,경북,전북,1428,19,41,36,39,57,1620,1729,26,35,35,76,58,1959
2020-03-08,경북,충남,2691,22,38,54,81,110,2996,2408,21,56,69,81,113,2748
2020-03-08,경북,충북,4024,77,124,160,138,154,4677,3988,74,137,108,103,154,4564
2020-03-08,광주,강원,67,0,12,0,0,3,82,84,0,12,1,2,1,100
2020-03-08,광주,경기,842,2,48,30,25,21,968,573,5,67,30,11,22,708
2020-03-08,광주,경남,1284,11,55,20,9,55,1434,1038,14,48,25,13,42,1180
2020-03-08,광주,경북,731,12,30,27,13,25,838,502,20,35,40,12,15,624
2020-03-08,광주,광주,12125,118,383,100,39,414,13179,12125,118,383,100,39,414,13179
2020-03-08,광주,대구,408,7,10,31,9,11,476,294,6,16,11,3,9,339
2020-03-08,광주,대전,450,1,3,5,5,18,482,433,1,3,1,2,18,458
2020-03-08,광주,부산,406,1,28,11,4,16,466,371,0,36,7,9,16,439
2020-03-08,광주,서울,872,9,10,7,4,22,924,565,8,8,8,2,15,606
2020-03-08,광주,세종,217,0,1,0,0,5,223,160,0,2,0,1,5,168
2020-03-08,광주,울산,62,0,6,0,0,4,72,34,0,5,0,1,0,40
2020-03-08,광주,전남,37713,253,587,181,196,1180,40110,37950,237,523,224,178,1218,40330
2020-03-08,광주,전북,7552,84,147,56,49,219,8107,7675,80,147,67,39,242,8250
2020-03-08,광주,충남,5102,33,349,133,81,149,5847,3837,40,363,107,35,108,4490
2020-03-08,광주,충북,593,8,24,21,8,17,671,492,8,17,29,12,14,572
2020-03-08,대구,강원,170,4,3,4,0,4,185,252,1,3,4,1,5,266
2020-03-08,대구,경기,1438,9,45,83,64,51,1690,1033,11,37,76,18,31,1206
2020-03-08,대구,경남,7766,90,114,83,50,333,8436,10271,132,180,257,369,430,11639
2020-03-08,대구,경북,48714,592,556,267,338,2008,52475,47859,564,452,250,290,2048,51463
2020-03-08,대구,광주,294,6,16,11,3,9,339,408,7,10,31,9,11,476
2020-03-08,대구,대구,27191,356,289,150,191,1466,29643,27191,356,289,150,191,1466,29643
2020-03-08,대구,대전,585,1,7,8,9,23,633,428,4,4,9,3,18,466
2020-03-08,대구,부산,404,7,17,8,24,20,480,2910,11,40,17,39,127,3144
2020-03-08,대구,서울,1435,12,57,51,15,34,1604,1196,14,33,17,2,33,1295
2020-03-08,대구,세종,171,0,4,0,0,5,180,94,1,2,1,0,3,101
2020-03-08,대구,울산,746,11,30,9,43,40,879,776,8,26,9,40,37,896
2020-03-08,대구,전남,626,5,7,1,18,15,672,833,5,6,6,10,25,885
2020-03-08,대구,전북,212,0,5,3,8,8,236,259,0,7,3,4,7,280
2020-03-08,대구,충남,859,10,15,27,22,33,966,568,13,7,28,9,24,649
2020-03-08,대구,충북,942,18,40,56,62,35,1153,758,12,26,44,23,33,896
2020-03-08,대전,강원,152,1,22,1,1,7,184,175,0,19,0,0,5,199
2020-03-08,대전,경기,2414,20,123,17,8,140,2722,1739,10,131,7,4,102,1993
2020-03-08,대전,경남,1124,6,57,10,6,33,1236,883,5,59,30,7,35,1019
2020-03-08,대전,경북,1591,6,28,10,10,68,1713,1410,7,27,37,17,71,1569
2020-03-08,대전,광주,433,1,3,1,2,18,458,450,1,3,5,5,18,482
2020-03-08,대전,대구,428,4,4,9,3,18,466,585,1,7,8,9,23,633
2020-03-08,대전,대전,9178,85,130,46,26,558,10023,9178,85,130,46,26,558,10023
2020-03-08,대전,부산,97,0,0,2,0,3,102,101,0,1,5,1,5,113
2020-03-08,대전,서울,2088,12,139,3,3,95,2340,1627,10,150,1,1,91,1880
2020-03-08,대전,세종,1939,46,20,7,1,127,2140,1725,38,14,7,6,112,1902
2020-03-08,대전,울산,128,2,8,2,6,8,154,86,0,9,1,5,4,105
2020-03-08,대전,전남,517,0,3,2,5,10,537,200,0,3,1,1,4,209
2020-03-08,대전,전북,3206,17,46,10,4,128,3411,3983,32,39,29,12,152,4247
2020-03-08,대전,충남,11831,84,194,42,35,633,12819,11229,98,195,51,30,634,12237
2020-03-08,대전,충북,7826,114,200,38,24,478,8680,7026,91,191,38,28,427,7801
2020-03-08,부산,강원,1,0,0,0,0,0,1,6,1,0,0,1,0,8
2020-03-08,부산,경기,347,2,8,28,53,13,451,207,4,11,36,17,9,284
2020-03-08,부산,경남,63234,543,987,230,482,3919,69395,65996,531,966,238,522,3899,72152
2020-03-08,부산,경북,5055,23,95,37,96,234,5540,4459,15,83,29,85,229,4900
2020-03-08,부산,광주,371,0,36,7,9,16,439,406,1,28,11,4,16,466
2020-03-08,부산,대구,2910,11,40,17,39,127,3144,404,7,17,8,24,20,480
2020-03-08,부산,대전,101,0,1,5,1,5,113,97,0,0,2,0,3,102
2020-03-08,부산,부산,48084,118,100,65,189,2701,51257,48084,118,100,65,189,2701,51257
2020-03-08,부산,서울,317,4,8,30,7,10,376,260,2,7,11,3,6,289
2020-03-08,부산,세종,35,0,0,2,0,1,38,30,0,0,0,0,2,32
2020-03-08,부산,울산,14985,44,82,78,380,928,16497,13743,67,42,52,346,876,15126
2020-03-08,부산,전남,1904,13,58,26,101,83,2185,1948,9,43,52,95,69,2216
2020-03-08,부산,전북,282,3,21,3,11,16,336,330,1,20,8,20,14,393
2020-03-08,부산,충남,215,6,3,6,16,10,256,143,1,2,8,13,4,171
2020-03-08,부산,충북,156,1,4,9,20,9,199,95,2,1,18,10,6,132
2020-03-08,서울,강원,867,6,147,2,3,33,1058,1686,7,200,4,6,69,1972
2020-03-08,서울,경기,104607,1681,3404,1158,582,5971,117403,95432,1530,3363,1166,597,5344,107432
2020-03-08,서울,경남,2359,14,329,39,23,89,2853,1938,15,279,131,63,72,2498
2020-03-08,서울,경북,2151,20,157,41,11,83,2463,2128,16,169,125,47,82,2567
2020-03-08,서울,광주,565,8,8,8,2,15,606,872,9,10,7,4,22,924
2020-03-08,서울,대구,1196,14,33,17,2,33,1295,1435,12,57,51,15,34,1604
2020-03-08,서울,대전,1627,10,150,1,1,91,1880,2088,12,139,3,3,95,2340
2020-03-08,서울,부산,260,2,7,11,3,6,289,317,4,8,30,7,10,376
2020-03-08,서울,서울,176,1,3,0,1,8,189,176,1,3,0,1,8,189
2020-03-08,서울,세종,27,0,1,0,0,0,28,23,0,0,0,0,0,23
2020-03-08,서울,울산,24,0,1,0,0,0,25,19,0,3,0,1,2,25
2020-03-08,서울,전남,771,3,9,7,4,18,812,1222,7,15,41,21,40,1346
2020-03-08,서울,전북,1144,5,23,6,5,42,1225,2010,3,21,19,11,76,2140
2020-03-08,서울,충남,29446,142,1608,172,164,1192,32724,34151,151,1563,519,245,1311,37940
2020-03-08,서울,충북,13115,91,578,199,99,533,14615,13769,102,579,215,97,605,15367
2020-03-08,세종,강원,3,0,1,0,0,0,4,7,0,0,0,0,0,7
2020-03-08,세종,경기,52,0,1,1,0,2,56,34,0,1,1,1,0,37
2020-03-08,세종,경남,269,2,9,1,0,15,296,249,0,4,2,0,10,265
2020-03-08,세종,경북,212,3,1,3,0,8,227,223,0,2,6,3,8,242
2020-03-08,세종,광주,160,0,2,0,1,5,168,217,0,1,0,0,5,223
2020-03-08,세종,대구,94,1,2,1,0,3,101,171,0,4,0,0,5,180
2020-03-08,세종,대전,1725,38,14,7,6,112,1902,1939,46,20,7,1,127,2140
2020-03-08,세종,부산,30,0,0,0,0,2,32,35,0,0,2,0,1,38
2020-03-08,세종,서울,23,0,0,0,0,0,23,27,0,1,0,0,0,28
2020-03-08,세종,세종,148,4,0,1,0,5,158,148,4,0,1,0,5,158
2020-03-08,세종,울산,9,0,0,0,1,1,11,2,0,0,0,0,1,3
2020-03-08,세종,전남,215,1,2,1,1,8,228,159,0,3,2,2,7,173
2020-03-08,세종,전북,795,2,7,1,7,18,830,1106,5,6,3,10,38,1168
2020-03-08,세종,충남,5383,52,63,30,29,219,5776,4966,34,71,41,29,205,5346
2020-03-08,세종,충북,294,2,4,4,2,23,329,300,4,4,1,0,29,338
2020-03-08,울산,강원,2,0,0,0,1,0,3,2,0,0,0,0,0,2
2020-03-08,울산,경기,27,0,0,5,4,1,37,23,1,0,6,1,0,31
2020-03-08,울산,경남,8281,104,190,44,66,470,9155,8516,132,188,41,57,500,9434
2020-03-08,울산,경북,4486,23,72,46,187,221,5035,4867,28,77,65,175,225,5437
2020-03-08,울산,광주,34,0,5,0,1,0,40,62,0,6,0,0,4,72
2020-03-08,울산,대구,776,8,26,9,40,37,896,746,11,30,9,43,40,879
2020-03-08,울산,대전,86,0,9,1,5,4,105,128,2,8,2,6,8,154
2020-03-08,울산,부산,13743,67,42,52,346,876,15126,14985,44,82,78,380,928,16497
2020-03-08,울산,서울,19,0,3,0,1,2,25,24,0,1,0,0,0,25
2020-03-08,울산,세종,2,0,0,0,0,1,3,9,0,0,0,1,1,11
2020-03-08,울산,울산,4483,37,74,20,72,300,4986,4483,37,74,20,72,300,4986
2020-03-08,울산,전남,217,3,2,4,0,10,236,262,3,0,1,5,10,281
2020-03-08,울산,전북,46,0,5,0,7,1,59,45,0,3,0,2,1,51
2020-03-08,울산,충남,127,0,1,8,17,6,159,110,0,2,3,17,2,134
2020-03-08,울산,충북,15,0,2,3,8,1,29,15,0,0,3,6,2,26
2020-03-08,전남,강원,17,0,2,0,2,1,22,43,0,2,1,1,0,47
2020-03-08,전남,경기,1003,4,44,38,23,31,1143,673,3,48,32,35,28,819
2020-03-08,전남,경남,6602,79,118,91,176,256,7322,5985,69,111,86,186,272,6709
2020-03-08,전남,경북,1029,17,17,12,47,25,1147,1119,19,28,27,84,36,1313
2020-03-08,전남,광주,37950,237,523,224,178,1218,40330,37713,253,587,181,196,1180,40110
2020-03-08,전남,대구,833,5,6,6,10,25,885,626,5,7,1,18,15,672
2020-03-08,전남,대전,200,0,3,1,1,4,209,517,0,3,2,5,10,537
2020-03-08,전남,부산,1948,9,43,52,95,69,2216,1904,13,58,26,101,83,2185
2020-03-08,전남,서울,1222,7,15,41,21,40,1346,771,3,9,7,4,18,812
2020-03-08,전남,세종,159,0,3,2,2,7,173,215,1,2,1,1,8,228
2020-03-08,전남,울산,262,3,0,1,5,10,281,217,3,2,4,0,10,236
2020-03-08,전남,전남,49358,452,649,454,747,1576,53236,49358,452,649,454,747,1576,53236
2020-03-08,전남,전북,10498,102,296,302,680,307,12185,6818,76,151,118,205,173,7541
2020-03-08,전남,충남,2850,20,141,308,111,72,3502,4803,31,287,88,230,163,5602
2020-03-08,전남,충북,172,4,6,21,13,9,225,481,5,18,22,50,17,593
2020-03-08,전북,강원,157,3,8,6,5,4,183,120,1,3,3,0,3,130
2020-03-08,전북,경기,2138,15,56,39,50,79,2377,1159,11,52,23,28,49,1322
2020-03-08,전북,경남,1358,14,67,28,19,55,1541,1232,19,43,19,27,37,1377
2020-03-08,전북,경북,1729,26,35,35,76,58,1959,1428,19,41,36,39,57,1620
2020-03-08,전북,광주,7675,80,147,67,39,242,8250,7552,84,147,56,49,219,8107
2020-03-08,전북,대구,259,0,7,3,4,7,280,212,0,5,3,8,8,236
2020-03-08,전북,대전,3983,32,39,29,12,152,4247,3206,17,46,10,4,128,3411
2020-03-08,전북,부산,330,1,20,8,20,14,393,282,3,21,3,11,16,336
2020-03-08,전북,서울,2010,3,21,19,11,76,2140,1144,5,23,6,5,42,1225
2020-03-08,전북,세종,1106,5,6,3,10,38,1168,795,2,7,1,7,18,830
2020-03-08,전북,울산,45,0,3,0,2,1,51,46,0,5,0,7,1,59
2020-03-08,전북,전남,6818,76,151,118,205,173,7541,10498,102,296,302,680,307,12185
2020-03-08,전북,전북,16031,173,323,151,227,497,17402,16031,173,323,151,227,497,17402
2020-03-08,전북,충남,22508,153,912,351,616,753,25293,13735,118,764,143,202,464,15426
2020-03-08,전북,충북,2437,41,42,117,75,100,2812,1621,38,38,65,42,66,1870
2020-03-08,충남,강원,369,4,12,4,7,15,411,416,1,4,1,7,28,457
2020-03-08,충남,경기,37679,300,1014,402,555,1767,41717,33452,269,1019,463,624,1645,37472
2020-03-08,충남,경남,1146,9,30,71,57,58,1371,1178,8,35,39,26,68,1354
2020-03-08,충남,경북,2408,21,56,69,81,113,2748,2691,22,38,54,81,110,2996
2020-03-08,충남,광주,3837,40,363,107,35,108,4490,5102,33,349,133,81,149,5847
2020-03-08,충남,대구,568,13,7,28,9,24,649,859,10,15,27,22,33,966
2020-03-08,충남,대전,11229,98,195,51,30,634,12237,11831,84,194,42,35,633,12819
2020-03-08,충남,부산,143,1,2,8,13,4,171,215,6,3,6,16,10,256
2020-03-08,충남,서울,34151,151,1563,519,245,1311,37940,29446,142,1608,172,164,1192,32724
2020-03-08,충남,세종,4966,34,71,41,29,205,5346,5383,52,63,30,29,219,5776
2020-03-08,충남,울산,110,0,2,3,17,2,134,127,0,1,8,17,6,159
2020-03-08,충남,전남,4803,31,287,88,230,163,5602,2850,20,141,308,111,72,3502
2020-03-08,충남,전북,13735,118,764,143,202,464,15426,22508,153,912,351,616,753,25293
2020-03-08,충남,충남,91836,876,3508,1457,1787,3865,103329,91836,876,3508,1457,1787,3865,103329
2020-03-08,충남,충북,9006,149,246,201,223,468,10293,8638,160,252,162,290,446,9948
2020-03-08,충북,강원,3791,48,80,43,44,189,4195,4290,60,90,46,39,192,4717
2020-03-08,충북,경기,25483,448,634,463,427,1229,28684,22257,446,647,471,467,1106,25394
2020-03-08,충북,경남,1215,12,51,98,90,46,1512,1135,12,42,61,52,48,1350
2020-03-08,충북,경북,3988,74,137,108,103,154,4564,4024,77,124,160,138,154,4677
2020-03-08,충북,광주,492,8,17,29,12,14,572,593,8,24,21,8,17,671
2020-03-08,충북,대구,758,12,26,44,23,33,896,942,18,40,56,62,35,1153
2020-03-08,충북,대전,7026,91,191,38,28,427,7801,7826,114,200,38,24,478,8680
2020-03-08,충북,부산,95,2,1,18,10,6,132,156,1,4,9,20,9,199
2020-03-08,충북,서울,13769,102,579,215,97,605,15367,13115,91,578,199,99,533,14615
2020-03-08,충북,세종,300,4,4,1,0,29,338,294,2,4,4,2,23,329
2020-03-08,충북,울산,15,0,0,3,6,2,26,15,0,2,3,8,1,29
2020-03-08,충북,전남,481,5,18,22,50,17,593,172,4,6,21,13,9,225
2020-03-08,충북,전북,1621,38,38,65,42,66,1870,2437,41,42,117,75,100,2812
2020-03-08,충북,충남,8638,160,252,162,290,446,9948,9006,149,246,201,223,468,10293
2020-03-08,충북,충북,25469,412,587,357,482,1337,28644,25469,412,587,357,482,1337,28644
2020-03-09,강원,강원,55754,2093,2427,1373,2431,3910,67988,55754,2093,2427,1373,2431,3910,67988
2020-03-09,강원,경기,19011,518,916,599,654,897,22595,17897,555,923,564,794,918,21651
2020-03-09,강원,경남,108,4,3,8,15,5,143,64,1,3,14,8,4,94
2020-03-09,강원,경북,337,18,23,11,20,16,425,279,13,20,27,26,26,391
2020-03-09,강원,광주,51,3,14,6,4,3,81,69,0,10,7,3,2,91
2020-03-09,강원,대구,120,2,6,5,10,2,145,185,3,7,17,16,5,233
2020-03-09,강원,대전,107,4,20,3,2,1,137,142,6,22,5,3,4,182
2020-03-09,강원,부산,3,0,0,2,1,0,6,0,0,1,0,1,0,2
2020-03-09,강원,서울,610,8,168,14,20,28,848,662,15,147,11,8,24,867
2020-03-09,강원,세종,4,0,0,0,0,0,4,8,1,0,0,0,0,9
2020-03-09,강원,울산,1,0,0,0,0,0,1,0,0,0,0,0,0,0
2020-03-09,강원,전남,55,1,2,2,11,0,71,29,2,3,4,2,0,40
2020-03-09,강원,전북,94,3,6,11,17,3,134,135,4,7,25,29,2,202
2020-03-09,강원,충남,288,6,16,13,27,13,363,350,7,15,28,71,19,490
2020-03-09,강원,충북,3934,209,267,235,331,261,5237,4037,171,235,195,286,249,5173
2020-03-09,경기,강원,17897,555,923,564,794,918,21651,19011,518,916,599,654,897,22595
2020-03-09,경기,경기,412586,22756,24135,19112,24572,30834,533995,412586,22756,24135,19112,24572,30834,533995
2020-03-09,경기,경남,2267,59,251,433,322,73,3405,1669,51,199,394,345,77,2735
2020-03-09,경기,경북,2963,159,416,549,516,108,4711,2558,161,381,764,514,92,4470
2020-03-09,경기,광주,599,19,131,248,135,15,1147,649,19,115,236,120,18,1157
2020-03-09,경기,대구,1054,62,147,257,141,45,1706,1567,96,143,359,409,55,2629
2020-03-09,경기,대전,1686,85,202,76,35,83,2167,2155,96,185,99,55,112,2702
2020-03-09,경기,부산,175,9,25,71,96,9,385,231,14,24,101,212,12,594
2020-03-09,경기,서울,139949,6897,8422,4745,3818,9607,173438,147251,6672,8845,4830,3500,9936,181034
2020-03-09,경기,세종,39,2,6,2,0,2,51,47,1,3,5,1,2,59
2020-03-09,경기,울산,24,0,2,4,8,0,38,27,0,5,17,50,0,99
2020-03-09,경기,전남,718,13,65,127,139,26,1088,678,12,58,87,57,26,918
2020-03-09,경기,전북,1093,52,138,104,198,44,1629,1327,53,129,181,227,46,1963
2020-03-09,경기,충남,36550,1531,2750,2448,4320,1926,49525,33748,1457,2677,2207,4200,1776,46065
2020-03-09,경기,충북,26621,2177,2819,2998,3473,1305,39393,24690,2103,2723,2719,3733,1199,37167
2020-03-09,경남,강원,64,1,3,14,8,4,94,108,4,3,8,15,5,143
2020-03-09,경남,경기,1669,51,199,394,345,77,2735,2267,59,251,433,322,73,3405
2020-03-09,경남,경남,174417,9561,9239,6645,12417,13136,225415,174417,9561,9239,6645,12417,13136,225415
2020-03-09,경남,경북,7857,588,835,897,1795,355,12327,8956,860,976,1092,2360,443,14687
2020-03-09,경남,광주,921,29,117,148,125,29,1369,1103,30,128,135,102,32,1530
2020-03-09,경남,대구,9088,681,748,907,1600,387,13411,6794,427,551,379,511,324,8986
2020-03-09,경남,대전,577,16,84,60,28,28,793,836,18,72,63,49,38,1076
2020-03-09,경남,부산,77310,2504,2404,1649,4484,5601,93952,78673,2649,2646,1825,4779,5659,96231
2020-03-09,경남,서울,1626,32,292,215,106,58,2329,2372,33,310,95,75,63,2948
2020-03-09,경남,세종,146,0,6,12,5,3,172,243,1,9,13,11,9,286
2020-03-09,경남,울산,8582,635,644,456,737,547,11601,8053,567,701,418,650,514,10903
2020-03-09,경남,전남,5401,267,398,476,1227,242,8011,5139,269,398,362,1200,207,7575
2020-03-09,경남,전북,941,40,101,84,179,23,1368,901,41,86,103,151,23,1305
2020-03-09,경남,충남,981,37,111,228,211,36,1604,1316,45,137,211,374,47,2130
2020-03-09,경남,충북,934,49,118,251,271,38,1661,1174,64,169,338,563,30,2338
2020-03-09,경북,강원,279,13,20,27,26,26,391,337,18,23,11,20,16,425
2020-03-09,경북,경기,2558,161,381,764,514,92,4470,2963,159,416,549,516,108,4711
2020-03-09,경북,경남,8956,860,976,1092,2360,443,14687,7857,588,835,897,1795,355,12327
2020-03-09,경북,경북,57834,3626,3791,2756,4781,3101,75889,57834,3626,3791,2756,4781,3101,75889
2020-03-09,경북,광주,521,37,116,165,108,21,968,585,32,84,140,78,27,946
2020-03-09,경북,대구,56182,2668,2166,1550,3167,2946,68679,61062,2922,2514,2015,3618,3122,75253
2020-03-09,경북,대전,1268,48,88,98,87,72,1661,1465,54,93,89,57,65,1823
2020-03-09,경북,부산,3029,106,201,158,592,142,4228,3687,111,200,181,725,169,5073
2020-03-09,경북,서울,1741,90,250,330,111,79,2601,2104,62,229,179,77,75,2726
2020-03-09,경북,세종,199,4,17,23,13,10,266,253,5,17,18,12,13,318
2020-03-09,경북,울산,3843,168,311,365,1054,224,5965,3648,154,289,314,1245,234,5884
2020-03-09,경북,전남,901,38,76,80,374,26,1495,775,49,61,65,274,27,1251
2020-03-09,경북,전북,1461,83,165,182,242,50,2183,1391,97,172,156,425,43,2284
2020-03-09,경북,충남,2440,134,329,565,566,89,4123,2495,125,322,427,666,109,4144
2020-03-09,경북,충북,3680,216,463,713,975,137,6184,3703,236,515,572,965,160,6151
2020-03-09,광주,강원,69,0,10,7,3,2,91,51,3,14,6,4,3,81
2020-03-09,광주,경기,649,19,115,236,120,18,1157,599,19,131,248,135,15,1147
2020-03-09,광주,경남,1103,30,128,135,102,32,1530,921,29,117,148,125,29,1369
2020-03-09,광주,경북,585,32,84,140,78,27,946,521,37,116,165,108,21,968
2020-03-09,광주,광주,12300,453,555,325,356,565,14554,12300,453,555,325,356,565,14554
2020-03-09,광주,대구,350,17,63,86,21,5,542,351,24,69,60,24,7,535
2020-03-09,광주,대전,375,17,13,16,10,14,445,423,15,20,16,16,12,502
2020-03-09,광주,부산,332,5,31,25,80,7,480,365,12,39,65,96,15,592
2020-03-09,광주,서울,523,16,23,55,24,17,658,593,17,9,24,23,23,689
2020-03-09,광주,세종,145,1,9,6,3,5,169,160,3,7,8,1,1,180
2020-03-09,광주,울산,50,1,12,11,4,3,81,50,1,7,6,9,2,75
2020-03-09,광주,전남,32047,950,1092,641,1940,1224,37894,29263,898,925,591,1772,1217,34666
2020-03-09,광주,전북,7208,379,483,366,360,274,9070,6852,433,444,308,364,240,8641
2020-03-09,광주,충남,3831,102,440,387,249,96,5105,3665,109,446,470,304,108,5102
2020-03-09,광주,충북,547,22,59,105,73,18,824,510,28,60,134,60,18,810
2020-03-09,대구,강원,185,3,7,17,16,5,233,120,2,6,5,10,2,145
2020-03-09,대구,경기,1567,96,143,359,409,55,2629,1054,62,147,257,141,45,1706
2020-03-09,대구,경남,6794,427,551,379,511,324,8986,9088,681,748,907,1600,387,13411
2020-03-09,대구,경북,61062,2922,2514,2015,3618,3122,75253,56182,2668,2166,1550,3167,2946,68679
2020-03-09,대구,광주,351,24,69,60,24,7,535,350,17,63,86,21,5,542
2020-03-09,대구,대구,50906,1881,1648,720,1180,3339,59674,50906,1881,1648,720,1180,3339,59674
2020-03-09,대구,대전,583,26,22,52,36,17,736,360,18,11,27,23,13,452
2020-03-09,대구,부산,474,42,95,50,150,13,824,2218,96,140,84,267,79,2884
2020-03-09,대구,서울,1633,44,80,158,87,61,2063,1071,36,46,75,22,34,1284
2020-03-09,대구,세종,173,4,16,7,6,4,210,116,0,10,2,5,4,137
2020-03-09,대구,울산,807,51,70,63,134,33,1158,715,37,76,68,147,38,1081
2020-03-09,대구,전남,393,6,25,20,47,7,498,413,5,32,18,53,13,534
2020-03-09,대구,전북,198,12,18,16,26,8,278,173,12,19,21,20,7,252
2020-03-09,대구,충남,1023,72,104,184,233,29,1645,575,51,101,112,129,18,986
2020-03-09,대구,충북,1056,84,150,233,372,31,1926,664,77,111,151,133,20,1156
2020-03-09,대전,강원,142,6,22,5,3,4,182,107,4,20,3,2,1,137
2020-03-09,대전,경기,2155,96,185,99,55,112,2702,1686,85,202,76,35,83,2167
2020-03-09,대전,경남,836,18,72,63,49,38,1076,577,16,84,60,28,28,793
2020-03-09,대전,경북,1465,54,93,89,57,65,1823,1268,48,88,98,87,72,1661
2020-03-09,대전,광주,423,15,20,16,16,12,502,375,17,13,16,10,14,445
2020-03-09,대전,대구,360,18,11,27,23,13,452,583,26,22,52,36,17,736
2020-03-09,대전,대전,13028,399,357,486,244,929,15443,13028,399,357,486,244,929,15443
2020-03-09,대전,부산,73,2,6,8,18,6,113,63,3,3,8,12,2,91
2020-03-09,대전,서울,1758,41,131,30,10,77,2047,1663,38,138,19,6,74,1938
2020-03-09,대전,세종,3180,97,76,33,55,249,3690,3201,100,71,40,70,238,3720
2020-03-09,대전,울산,98,1,1,8,22,4,134,82,2,3,7,28,4,126
2020-03-09,대전,전남,344,5,2,17,22,7,397,137,4,5,13,3,2,164
2020-03-09,대전,전북,2903,70,77,54,42,122,3268,2791,81,82,75,50,135,3214
2020-03-09,대전,충남,15665,455,493,218,204,1138,18173,13379,424,447,242,203,1054,15749
2020-03-09,대전,충북,10522,410,454,185,188,800,12559,9066,369,372,174,158,703,10842
2020-03-09,부산,강원,0,0,1,0,1,0,2,3,0,0,2,1,0,6
2020-03-09,부산,경기,231,14,24,101,212,12,594,175,9,25,71,96,9,385
2020-03-09,부산,경남,78673,2649,2646,1825,4779,5659,96231,77310,2504,2404,1649,4484,5601,93952
2020-03-09,부산,경북,3687,111,200,181,725,169,5073,3029,106,201,158,592,142,4228
2020-03-09,부산,광주,365,12,39,65,96,15,592,332,5,31,25,80,7,480
2020-03-09,부산,대구,2218,96,140,84,267,79,2884,474,42,95,50,150,13,824
2020-03-09,부산,대전,63,3,3,8,12,2,91,73,2,6,8,18,6,113
2020-03-09,부산,부산,37548,634,604,735,1979,2898,44398,37548,634,604,735,1979,2898,44398
2020-03-09,부산,서울,185,7,14,56,51,7,320,177,8,10,24,29,4,252
2020-03-09,부산,세종,16,0,3,4,1,0,24,21,0,2,0,1,0,24
2020-03-09,부산,울산,14963,359,459,575,2450,1092,19898,13620,380,401,404,2333,1018,18156
2020-03-09,부산,전남,1934,94,114,189,496,65,2892,1564,70,89,137,519,59,2438
2020-03-09,부산,전북,269,7,30,34,69,3,412,227,4,26,43,51,3,354
2020-03-09,부산,충남,187,11,22,56,117,7,400,140,7,29,57,135,1,369
2020-03-09,부산,충북,122,6,21,79,176,5,409,86,7,20,59,151,0,323
2020-03-09,서울,강원,662,15,147,11,8,24,867,610,8,168,14,20,28,848
2020-03-09,서울,경기,147251,6672,8845,4830,3500,9936,181034,139949,6897,8422,4745,3818,9607,173438
2020-03-09,서울,경남,2372,33,310,95,75,63,2948,1626,32,292,215,106,58,2329
2020-03-09,서울,경북,2104,62,229,179,77,75,2726,1741,90,250,330,111,79,2601
2020-03-09,서울,광주,593,17,9,24,23,23,689,523,16,23,55,24,17,658
2020-03-09,서울,대구,1071,36,46,75,22,34,1284,1633,44,80,158,87,61,2063
2020-03-09,서울,대전,1663,38,138,19,6,74,1938,1758,41,131,30,10,77,2047
2020-03-09,서울,부산,177,8,10,24,29,4,252,185,7,14,56,51,7,320
2020-03-09,서울,서울,191,2,15,1,6,10,225,191,2,15,1,6,10,225
2020-03-09,서울,세종,31,1,1,1,0,1,35,15,1,1,1,1,1,20
2020-03-09,서울,울산,15,0,1,1,1,0,18,15,0,1,2,10,1,29
2020-03-09,서울,전남,880,11,21,29,16,36,993,776,6,15,61,22,25,905
2020-03-09,서울,전북,1099,15,33,17,28,32,1224,1030,16,25,35,33,32,1171
2020-03-09,서울,충남,26588,501,1923,718,692,1172,31594,24754,616,1866,1119,1130,1017,30502
2020-03-09,서울,충북,14520,505,947,702,674,584,17932,12126,614,972,781,829,557,15879
2020-03-09,세종,강원,8,1,0,0,0,0,9,4,0,0,0,0,0,4
2020-03-09,세종,경기,47,1,3,5,1,2,59,39,2,6,2,0,2,51
2020-03-09,세종,경남,243,1,9,13,11,9,286,146,0,6,12,5,3,172
2020-03-09,세종,경북,253,5,17,18,12,13,318,199,4,17,23,13,10,266
2020-03-09,세종,광주,160,3,7,8,1,1,180,145,1,9,6,3,5,169
2020-03-09,세종,대구,116,0,10,2,5,4,137,173,4,16,7,6,4,210
2020-03-09,세종,대전,3201,100,71,40,70,238,3720,3180,97,76,33,55,249,3690
2020-03-09,세종,부산,21,0,2,0,1,0,24,16,0,3,4,1,0,24
2020-03-09,세종,서울,15,1,1,1,1,1,20,31,1,1,1,0,1,35
2020-03-09,세종,세종,186,26,2,0,1,10,225,186,26,2,0,1,10,225
2020-03-09,세종,울산,12,0,0,4,5,0,21,3,0,3,2,4,0,12
2020-03-09,세종,전남,190,3,3,5,16,3,220,112,1,1,2,8,3,127
2020-03-09,세종,전북,675,20,26,9,45,27,802,630,16,22,15,57,20,760
2020-03-09,세종,충남,5952,152,146,102,171,339,6862,4064,133,139,112,169,226,4843
2020-03-09,세종,충북,355,7,21,25,14,27,449,273,12,22,7,11,25,350
2020-03-09,울산,강원,0,0,0,0,0,0,0,1,0,0,0,0,0,1
2020-03-09,울산,경기,27,0,5,17,50,0,99,24,0,2,4,8,0,38
2020-03-09,울산,경남,8053,567,701,418,650,514,10903,8582,635,644,456,737,547,11601
2020-03-09,울산,경북,3648,154,289,314,1245,234,5884,3843,168,311,365,1054,224,5965
2020-03-09,울산,광주,50,1,7,6,9,2,75,50,1,12,11,4,3,81
2020-03-09,울산,대구,715,37,76,68,147,38,1081,807,51,70,63,134,33,1158
2020-03-09,울산,대전,82,2,3,7,28,4,126,98,1,1,8,22,4,134
2020-03-09,울산,부산,13620,380,401,404,2333,1018,18156,14963,359,459,575,2450,1092,19898
2020-03-09,울산,서울,15,0,1,2,10,1,29,15,0,1,1,1,0,18
2020-03-09,울산,세종,3,0,3,2,4,0,12,12,0,0,4,5,0,21
2020-03-09,울산,울산,7073,295,528,328,558,678,9460,7073,295,528,328,558,678,9460
2020-03-09,울산,전남,197,11,20,17,30,9,284,182,16,22,14,39,8,281
2020-03-09,울산,전북,46,0,4,2,15,2,69,20,0,3,3,3,2,31
2020-03-09,울산,충남,148,2,16,32,132,2,332,130,3,10,23,97,2,265
2020-03-09,울산,충북,16,3,5,13,40,0,77,11,2,4,8,26,1,52
2020-03-09,전남,강원,29,2,3,4,2,0,40,55,1,2,2,11,0,71
2020-03-09,전남,경기,678,12,58,87,57,26,918,718,13,65,127,139,26,1088
2020-03-09,전남,경남,5139,269,398,362,1200,207,7575,5401,267,398,476,1227,242,8011
2020-03-09,전남,경북,775,49,61,65,274,27,1251,901,38,76,80,374,26,1495
2020-03-09,전남,광주,29263,898,925,591,1772,1217,34666,32047,950,1092,641,1940,1224,37894
2020-03-09,전남,대구,413,5,32,18,53,13,534,393,6,25,20,47,7,498
2020-03-09,전남,대전,137,4,5,13,3,2,164,344,5,2,17,22,7,397
2020-03-09,전남,부산,1564,70,89,137,519,59,2438,1934,94,114,189,496,65,2892
2020-03-09,전남,서울,776,6,15,61,22,25,905,880,11,21,29,16,36,993
2020-03-09,전남,세종,112,1,1,2,8,3,127,190,3,3,5,16,3,220
2020-03-09,전남,울산,182,16,22,14,39,8,281,197,11,20,17,30,9,284
2020-03-09,전남,전남,41190,1211,1413,1422,4446,1679,51361,41190,1211,1413,1422,4446,1679,51361
2020-03-09,전남,전북,6668,309,649,764,2679,209,11278,4535,206,420,539,1272,147,7119
2020-03-09,전남,충남,2075,50,181,383,256,51,2996,4448,81,350,424,867,141,6311
2020-03-09,전남,충북,189,12,9,36,51,2,299,386,20,52,74,229,7,768
2020-03-09,전북,강원,135,4,7,25,29,2,202,94,3,6,11,17,3,134
2020-03-09,전북,경기,1327,53,129,181,227,46,1963,1093,52,138,104,198,44,1629
2020-03-09,전북,경남,901,41,86,103,151,23,1305,941,40,101,84,179,23,1368
2020-03-09,전북,경북,1391,97,172,156,425,43,2284,1461,83,165,182,242,50,2183
2020-03-09,전북,광주,6852,433,444,308,364,240,8641,7208,379,483,366,360,274,9070
2020-03-09,전북,대구,173,12,19,21,20,7,252,198,12,18,16,26,8,278
2020-03-09,전북,대전,2791,81,82,75,50,135,3214,2903,70,77,54,42,122,3268
2020-03-09,전북,부산,227,4,26,43,51,3,354,269,7,30,34,69,3,412
2020-03-09,전북,서울,1030,16,25,35,33,32,1171,1099,15,33,17,28,32,1224
2020-03-09,전북,세종,630,16,22,15,57,20,760,675,20,26,9,45,27,802
2020-03-09,전북,울산,20,0,3,3,3,2,31,46,0,4,2,15,2,69
2020-03-09,전북,전남,4535,206,420,539,1272,147,7119,6668,309,649,764,2679,209,11278
2020-03-09,전북,전북,15691,648,944,680,1224,605,19792,15691,648,944,680,1224,605,19792
2020-03-09,전북,충남,14385,513,1538,1295,2172,527,20430,11750,477,1353,879,1193,444,16096
2020-03-09,전북,충북,1843,120,204,338,458,61,3024,1605,122,217,254,236,69,2503
2020-03-09,충남,강원,350,7,15,28,71,19,490,288,6,16,13,27,13,363
2020-03-09,충남,경기,33748,1457,2677,2207,4200,1776,46065,36550,1531,2750,2448,4320,1926,49525
2020-03-09,충남,경남,1316,45,137,211,374,47,2130,981,37,111,228,211,36,1604
2020-03-09,충남,경북,2495,125,322,427,666,109,4144,2440,134,329,565,566,89,4123
2020-03-09,충남,광주,3665,109,446,470,304,108,5102,3831,102,440,387,249,96,5105
2020-03-09,충남,대구,575,51,101,112,129,18,986,1023,72,104,184,233,29,1645
2020-03-09,충남,대전,13379,424,447,242,203,1054,15749,15665,455,493,218,204,1138,18173
2020-03-09,충남,부산,140,7,29,57,135,1,369,187,11,22,56,117,7,400
2020-03-09,충남,서울,24754,616,1866,1119,1130,1017,30502,26588,501,1923,718,692,1172,31594
2020-03-09,충남,세종,4064,133,139,112,169,226,4843,5952,152,146,102,171,339,6862
2020-03-09,충남,울산,130,3,10,23,97,2,265,148,2,16,32,132,2,332
2020-03-09,충남,전남,4448,81,350,424,867,141,6311,2075,50,181,383,256,51,2996
2020-03-09,충남,전북,11750,477,1353,879,1193,444,16096,14385,513,1538,1295,2172,527,20430
2020-03-09,충남,충남,89441,3445,7014,6638,9939,4396,120873,89441,3445,7014,6638,9939,4396,120873
2020-03-09,충남,충북,12487,673,811,907,1389,717,16984,11382,659,828,778,1521,642,15810
2020-03-09,충북,강원,4037,171,235,195,286,249,5173,3934,209,267,235,331,261,5237
2020-03-09,충북,경기,24690,2103,2723,2719,3733,1199,37167,26621,2177,2819,2998,3473,1305,39393
2020-03-09,충북,경남,1174,64,169,338,563,30,2338,934,49,118,251,271,38,1661
2020-03-09,충북,경북,3703,236,515,572,965,160,6151,3680,216,463,713,975,137,6184
2020-03-09,충북,광주,510,28,60,134,60,18,810,547,22,59,105,73,18,824
2020-03-09,충북,대구,664,77,111,151,133,20,1156,1056,84,150,233,372,31,1926
2020-03-09,충북,대전,9066,369,372,174,158,703,10842,10522,410,454,185,188,800,12559
2020-03-09,충북,부산,86,7,20,59,151,0,323,122,6,21,79,176,5,409
2020-03-09,충북,서울,12126,614,972,781,829,557,15879,14520,505,947,702,674,584,17932
2020-03-09,충북,세종,273,12,22,7,11,25,350,355,7,21,25,14,27,449
2020-03-09,충북,울산,11,2,4,8,26,1,52,16,3,5,13,40,0,77
2020-03-09,충북,전남,386,20,52,74,229,7,768,189,12,9,36,51,2,299
2020-03-09,충북,전북,1605,122,217,254,236,69,2503,1843,120,204,338,458,61,3024
2020-03-09,충북,충남,11382,659,828,778,1521,642,15810,12487,673,811,907,1389,717,16984
2020-03-09,충북,충북,32558,1876,2268,2027,3175,1959,43863,32558,1876,2268,2027,3175,1959,43863
2020-03-10,강원,강원,45766,1899,2269,1023,2305,3446,56708,45766,1899,2269,1023,2305,3446,56708
2020-03-10,강원,경기,13107,489,885,608,686,670,16445,13335,545,865,664,862,711,16982
2020-03-10,강원,경남,99,3,8,9,27,6,152,59,3,5,23,8,5,103
2020-03-10,강원,경북,252,17,16,12,17,9,323,211,9,18,28,24,6,296
2020-03-10,강원,광주,51,0,15,10,9,2,87,62,2,11,10,4,1,90
2020-03-10,강원,대구,76,1,8,14,9,1,109,156,2,7,24,14,6,209
2020-03-10,강원,대전,103,2,15,2,1,3,126,123,3,20,4,2,0,152
2020-03-10,강원,부산,2,0,1,1,2,1,7,1,0,0,3,1,0,5
2020-03-10,강원,서울,389,12,161,8,19,17,606,489,11,137,12,9,20,678
2020-03-10,강원,세종,0,0,0,1,0,0,1,2,0,0,0,2,0,4
2020-03-10,강원,울산,5,0,0,0,0,0,5,0,0,0,0,0,0,0
2020-03-10,강원,전남,28,0,1,2,7,0,38,18,0,1,3,2,0,24
2020-03-10,강원,전북,76,2,12,12,20,1,123,107,8,16,20,29,3,183
2020-03-10,강원,충남,198,3,16,20,35,9,281,238,12,16,41,60,9,376
2020-03-10,강원,충북,3309,204,224,213,338,206,4494,3267,174,221,210,262,184,4318
2020-03-10,경기,강원,13335,545,865,664,862,711,16982,13107,489,885,608,686,670,16445
2020-03-10,경기,경기,373409,21232,23183,18071,20819,28863,485577,373409,21232,23183,18071,20819,28863,485577
2020-03-10,경기,경남,1919,105,290,776,611,55,3756,1308,57,230,531,444,36,2606
2020-03-10,경기,경북,2285,177,429,681,573,77,4222,2239,163,401,914,575,67,4359
2020-03-10,경기,광주,568,27,143,333,151,15,1237,494,15,129,273,117,12,1040
2020-03-10,경기,대구,876,83,171,389,213,25,1757,1383,102,168,481,454,49,2637
2020-03-10,경기,대전,1435,85,202,115,43,60,1940,1477,101,184,108,42,76,1988
2020-03-10,경기,부산,156,15,36,198,158,5,568,183,20,26,172,305,8,714
2020-03-10,경기,서울,128804,6672,8316,5039,2927,8913,160671,129186,6319,8676,4764,2843,9029,160817
2020-03-10,경기,세종,32,2,2,1,4,1,42,30,3,3,5,5,2,48
2020-03-10,경기,울산,28,0,1,10,9,0,48,31,2,24,36,82,1,176
2020-03-10,경기,전남,576,19,82,167,154,13,1011,448,10,68,111,96,17,750
2020-03-10,경기,전북,943,41,147,119,186,29,1465,996,47,131,195,240,34,1643
2020-03-10,경기,충남,29121,1424,2749,2429,4193,1598,41514,28535,1397,2603,2407,3841,1581,40364
2020-03-10,경기,충북,20803,2064,2788,3035,3150,1056,32896,20228,2006,2622,2759,3144,1059,31818
2020-03-10,경남,강원,59,3,5,23,8,5,103,99,3,8,9,27,6,152
2020-03-10,경남,경기,1308,57,230,531,444,36,2606,1919,105,290,776,611,55,3756
2020-03-10,경남,경남,158003,8915,8650,6219,10864,12355,205006,158003,8915,8650,6219,10864,12355,205006
2020-03-10,경남,경북,5902,536,853,802,1679,263,10035,7508,751,1027,1223,2425,330,13264
2020-03-10,경남,광주,661,33,93,167,129,31,1114,738,38,119,152,117,23,1187
2020-03-10,경남,대구,7300,623,729,984,1692,289,11617,5461,443,530,381,458,215,7488
2020-03-10,경남,대전,452,16,85,76,37,14,680,651,30,94,116,56,23,970
2020-03-10,경남,부산,72009,2371,2370,1367,3944,5209,87270,71829,2436,2473,1480,4277,5177,87672
2020-03-10,경남,서울,1263,35,285,297,124,34,2038,1982,62,321,211,127,51,2754
2020-03-10,경남,세종,100,1,8,12,9,4,134,151,0,7,14,13,5,190
2020-03-10,경남,울산,7393,610,643,437,620,504,10207,7058,548,684,444,569,464,9767
2020-03-10,경남,전남,4468,234,396,449,1175,192,6914,4520,243,386,356,1093,184,6782
2020-03-10,경남,전북,782,29,107,101,165,23,1207,793,34,105,102,149,31,1214
2020-03-10,경남,충남,727,46,111,248,227,30,1389,1031,46,157,318,522,43,2117
2020-03-10,경남,충북,642,49,117,285,266,14,1373,852,61,198,485,596,25,2217
2020-03-10,경북,강원,211,9,18,28,24,6,296,252,17,16,12,17,9,323
2020-03-10,경북,경기,2239,163,401,914,575,67,4359,2285,177,429,681,573,77,4222
2020-03-10,경북,경남,7508,751,1027,1223,2425,330,13264,5902,536,853,802,1679,263,10035
2020-03-10,경북,경북,49933,3298,3382,2632,3851,2799,65895,49933,3298,3382,2632,3851,2799,65895
2020-03-10,경북,광주,458,33,94,190,149,10,934,478,38,88,148,87,12,851
2020-03-10,경북,대구,48812,2555,2045,1325,2009,2706,59452,50682,2633,2343,1709,2615,2724,62706
2020-03-10,경북,대전,1079,50,81,108,63,58,1439,1123,48,88,137,79,58,1533
2020-03-10,경북,부산,2646,106,193,195,591,103,3834,2791,121,191,170,835,118,4226
2020-03-10,경북,서울,1413,95,240,438,167,44,2397,1679,67,232,229,106,52,2365
2020-03-10,경북,세종,146,2,21,20,14,13,216,147,7,17,18,7,11,207
2020-03-10,경북,울산,3122,146,272,358,970,205,5073,3191,142,294,313,1136,216,5292
2020-03-10,경북,전남,635,38,79,115,401,25,1293,549,30,49,70,305,17,1020
2020-03-10,경북,전북,1281,78,157,185,215,47,1963,1193,90,162,150,444,47,2086
2020-03-10,경북,충남,1915,125,311,552,589,70,3562,2047,112,356,489,765,71,3840
2020-03-10,경북,충북,3124,205,460,686,880,123,5478,3082,219,497,668,921,124,5511
2020-03-10,광주,강원,62,2,11,10,4,1,90,51,0,15,10,9,2,87
2020-03-10,광주,경기,494,15,129,273,117,12,1040,568,27,143,333,151,15,1237
2020-03-10,광주,경남,738,38,119,152,117,23,1187,661,33,93,167,129,31,1114
2020-03-10,광주,경북,478,38,88,148,87,12,851,458,33,94,190,149,10,934
2020-03-10,광주,광주,11133,457,542,342,252,534,13260,11133,457,542,342,252,534,13260
2020-03-10,광주,대구,266,24,61,88,26,2,467,314,27,78,65,26,5,515
2020-03-10,광주,대전,306,19,11,22,13,10,381,367,23,13,31,15,7,456
2020-03-10,광주,부산,242,14,42,34,73,4,409,288,12,58,67,96,3,524
2020-03-10,광주,서울,418,14,17,63,18,11,541,610,24,28,55,15,21,753
2020-03-10,광주,세종,127,8,6,6,1,2,150,131,4,4,6,0,5,150
2020-03-10,광주,울산,51,0,5,2,8,1,67,30,1,6,8,9,1,55
2020-03-10,광주,전남,27091,824,1012,683,1732,1093,32435,26206,848,897,640,1566,1026,31183
2020-03-10,광주,전북,6121,411,521,324,344,218,7939,6203,449,457,313,373,221,8016
2020-03-10,광주,충남,3003,90,415,481,233,82,4304,3108,119,418,612,348,89,4694
2020-03-10,광주,충북,416,28,51,115,55,9,674,429,33,68,174,100,12,816
2020-03-10,대구,강원,156,2,7,24,14,6,209,76,1,8,14,9,1,109
2020-03-10,대구,경기,1383,102,168,481,454,49,2637,876,83,171,389,213,25,1757
2020-03-10,대구,경남,5461,443,530,381,458,215,7488,7300,623,729,984,1692,289,11617
2020-03-10,대구,경북,50682,2633,2343,1709,2615,2724,62706,48812,2555,2045,1325,2009,2706,59452
2020-03-10,대구,광주,314,27,78,65,26,5,515,266,24,61,88,26,2,467
2020-03-10,대구,대구,45807,1832,1467,776,882,3207,53971,45807,1832,1467,776,882,3207,53971
2020-03-10,대구,대전,471,29,28,68,44,15,655,294,11,18,62,16,11,412
2020-03-10,대구,부산,341,41,81,52,148,14,677,1638,71,149,93,247,64,2262
2020-03-10,대구,서울,1337,58,103,259,102,38,1897,848,33,63,137,44,22,1147
2020-03-10,대구,세종,108,1,3,8,6,1,127,58,2,2,5,4,2,73
2020-03-10,대구,울산,656,44,66,71,155,30,1022,669,33,71,58,177,31,1039
2020-03-10,대구,전남,303,13,29,30,49,6,430,265,13,34,22,66,1,401
2020-03-10,대구,전북,158,10,24,15,19,7,233,129,6,22,21,19,7,204
2020-03-10,대구,충남,760,52,120,187,254,22,1395,479,41,97,152,185,14,968
2020-03-10,대구,충북,760,78,128,264,412,23,1665,534,64,105,238,137,18,1096
2020-03-10,대전,강원,123,3,20,4,2,0,152,103,2,15,2,1,3,126
2020-03-10,대전,경기,1477,101,184,108,42,76,1988,1435,85,202,115,43,60,1940
2020-03-10,대전,경남,651,30,94,116,56,23,970,452,16,85,76,37,14,680
2020-03-10,대전,경북,1123,48,88,137,79,58,1533,1079,50,81,108,63,58,1439
2020-03-10,대전,광주,367,23,13,31,15,7,456,306,19,11,22,13,10,381
2020-03-10,대전,대구,294,11,18,62,16,11,412,471,29,28,68,44,15,655
2020-03-10,대전,대전,11736,338,369,203,85,912,13643,11736,338,369,203,85,912,13643
2020-03-10,대전,부산,46,4,2,19,27,2,100,52,2,6,18,18,1,97
2020-03-10,대전,서울,1337,38,148,32,7,52,1614,1325,39,148,38,7,52,1609
2020-03-10,대전,세종,2844,85,62,24,22,234,3271,2871,81,61,30,36,223,3302
2020-03-10,대전,울산,69,2,3,17,30,3,124,50,1,7,13,23,2,96
2020-03-10,대전,전남,186,1,6,25,31,5,254,86,0,6,11,8,3,114
2020-03-10,대전,전북,2245,53,91,79,37,100,2605,2357,86,79,95,53,111,2781
2020-03-10,대전,충남,13560,377,482,235,130,1060,15844,12178,392,444,218,166,978,14376
2020-03-10,대전,충북,9276,394,411,161,131,679,11052,8173,331,374,158,104,631,9771
2020-03-10,부산,강원,1,0,0,3,1,0,5,2,0,1,1,2,1,7
2020-03-10,부산,경기,183,20,26,172,305,8,714,156,15,36,198,158,5,568
2020-03-10,부산,경남,71829,2436,2473,1480,4277,5177,87672,72009,2371,2370,1367,3944,5209,87270
2020-03-10,부산,경북,2791,121,191,170,835,118,4226,2646,106,193,195,591,103,3834
2020-03-10,부산,광주,288,12,58,67,96,3,524,242,14,42,34,73,4,409
2020-03-10,부산,대구,1638,71,149,93,247,64,2262,341,41,81,52,148,14,677
2020-03-10,부산,대전,52,2,6,18,18,1,97,46,4,2,19,27,2,100
2020-03-10,부산,부산,34569,605,451,567,1902,2660,40754,34569,605,451,567,1902,2660,40754
2020-03-10,부산,서울,163,14,16,89,82,3,367,165,8,14,78,30,6,301
2020-03-10,부산,세종,17,0,2,4,1,2,26,10,1,0,0,1,1,13
2020-03-10,부산,울산,12720,312,461,618,2362,968,17441,12733,353,409,387,2305,967,17154
2020-03-10,부산,전남,1468,64,132,168,553,59,2444,1307,59,116,127,531,61,2201
2020-03-10,부산,전북,217,18,34,42,86,8,405,160,8,29,36,62,5,300
2020-03-10,부산,충남,117,11,14,68,155,4,369,100,14,23,96,212,1,446
2020-03-10,부산,충북,66,11,20,106,212,28,443,77,14,18,128,219,1,457
2020-03-10,서울,강원,489,11,137,12,9,20,678,389,12,161,8,19,17,606
2020-03-10,서울,경기,129186,6319,8676,4764,2843,9029,160817,128804,6672,8316,5039,2927,8913,160671
2020-03-10,서울,경남,1982,62,321,211,127,51,2754,1263,35,285,297,124,34,2038
2020-03-10,서울,경북,1679,67,232,229,106,52,2365,1413,95,240,438,167,44,2397
2020-03-10,서울,광주,610,24,28,55,15,21,753,418,14,17,63,18,11,541
2020-03-10,서울,대구,848,33,63,137,44,22,1147,1337,58,103,259,102,38,1897
2020-03-10,서울,대전,1325,39,148,38,7,52,1609,1337,38,148,32,7,52,1614
2020-03-10,서울,부산,165,8,14,78,30,6,301,163,14,16,89,82,3,367
2020-03-10,서울,서울,169,7,9,8,2,10,205,169,7,9,8,2,10,205
2020-03-10,서울,세종,30,2,2,0,0,0,34,20,1,0,0,0,1,22
2020-03-10,서울,울산,22,0,2,0,1,1,26,11,0,4,14,14,0,43
2020-03-10,서울,전남,663,13,20,41,21,20,778,539,12,16,56,24,10,657
2020-03-10,서울,전북,971,22,36,24,23,30,1106,838,22,43,32,22,22,979
2020-03-10,서울,충남,20615,493,1825,814,703,818,25268,20393,537,1808,1216,1095,807,25856
2020-03-10,서울,충북,10505,482,947,743,637,455,13769,10171,572,928,770,748,400,13589
2020-03-10,세종,강원,2,0,0,0,2,0,4,0,0,0,1,0,0,1
2020-03-10,세종,경기,30,3,3,5,5,2,48,32,2,2,1,4,1,42
2020-03-10,세종,경남,151,0,7,14,13,5,190,100,1,8,12,9,4,134
2020-03-10,세종,경북,147,7,17,18,7,11,207,146,2,21,20,14,13,216
2020-03-10,세종,광주,131,4,4,6,0,5,150,127,8,6,6,1,2,150
2020-03-10,세종,대구,58,2,2,5,4,2,73,108,1,3,8,6,1,127
2020-03-10,세종,대전,2871,81,61,30,36,223,3302,2844,85,62,24,22,234,3271
2020-03-10,세종,부산,10,1,0,0,1,1,13,17,0,2,4,1,2,26
2020-03-10,세종,서울,20,1,0,0,0,1,22,30,2,2,0,0,0,34
2020-03-10,세종,세종,212,22,3,1,1,10,249,212,22,3,1,1,10,249
2020-03-10,세종,울산,3,0,0,0,5,0,8,8,0,0,1,2,0,11
2020-03-10,세종,전남,105,2,5,6,17,2,137,68,3,0,3,7,0,81
2020-03-10,세종,전북,474,14,22,8,43,25,586,485,14,23,11,57,18,608
2020-03-10,세종,충남,4618,134,146,98,161,253,5410,3477,129,129,136,145,165,4181
2020-03-10,세종,충북,289,14,17,16,6,25,367,255,11,15,7,8,20,316
2020-03-10,울산,강원,0,0,0,0,0,0,0,5,0,0,0,0,0,5
2020-03-10,울산,경기,31,2,24,36,82,1,176,28,0,1,10,9,0,48
2020-03-10,울산,경남,7058,548,684,444,569,464,9767,7393,610,643,437,620,504,10207
2020-03-10,울산,경북,3191,142,294,313,1136,216,5292,3122,146,272,358,970,205,5073
2020-03-10,울산,광주,30,1,6,8,9,1,55,51,0,5,2,8,1,67
2020-03-10,울산,대구,669,33,71,58,177,31,1039,656,44,66,71,155,30,1022
2020-03-10,울산,대전,50,1,7,13,23,2,96,69,2,3,17,30,3,124
2020-03-10,울산,부산,12733,353,409,387,2305,967,17154,12720,312,461,618,2362,968,17441
2020-03-10,울산,서울,11,0,4,14,14,0,43,22,0,2,0,1,1,26
2020-03-10,울산,세종,8,0,0,1,2,0,11,3,0,0,0,5,0,8
2020-03-10,울산,울산,6716,262,470,255,588,602,8893,6716,262,470,255,588,602,8893
2020-03-10,울산,전남,142,11,19,11,27,2,212,157,14,22,6,49,3,251
2020-03-10,울산,전북,35,1,6,3,16,0,61,23,1,5,3,3,0,35
2020-03-10,울산,충남,102,2,18,53,141,4,320,75,3,10,37,118,2,245
2020-03-10,울산,충북,16,2,3,23,40,1,85,12,0,6,19,33,0,70
2020-03-10,전남,강원,18,0,1,3,2,0,24,28,0,1,2,7,0,38
2020-03-10,전남,경기,448,10,68,111,96,17,750,576,19,82,167,154,13,1011
2020-03-10,전남,경남,4520,243,386,356,1093,184,6782,4468,234,396,449,1175,192,6914
2020-03-10,전남,경북,549,30,49,70,305,17,1020,635,38,79,115,401,25,1293
2020-03-10,전남,광주,26206,848,897,640,1566,1026,31183,27091,824,1012,683,1732,1093,32435
2020-03-10,전남,대구,265,13,34,22,66,1,401,303,13,29,30,49,6,430
2020-03-10,전남,대전,86,0,6,11,8,3,114,186,1,6,25,31,5,254
2020-03-10,전남,부산,1307,59,116,127,531,61,2201,1468,64,132,168,553,59,2444
2020-03-10,전남,서울,539,12,16,56,24,10,657,663,13,20,41,21,20,778
2020-03-10,전남,세종,68,3,0,3,7,0,81,105,2,5,6,17,2,137
2020-03-10,전남,울산,157,14,22,6,49,3,251,142,11,19,11,27,2,212
2020-03-10,전남,전남,35699,1145,1252,1338,4005,1446,44885,35699,1145,1252,1338,4005,1446,44885
2020-03-10,전남,전북,5281,280,624,770,2614,153,9722,3462,193,385,519,1114,105,5778
2020-03-10,전남,충남,1370,41,181,373,241,35,2241,3334,73,423,519,1028,94,5471
2020-03-10,전남,충북,91,5,21,40,69,4,230,275,8,54,101,254,8,700
2020-03-10,전북,강원,107,8,16,20,29,3,183,76,2,12,12,20,1,123
2020-03-10,전북,경기,996,47,131,195,240,34,1643,943,41,147,119,186,29,1465
2020-03-10,전북,경남,793,34,105,102,149,31,1214,782,29,107,101,165,23,1207
2020-03-10,전북,경북,1193,90,162,150,444,47,2086,1281,78,157,185,215,47,1963
2020-03-10,전북,광주,6203,449,457,313,373,221,8016,6121,411,521,324,344,218,7939
2020-03-10,전북,대구,129,6,22,21,19,7,204,158,10,24,15,19,7,233
2020-03-10,전북,대전,2357,86,79,95,53,111,2781,2245,53,91,79,37,100,2605
2020-03-10,전북,부산,160,8,29,36,62,5,300,217,18,34,42,86,8,405
2020-03-10,전북,서울,838,22,43,32,22,22,979,971,22,36,24,23,30,1106
2020-03-10,전북,세종,485,14,23,11,57,18,608,474,14,22,8,43,25,586
2020-03-10,전북,울산,23,1,5,3,3,0,35,35,1,6,3,16,0,61
2020-03-10,전북,전남,3462,193,385,519,1114,105,5778,5281,280,624,770,2614,153,9722
2020-03-10,전북,전북,13669,560,852,581,987,572,17221,13669,560,852,581,987,572,17221
2020-03-10,전북,충남,11707,477,1493,1340,2313,347,17677,10181,413,1294,892,1306,299,14385
2020-03-10,전북,충북,1417,107,160,321,413,49,2467,1261,118,183,279,273,36,2150
2020-03-10,충남,강원,238,12,16,41,60,9,376,198,3,16,20,35,9,281
2020-03-10,충남,경기,28535,1397,2603,2407,3841,1581,40364,29121,1424,2749,2429,4193,1598,41514
2020-03-10,충남,경남,1031,46,157,318,522,43,2117,727,46,111,248,227,30,1389
2020-03-10,충남,경북,2047,112,356,489,765,71,3840,1915,125,311,552,589,70,3562
2020-03-10,충남,광주,3108,119,418,612,348,89,4694,3003,90,415,481,233,82,4304
2020-03-10,충남,대구,479,41,97,152,185,14,968,760,52,120,187,254,22,1395
2020-03-10,충남,대전,12178,392,444,218,166,978,14376,13560,377,482,235,130,1060,15844
2020-03-10,충남,부산,100,14,23,96,212,1,446,117,11,14,68,155,4,369
2020-03-10,충남,서울,20393,537,1808,1216,1095,807,25856,20615,493,1825,814,703,818,25268
2020-03-10,충남,세종,3477,129,129,136,145,165,4181,4618,134,146,98,161,253,5410
2020-03-10,충남,울산,75,3,10,37,118,2,245,102,2,18,53,141,4,320
2020-03-10,충남,전남,3334,73,423,519,1028,94,5471,1370,41,181,373,241,35,2241
2020-03-10,충남,전북,10181,413,1294,892,1306,299,14385,11707,477,1493,1340,2313,347,17677
2020-03-10,충남,충남,75590,3147,7032,6825,9827,3693,106114,75590,3147,7032,6825,9827,3693,106114
2020-03-10,충남,충북,10674,583,797,896,1386,634,14970,9673,574,762,814,1307,562,13692
2020-03-10,충북,강원,3267,174,221,210,262,184,4318,3309,204,224,213,338,206,4494
2020-03-10,충북,경기,20228,2006,2622,2759,3144,1059,31818,20803,2064,2788,3035,3150,1056,32896
2020-03-10,충북,경남,852,61,198,485,596,25,2217,642,49,117,285,266,14,1373
2020-03-10,충북,경북,3082,219,497,668,921,124,5511,3124,205,460,686,880,123,5478
2020-03-10,충북,광주,429,33,68,174,100,12,816,416,28,51,115,55,9,674
2020-03-10,충북,대구,534,64,105,238,137,18,1096,760,78,128,264,412,23,1665
2020-03-10,충북,대전,8173,331,374,158,104,631,9771,9276,394,411,161,131,679,11052
2020-03-10,충북,부산,77,14,18,128,219,1,457,66,11,20,106,212,28,443
2020-03-10,충북,서울,10171,572,928,770,748,400,13589,10505,482,947,743,637,455,13769
2020-03-10,충북,세종,255,11,15,7,8,20,316,289,14,17,16,6,25,367
2020-03-10,충북,울산,12,0,6,19,33,0,70,16,2,3,23,40,1,85
2020-03-10,충북,전남,275,8,54,101,254,8,700,91,5,21,40,69,4,230
2020-03-10,충북,전북,1261,118,183,279,273,36,2150,1417,107,160,321,413,49,2467
2020-03-10,충북,충남,9673,574,762,814,1307,562,13692,10674,583,797,896,1386,634,14970
2020-03-10,충북,충북,28382,1689,2229,1963,2727,1832,38822,28382,1689,2229,1963,2727,1832,38822
2020-03-11,강원,강원,54873,2189,2451,1463,2620,3839,67435,54873,2189,2451,1463,2620,3839,67435
2020-03-11,강원,경기,16261,574,950,645,726,796,19952,18482,582,930,726,955,820,22495
2020-03-11,강원,경남,106,5,8,14,27,2,162,60,1,8,18,28,2,117
2020-03-11,강원,경북,249,24,17,16,36,6,348,268,21,23,22,37,6,377
2020-03-11,강원,광주,73,4,16,9,18,1,121,58,1,8,7,7,1,82
2020-03-11,강원,대구,111,6,14,7,10,3,151,151,10,8,18,16,5,208
2020-03-11,강원,대전,121,4,24,7,4,6,166,136,9,21,6,7,5,184
2020-03-11,강원,부산,5,0,0,1,4,0,10,4,0,1,0,4,0,9
2020-03-11,강원,서울,582,17,150,7,17,21,794,667,14,119,6,14,21,841
2020-03-11,강원,세종,7,0,0,0,0,0,7,6,0,0,0,0,1,7
2020-03-11,강원,울산,2,0,0,1,1,0,4,1,0,0,0,0,0,1
2020-03-11,강원,전남,26,2,4,6,12,1,51,13,1,2,1,6,0,23
2020-03-11,강원,전북,91,3,10,12,22,4,142,111,9,9,22,35,6,192
2020-03-11,강원,충남,206,8,13,25,29,5,286,304,10,28,36,63,14,455
2020-03-11,강원,충북,3695,216,240,224,360,233,4968,3836,210,220,230,295,220,5011
2020-03-11,경기,강원,18482,582,930,726,955,820,22495,16261,574,950,645,726,796,19952
2020-03-11,경기,경기,414776,23838,24982,20267,24515,30906,539284,414776,23838,24982,20267,24515,30906,539284
2020-03-11,경기,경남,2057,88,275,744,605,60,3829,1464,63,200,527,429,32,2715
2020-03-11,경기,경북,2510,177,419,779,639,70,4594,2401,166,392,954,653,78,4644
2020-03-11,경기,광주,639,35,138,306,144,16,1278,552,18,123,251,114,14,1072
2020-03-11,경기,대구,912,84,171,410,231,23,1831,1520,101,158,440,445,58,2722
2020-03-11,경기,대전,1594,99,203,130,53,62,2141,1637,119,168,107,41,75,2147
2020-03-11,경기,부산,144,18,47,178,174,7,568,164,17,34,153,322,6,696
2020-03-11,경기,서울,141587,7272,8514,5358,3970,9419,176120,144102,6977,8926,4983,3549,9673,178210
2020-03-11,경기,세종,38,1,0,4,1,2,46,41,4,4,3,2,8,62
2020-03-11,경기,울산,21,0,1,10,13,2,47,37,3,7,24,67,2,140
2020-03-11,경기,전남,682,21,87,174,173,17,1154,486,18,57,80,85,9,735
2020-03-11,경기,전북,1088,56,152,129,184,32,1641,1070,52,150,222,252,37,1783
2020-03-11,경기,충남,33627,1559,2800,2636,4790,1756,47168,32411,1498,2681,2424,4517,1650,45181
2020-03-11,경기,충북,24387,2259,2955,3356,3603,1186,37746,23549,2198,2810,3017,3720,1135,36429
2020-03-11,경남,강원,60,1,8,18,28,2,117,106,5,8,14,27,2,162
2020-03-11,경남,경기,1464,63,200,527,429,32,2715,2057,88,275,744,605,60,3829
2020-03-11,경남,경남,179169,9943,9691,7211,12791,13374,232179,179169,9943,9691,7211,12791,13374,232179
2020-03-11,경남,경북,7112,605,869,937,1746,330,11599,8822,833,1075,1231,2617,420,14998
2020-03-11,경남,광주,778,44,104,191,157,19,1293,776,44,136,145,120,16,1237
2020-03-11,경남,대구,8872,704,755,993,1787,348,13459,6916,506,544,414,528,273,9181
2020-03-11,경남,대전,540,19,75,65,25,27,751,737,18,86,111,55,29,1036
2020-03-11,경남,부산,80859,2712,2551,1685,4535,5703,98045,80365,2794,2728,1719,4847,5649,98102
2020-03-11,경남,서울,1423,29,267,276,144,41,2180,2013,54,304,203,119,54,2747
2020-03-11,경남,세종,121,2,15,11,7,4,160,180,3,12,16,20,6,237
2020-03-11,경남,울산,8439,641,654,487,645,559,11425,8212,584,663,441,611,525,11036
2020-03-11,경남,전남,5300,236,421,492,1339,223,8011,5171,271,417,434,1291,209,7793
2020-03-11,경남,전북,890,45,128,92,165,34,1354,863,41,112,97,171,36,1320
2020-03-11,경남,충남,714,49,120,285,234,24,1426,1101,60,162,342,536,46,2247
2020-03-11,경남,충북,774,62,114,280,283,29,1542,985,65,224,494,656,33,2457
2020-03-11,경북,강원,268,21,23,22,37,6,377,249,24,17,16,36,6,348
2020-03-11,경북,경기,2401,166,392,954,653,78,4644,2510,177,419,779,639,70,4594
2020-03-11,경북,경남,8822,833,1075,1231,2617,420,14998,7112,605,869,937,1746,330,11599
2020-03-11,경북,경북,58712,3814,3816,2957,4862,3146,77307,58712,3814,3816,2957,4862,3146,77307
2020-03-11,경북,광주,534,60,101,186,138,11,1030,513,49,97,179,87,17,942
2020-03-11,경북,대구,57279,2902,2310,1557,2467,2996,69511,60448,3021,2572,1815,2964,3083,73903
2020-03-11,경북,대전,1213,60,88,119,79,65,1624,1242,65,91,115,69,73,1655
2020-03-11,경북,부산,3105,126,186,234,677,146,4474,3341,130,214,220,966,162,5033
2020-03-11,경북,서울,1620,87,238,393,171,46,2555,1818,79,218,253,115,44,2527
2020-03-11,경북,세종,187,7,16,20,17,12,259,189,7,11,19,15,11,252
2020-03-11,경북,울산,3978,182,276,461,1029,229,6155,3958,162,286,360,1283,221,6270
2020-03-11,경북,전남,785,29,89,107,445,17,1472,674,37,70,69,294,21,1165
2020-03-11,경북,전북,1547,102,176,193,260,54,2332,1400,102,187,165,496,41,2391
2020-03-11,경북,충남,2112,161,353,591,608,91,3916,2219,137,373,538,797,92,4156
2020-03-11,경북,충북,3479,244,485,717,905,123,5953,3340,253,512,683,1018,130,5936
2020-03-11,광주,강원,58,1,8,7,7,1,82,73,4,16,9,18,1,121
2020-03-11,광주,경기,552,18,123,251,114,14,1072,639,35,138,306,144,16,1278
2020-03-11,광주,경남,776,44,136,145,120,16,1237,778,44,104,191,157,19,1293
2020-03-11,광주,경북,513,49,97,179,87,17,942,534,60,101,186,138,11,1030
2020-03-11,광주,광주,12956,491,538,406,257,565,15213,12956,491,538,406,257,565,15213
2020-03-11,광주,대구,282,30,54,86,22,5,479,333,33,66,77,24,5,538
2020-03-11,광주,대전,358,18,11,18,14,7,426,413,20,18,31,18,16,516
2020-03-11,광주,부산,288,6,37,48,80,8,467,309,14,39,63,117,4,546
2020-03-11,광주,서울,473,14,22,70,18,15,612,632,13,16,43,22,12,738
2020-03-11,광주,세종,109,1,8,5,0,7,130,125,4,8,6,3,3,149
2020-03-11,광주,울산,50,0,5,1,4,0,60,41,1,7,8,10,1,68
2020-03-11,광주,전남,31492,1002,1166,763,1826,1250,37499,29952,965,967,628,1692,1226,35430
2020-03-11,광주,전북,6695,434,516,362,380,270,8657,6776,436,465,367,391,271,8706
2020-03-11,광주,충남,3306,108,397,499,237,75,4622,3438,111,410,632,342,79,5012
2020-03-11,광주,충북,438,24,67,112,81,8,730,491,36,97,179,111,13,927
2020-03-11,대구,강원,151,10,8,18,16,5,208,111,6,14,7,10,3,151
2020-03-11,대구,경기,1520,101,158,440,445,58,2722,912,84,171,410,231,23,1831
2020-03-11,대구,경남,6916,506,544,414,528,273,9181,8872,704,755,993,1787,348,13459
2020-03-11,대구,경북,60448,3021,2572,1815,2964,3083,73903,57279,2902,2310,1557,2467,2996,69511
2020-03-11,대구,광주,333,33,66,77,24,5,538,282,30,54,86,22,5,479
2020-03-11,대구,대구,50917,2055,1593,1006,1058,3330,59959,50917,2055,1593,1006,1058,3330,59959
2020-03-11,대구,대전,549,32,23,71,33,25,733,320,23,17,47,16,4,427
2020-03-11,대구,부산,397,56,108,59,153,10,783,1975,111,161,90,252,84,2673
2020-03-11,대구,서울,1501,60,87,234,118,36,2036,835,44,66,119,52,25,1141
2020-03-11,대구,세종,117,0,6,4,7,3,137,67,2,4,3,3,2,81
2020-03-11,대구,울산,735,55,58,82,172,26,1128,734,46,59,76,187,36,1138
2020-03-11,대구,전남,384,17,31,34,37,9,512,378,20,27,33,77,9,544
2020-03-11,대구,전북,191,16,36,22,21,9,295,176,4,35,18,25,3,261
2020-03-11,대구,충남,906,74,137,217,258,29,1621,567,63,120,166,167,13,1096
2020-03-11,대구,충북,994,102,173,246,440,32,1987,666,79,132,234,144,17,1272
2020-03-11,대전,강원,136,9,21,6,7,5,184,121,4,24,7,4,6,166
2020-03-11,대전,경기,1637,119,168,107,41,75,2147,1594,99,203,130,53,62,2141
2020-03-11,대전,경남,737,18,86,111,55,29,1036,540,19,75,65,25,27,751
2020-03-11,대전,경북,1242,65,91,115,69,73,1655,1213,60,88,119,79,65,1624
2020-03-11,대전,광주,413,20,18,31,18,16,516,358,18,11,18,14,7,426
2020-03-11,대전,대구,320,23,17,47,16,4,427,549,32,23,71,33,25,733
2020-03-11,대전,대전,13203,427,383,204,154,959,15330,13203,427,383,204,154,959,15330
2020-03-11,대전,부산,44,3,2,15,16,1,81,44,2,4,16,20,3,89
2020-03-11,대전,서울,1437,39,148,36,8,63,1731,1549,49,139,39,11,58,1845
2020-03-11,대전,세종,3076,101,59,24,56,237,3553,3168,95,65,33,52,257,3670
2020-03-11,대전,울산,62,2,5,24,26,4,123,68,2,7,7,25,4,113
2020-03-11,대전,전남,299,9,4,30,25,13,380,97,4,5,3,7,2,118
2020-03-11,대전,전북,2751,78,96,77,50,148,3200,2887,86,98,92,63,128,3354
2020-03-11,대전,충남,14889,484,530,279,248,1115,17545,13569,472,457,244,262,1033,16037
2020-03-11,대전,충북,10230,450,450,193,165,768,12256,9174,419,384,185,130,741,11033
2020-03-11,부산,강원,4,0,1,0,4,0,9,5,0,0,1,4,0,10
2020-03-11,부산,경기,164,17,34,153,322,6,696,144,18,47,178,174,7,568
2020-03-11,부산,경남,80365,2794,2728,1719,4847,5649,98102,80859,2712,2551,1685,4535,5703,98045
2020-03-11,부산,경북,3341,130,214,220,966,162,5033,3105,126,186,234,677,146,4474
2020-03-11,부산,광주,309,14,39,63,117,4,546,288,6,37,48,80,8,467
2020-03-11,부산,대구,1975,111,161,90,252,84,2673,397,56,108,59,153,10,783
2020-03-11,부산,대전,44,2,4,16,20,3,89,44,3,2,15,16,1,81
2020-03-11,부산,부산,41538,654,612,788,2237,3026,48855,41538,654,612,788,2237,3026,48855
2020-03-11,부산,서울,146,11,12,79,72,5,325,171,14,28,60,30,7,310
2020-03-11,부산,세종,15,0,3,3,5,0,26,13,0,0,1,2,1,17
2020-03-11,부산,울산,14097,413,469,614,2527,1058,19178,14151,378,419,427,2383,1072,18830
2020-03-11,부산,전남,1671,82,115,186,561,70,2685,1481,67,107,128,611,57,2451
2020-03-11,부산,전북,237,10,29,36,95,11,418,192,7,28,32,53,8,320
2020-03-11,부산,충남,126,7,23,69,160,5,390,107,13,29,94,192,5,440
2020-03-11,부산,충북,68,9,26,69,225,6,403,80,15,29,126,187,3,440
2020-03-11,서울,강원,667,14,119,6,14,21,841,582,17,150,7,17,21,794
2020-03-11,서울,경기,144102,6977,8926,4983,3549,9673,178210,141587,7272,8514,5358,3970,9419,176120
2020-03-11,서울,경남,2013,54,304,203,119,54,2747,1423,29,267,276,144,41,2180
2020-03-11,서울,경북,1818,79,218,253,115,44,2527,1620,87,238,393,171,46,2555
2020-03-11,서울,광주,632,13,16,43,22,12,738,473,14,22,70,18,15,612
2020-03-11,서울,대구,835,44,66,119,52,25,1141,1501,60,87,234,118,36,2036
2020-03-11,서울,대전,1549,49,139,39,11,58,1845,1437,39,148,36,8,63,1731
2020-03-11,서울,부산,171,14,28,60,30,7,310,146,11,12,79,72,5,325
2020-03-11,서울,서울,195,6,10,4,3,3,221,195,6,10,4,3,3,221
2020-03-11,서울,세종,27,0,0,1,0,0,28,27,0,1,1,0,0,29
2020-03-11,서울,울산,21,2,2,2,3,0,30,21,2,2,7,12,0,44
2020-03-11,서울,전남,761,8,11,32,29,29,870,532,6,15,64,26,15,658
2020-03-11,서울,전북,1085,20,28,18,16,39,1206,945,19,38,26,16,26,1070
2020-03-11,서울,충남,23148,509,1869,843,739,962,28070,22286,595,1837,1331,1198,916,28163
2020-03-11,서울,충북,12170,575,914,817,751,544,15771,11519,664,926,898,879,509,15395
2020-03-11,세종,강원,6,0,0,0,0,1,7,7,0,0,0,0,0,7
2020-03-11,세종,경기,41,4,4,3,2,8,62,38,1,0,4,1,2,46
2020-03-11,세종,경남,180,3,12,16,20,6,237,121,2,15,11,7,4,160
2020-03-11,세종,경북,189,7,11,19,15,11,252,187,7,16,20,17,12,259
2020-03-11,세종,광주,125,4,8,6,3,3,149,109,1,8,5,0,7,130
2020-03-11,세종,대구,67,2,4,3,3,2,81,117,0,6,4,7,3,137
2020-03-11,세종,대전,3168,95,65,33,52,257,3670,3076,101,59,24,56,237,3553
2020-03-11,세종,부산,13,0,0,1,2,1,17,15,0,3,3,5,0,26
2020-03-11,세종,서울,27,0,1,1,0,0,29,27,0,0,1,0,0,28
2020-03-11,세종,세종,205,25,1,0,0,21,252,205,25,1,0,0,21,252
2020-03-11,세종,울산,5,0,0,3,2,0,10,6,0,0,0,3,0,9
2020-03-11,세종,전남,141,3,2,7,18,1,172,65,1,2,2,10,3,83
2020-03-11,세종,전북,609,21,21,12,48,22,733,592,15,15,12,62,9,705
2020-03-11,세종,충남,5306,165,154,143,214,302,6284,3992,153,141,126,179,207,4798
2020-03-11,세종,충북,333,15,16,11,17,33,425,296,14,16,11,18,22,377
2020-03-11,울산,강원,1,0,0,0,0,0,1,2,0,0,1,1,0,4
2020-03-11,울산,경기,37,3,7,24,67,2,140,21,0,1,10,13,2,47
2020-03-11,울산,경남,8212,584,663,441,611,525,11036,8439,641,654,487,645,559,11425
2020-03-11,울산,경북,3958,162,286,360,1283,221,6270,3978,182,276,461,1029,229,6155
2020-03-11,울산,광주,41,1,7,8,10,1,68,50,0,5,1,4,0,60
2020-03-11,울산,대구,734,46,59,76,187,36,1138,735,55,58,82,172,26,1128
2020-03-11,울산,대전,68,2,7,7,25,4,113,62,2,5,24,26,4,123
2020-03-11,울산,부산,14151,378,419,427,2383,1072,18830,14097,413,469,614,2527,1058,19178
2020-03-11,울산,서울,21,2,2,7,12,0,44,21,2,2,2,3,0,30
2020-03-11,울산,세종,6,0,0,0,3,0,9,5,0,0,3,2,0,10
2020-03-11,울산,울산,7430,301,531,305,618,645,9830,7430,301,531,305,618,645,9830
2020-03-11,울산,전남,141,9,20,8,24,4,206,161,11,15,8,26,9,230
2020-03-11,울산,전북,36,1,4,3,18,1,63,32,1,7,8,4,0,52
2020-03-11,울산,충남,95,3,16,47,143,2,306,69,4,8,33,103,3,220
2020-03-11,울산,충북,12,7,3,14,50,1,87,19,2,1,13,36,0,71
2020-03-11,전남,강원,13,1,2,1,6,0,23,26,2,4,6,12,1,51
2020-03-11,전남,경기,486,18,57,80,85,9,735,682,21,87,174,173,17,1154
2020-03-11,전남,경남,5171,271,417,434,1291,209,7793,5300,236,421,492,1339,223,8011
2020-03-11,전남,경북,674,37,70,69,294,21,1165,785,29,89,107,445,17,1472
2020-03-11,전남,광주,29952,965,967,628,1692,1226,35430,31492,1002,1166,763,1826,1250,37499
2020-03-11,전남,대구,378,20,27,33,77,9,544,384,17,31,34,37,9,512
2020-03-11,전남,대전,97,4,5,3,7,2,118,299,9,4,30,25,13,380
2020-03-11,전남,부산,1481,67,107,128,611,57,2451,1671,82,115,186,561,70,2685
2020-03-11,전남,서울,532,6,15,64,26,15,658,761,8,11,32,29,29,870
2020-03-11,전남,세종,65,1,2,2,10,3,83,141,3,2,7,18,1,172
2020-03-11,전남,울산,161,11,15,8,26,9,230,141,9,20,8,24,4,206
2020-03-11,전남,전남,41892,1343,1535,1633,4712,1728,52843,41892,1343,1535,1633,4712,1728,52843
2020-03-11,전남,전북,6263,338,673,840,2830,180,11124,4475,238,442,629,1300,127,7211
2020-03-11,전남,충남,1486,42,152,412,245,39,2376,4065,99,372,498,1024,130,6188
2020-03-11,전남,충북,129,13,16,25,70,3,256,352,23,45,110,250,14,794
2020-03-11,전북,강원,111,9,9,22,35,6,192,91,3,10,12,22,4,142
2020-03-11,전북,경기,1070,52,150,222,252,37,1783,1088,56,152,129,184,32,1641
2020-03-11,전북,경남,863,41,112,97,171,36,1320,890,45,128,92,165,34,1354
2020-03-11,전북,경북,1400,102,187,165,496,41,2391,1547,102,176,193,260,54,2332
2020-03-11,전북,광주,6776,436,465,367,391,271,8706,6695,434,516,362,380,270,8657
2020-03-11,전북,대구,176,4,35,18,25,3,261,191,16,36,22,21,9,295
2020-03-11,전북,대전,2887,86,98,92,63,128,3354,2751,78,96,77,50,148,3200
2020-03-11,전북,부산,192,7,28,32,53,8,320,237,10,29,36,95,11,418
2020-03-11,전북,서울,945,19,38,26,16,26,1070,1085,20,28,18,16,39,1206
2020-03-11,전북,세종,592,15,15,12,62,9,705,609,21,21,12,48,22,733
2020-03-11,전북,울산,32,1,7,8,4,0,52,36,1,4,3,18,1,63
2020-03-11,전북,전남,4475,238,442,629,1300,127,7211,6263,338,673,840,2830,180,11124
2020-03-11,전북,전북,15808,687,947,689,1228,560,19919,15808,687,947,689,1228,560,19919
2020-03-11,전북,충남,13457,596,1543,1412,2287,453,19748,11657,482,1332,1025,1342,376,16214
2020-03-11,전북,충북,1691,138,189,321,435,43,2817,1517,132,219,275,289,57,2489
2020-03-11,충남,강원,304,10,28,36,63,14,455,206,8,13,25,29,5,286
2020-03-11,충남,경기,32411,1498,2681,2424,4517,1650,45181,33627,1559,2800,2636,4790,1756,47168
2020-03-11,충남,경남,1101,60,162,342,536,46,2247,714,49,120,285,234,24,1426
2020-03-11,충남,경북,2219,137,373,538,797,92,4156,2112,161,353,591,608,91,3916
2020-03-11,충남,광주,3438,111,410,632,342,79,5012,3306,108,397,499,237,75,4622
2020-03-11,충남,대구,567,63,120,166,167,13,1096,906,74,137,217,258,29,1621
2020-03-11,충남,대전,13569,472,457,244,262,1033,16037,14889,484,530,279,248,1115,17545
2020-03-11,충남,부산,107,13,29,94,192,5,440,126,7,23,69,160,5,390
2020-03-11,충남,서울,22286,595,1837,1331,1198,916,28163,23148,509,1869,843,739,962,28070
2020-03-11,충남,세종,3992,153,141,126,179,207,4798,5306,165,154,143,214,302,6284
2020-03-11,충남,울산,69,4,8,33,103,3,220,95,3,16,47,143,2,306
2020-03-11,충남,전남,4065,99,372,498,1024,130,6188,1486,42,152,412,245,39,2376
2020-03-11,충남,전북,11657,482,1332,1025,1342,376,16214,13457,596,1543,1412,2287,453,19748
2020-03-11,충남,충남,84617,3517,7164,7230,10719,4082,117329,84617,3517,7164,7230,10719,4082,117329
2020-03-11,충남,충북,12260,680,892,1001,1536,704,17073,11044,667,810,828,1580,610,15539
2020-03-11,충북,강원,3836,210,220,230,295,220,5011,3695,216,240,224,360,233,4968
2020-03-11,충북,경기,23549,2198,2810,3017,3720,1135,36429,24387,2259,2955,3356,3603,1186,37746
2020-03-11,충북,경남,985,65,224,494,656,33,2457,774,62,114,280,283,29,1542
2020-03-11,충북,경북,3340,253,512,683,1018,130,5936,3479,244,485,717,905,123,5953
2020-03-11,충북,광주,491,36,97,179,111,13,927,438,24,67,112,81,8,730
2020-03-11,충북,대구,666,79,132,234,144,17,1272,994,102,173,246,440,32,1987
2020-03-11,충북,대전,9174,419,384,185,130,741,11033,10230,450,450,193,165,768,12256
2020-03-11,충북,부산,80,15,29,126,187,3,440,68,9,26,69,225,6,403
2020-03-11,충북,서울,11519,664,926,898,879,509,15395,12170,575,914,817,751,544,15771
2020-03-11,충북,세종,296,14,16,11,18,22,377,333,15,16,11,17,33,425
2020-03-11,충북,울산,19,2,1,13,36,0,71,12,7,3,14,50,1,87
2020-03-11,충북,전남,352,23,45,110,250,14,794,129,13,16,25,70,3,256
2020-03-11,충북,전북,1517,132,219,275,289,57,2489,1691,138,189,321,435,43,2817
2020-03-11,충북,충남,11044,667,810,828,1580,610,15539,12260,680,892,1001,1536,704,17073
2020-03-11,충북,충북,32770,1940,2246,2334,3230,1926,44446,32770,1940,2246,2334,3230,1926,44446
2020-03-12,강원,강원,56576,2318,2627,1400,2902,3878,69701,56576,2318,2627,1400,2902,3878,69701
2020-03-12,강원,경기,17583,600,990,759,775,815,21522,18763,630,923,870,935,898,23019
2020-03-12,강원,경남,107,4,5,14,17,2,149,65,3,8,19,17,1,113
2020-03-12,강원,경북,284,19,30,22,30,7,392,277,20,13,27,33,6,376
2020-03-12,강원,광주,60,2,15,11,13,1,102,64,4,12,16,2,1,99
2020-03-12,강원,대구,119,3,7,18,12,2,161,182,15,9,20,14,5,245
2020-03-12,강원,대전,109,2,19,1,3,2,136,125,2,19,4,2,8,160
2020-03-12,강원,부산,2,0,0,1,5,1,9,5,0,1,1,3,0,10
2020-03-12,강원,서울,706,14,154,19,27,24,944,751,16,125,5,8,26,931
2020-03-12,강원,세종,5,0,1,1,1,0,8,4,0,2,0,1,0,7
2020-03-12,강원,울산,0,0,0,0,0,0,0,1,0,0,0,0,0,1
2020-03-12,강원,전남,25,0,3,10,10,0,48,15,1,1,4,2,0,23
2020-03-12,강원,전북,92,3,9,9,23,1,137,119,7,21,20,35,2,204
2020-03-12,강원,충남,208,7,19,30,33,14,311,310,7,19,40,68,14,458
2020-03-12,강원,충북,3805,232,249,240,373,249,5148,4047,193,217,213,342,245,5257
2020-03-12,경기,강원,18763,630,923,870,935,898,23019,17583,600,990,759,775,815,21522
2020-03-12,경기,경기,416331,23391,24776,19915,25027,30596,540036,416331,23391,24776,19915,25027,30596,540036
2020-03-12,경기,경남,2124,92,286,763,634,59,3958,1581,68,227,573,430,56,2935
2020-03-12,경기,경북,2491,164,464,751,630,80,4580,2483,195,395,944,629,61,4707
2020-03-12,경기,광주,683,27,142,324,153,10,1339,594,20,131,287,132,19,1183
2020-03-12,경기,대구,994,81,154,374,220,27,1850,1673,105,167,477,485,46,2953
2020-03-12,경기,대전,1728,108,174,109,51,73,2243,1709,112,172,99,43,79,2214
2020-03-12,경기,부산,155,21,32,217,167,5,597,170,30,25,178,289,7,699
2020-03-12,경기,서울,144228,7317,8617,5465,4050,9466,179143,144406,6976,8996,4970,3734,9655,178737
2020-03-12,경기,세종,39,2,3,2,0,1,47,64,3,7,8,1,1,84
2020-03-12,경기,울산,15,2,3,10,14,0,44,27,4,12,45,75,0,163
2020-03-12,경기,전남,645,27,81,192,201,20,1166,564,20,65,126,102,20,897
2020-03-12,경기,전북,1087,41,155,137,192,32,1644,1152,50,139,197,261,49,1848
2020-03-12,경기,충남,34530,1625,2847,2785,4659,1789,48235,34322,1575,2703,2585,4456,1718,47359
2020-03-12,경기,충북,24853,2237,2988,3296,3696,1184,38254,24256,2181,2812,2947,3820,1154,37170
2020-03-12,경남,강원,65,3,8,19,17,1,113,107,4,5,14,17,2,149
2020-03-12,경남,경기,1581,68,227,573,430,56,2935,2124,92,286,763,634,59,3958
2020-03-12,경남,경남,178934,9957,9520,7699,13698,13560,233368,178934,9957,9520,7699,13698,13560,233368
2020-03-12,경남,경북,7285,584,895,911,1838,320,11833,9204,820,1100,1243,2740,387,15494
2020-03-12,경남,광주,874,46,124,187,170,32,1433,839,41,145,143,129,37,1334
2020-03-12,경남,대구,8968,699,824,989,1803,336,13619,6975,493,553,369,469,299,9158
2020-03-12,경남,대전,580,20,89,75,36,15,815,816,35,84,130,70,35,1170
2020-03-12,경남,부산,80504,2600,2508,1869,5097,5842,98420,80164,2656,2767,1946,5264,5783,98580
2020-03-12,경남,서울,1618,43,293,293,127,48,2422,2207,46,298,199,121,72,2943
2020-03-12,경남,세종,128,4,5,11,3,5,156,198,5,11,11,14,4,243
2020-03-12,경남,울산,8485,638,683,487,702,541,11536,8054,586,699,435,656,509,10939
2020-03-12,경남,전남,5246,264,425,507,1365,236,8043,5289,294,418,435,1286,245,7967
2020-03-12,경남,전북,889,42,105,101,189,43,1369,893,42,108,112,159,32,1346
2020-03-12,경남,충남,894,53,114,266,270,28,1625,1340,72,148,338,557,40,2495
2020-03-12,경남,충북,858,63,129,287,323,24,1684,1118,74,175,503,657,34,2561
2020-03-12,경북,강원,277,20,13,27,33,6,376,284,19,30,22,30,7,392
2020-03-12,경북,경기,2483,195,395,944,629,61,4707,2491,164,464,751,630,80,4580
2020-03-12,경북,경남,9204,820,1100,1243,2740,387,15494,7285,584,895,911,1838,320,11833
2020-03-12,경북,경북,60401,3810,3820,3053,5431,3279,79794,60401,3810,3820,3053,5431,3279,79794
2020-03-12,경북,광주,554,46,100,180,140,19,1039,481,41,85,162,89,8,866
2020-03-12,경북,대구,58084,2868,2226,1613,3118,3104,71013,61040,3042,2593,1977,3674,3128,75454
2020-03-12,경북,대전,1229,64,89,110,89,53,1634,1337,67,83,114,59,52,1712
2020-03-12,경북,부산,3162,122,192,226,741,152,4595,3420,136,204,233,930,191,5114
2020-03-12,경북,서울,1751,121,241,437,155,53,2758,1809,85,217,260,128,58,2557
2020-03-12,경북,세종,193,7,16,24,21,6,267,185,9,14,24,19,6,257
2020-03-12,경북,울산,3926,169,291,441,1124,261,6212,4014,147,304,355,1462,234,6516
2020-03-12,경북,전남,904,47,89,116,439,24,1619,696,32,58,83,305,16,1190
2020-03-12,경북,전북,1519,97,168,192,260,50,2286,1509,108,176,184,495,51,2523
2020-03-12,경북,충남,2233,148,319,590,604,84,3978,2431,131,347,490,814,91,4304
2020-03-12,경북,충북,3619,230,491,737,932,131,6140,3520,259,516,663,1044,134,6136
2020-03-12,광주,강원,64,4,12,16,2,1,99,60,2,15,11,13,1,102
2020-03-12,광주,경기,594,20,131,287,132,19,1183,683,27,142,324,153,10,1339
2020-03-12,광주,경남,839,41,145,143,129,37,1334,874,46,124,187,170,32,1433
2020-03-12,광주,경북,481,41,85,162,89,8,866,554,46,100,180,140,19,1039
2020-03-12,광주,광주,13392,487,624,412,371,557,15843,13392,487,624,412,371,557,15843
2020-03-12,광주,대구,355,23,60,82,27,8,555,323,30,60,61,25,10,509
2020-03-12,광주,대전,352,18,11,21,13,9,424,413,12,11,26,17,11,490
2020-03-12,광주,부산,333,9,43,51,68,10,514,348,17,52,76,100,9,602
2020-03-12,광주,서울,568,17,21,77,21,19,723,635,18,19,53,14,28,767
2020-03-12,광주,세종,84,1,11,2,5,5,108,119,0,7,9,1,5,141
2020-03-12,광주,울산,34,4,9,7,3,2,59,41,2,7,6,2,0,58
2020-03-12,광주,전남,32834,1004,1101,682,2256,1286,39163,31593,956,960,634,2127,1253,37523
2020-03-12,광주,전북,7057,429,531,349,377,256,8999,7076,450,472,304,424,274,9000
2020-03-12,광주,충남,3360,101,410,467,252,74,4664,3687,126,426,604,369,82,5294
2020-03-12,광주,충북,439,30,58,100,80,8,715,475,38,95,162,101,8,879
2020-03-12,대구,강원,182,15,9,20,14,5,245,119,3,7,18,12,2,161
2020-03-12,대구,경기,1673,105,167,477,485,46,2953,994,81,154,374,220,27,1850
2020-03-12,대구,경남,6975,493,553,369,469,299,9158,8968,699,824,989,1803,336,13619
2020-03-12,대구,경북,61040,3042,2593,1977,3674,3128,75454,58084,2868,2226,1613,3118,3104,71013
2020-03-12,대구,광주,323,30,60,61,25,10,509,355,23,60,82,27,8,555
2020-03-12,대구,대구,51027,2049,1642,815,1374,3362,60269,51027,2049,1642,815,1374,3362,60269
2020-03-12,대구,대전,500,31,25,67,43,25,691,346,23,23,55,20,14,481
2020-03-12,대구,부산,408,37,105,78,118,19,765,1931,88,169,99,244,79,2610
2020-03-12,대구,서울,1521,57,89,203,106,49,2025,936,56,63,137,50,22,1264
2020-03-12,대구,세종,122,6,7,3,11,5,154,76,3,4,1,3,2,89
2020-03-12,대구,울산,703,47,72,72,166,33,1093,682,43,71,57,181,30,1064
2020-03-12,대구,전남,388,13,39,30,36,9,515,409,19,40,22,48,6,544
2020-03-12,대구,전북,195,18,31,25,32,4,305,201,16,25,21,24,5,292
2020-03-12,대구,충남,908,65,121,235,248,19,1596,614,58,104,160,205,17,1158
2020-03-12,대구,충북,1055,87,169,274,443,28,2056,678,84,132,252,133,19,1298
2020-03-12,대전,강원,125,2,19,4,2,8,160,109,2,19,1,3,2,136
2020-03-12,대전,경기,1709,112,172,99,43,79,2214,1728,108,174,109,51,73,2243
2020-03-12,대전,경남,816,35,84,130,70,35,1170,580,20,89,75,36,15,815
2020-03-12,대전,경북,1337,67,83,114,59,52,1712,1229,64,89,110,89,53,1634
2020-03-12,대전,광주,413,12,11,26,17,11,490,352,18,11,21,13,9,424
2020-03-12,대전,대구,346,23,23,55,20,14,481,500,31,25,67,43,25,691
2020-03-12,대전,대전,13433,414,390,227,201,994,15659,13433,414,390,227,201,994,15659
2020-03-12,대전,부산,52,4,3,20,14,1,94,46,2,10,20,23,0,101
2020-03-12,대전,서울,1508,48,133,35,9,80,1813,1554,51,133,36,11,70,1855
2020-03-12,대전,세종,3208,108,76,27,55,244,3718,3160,118,57,36,67,236,3674
2020-03-12,대전,울산,67,2,4,17,22,3,115,56,3,2,12,21,1,95
2020-03-12,대전,전남,336,10,8,27,24,10,415,107,7,7,13,5,3,142
2020-03-12,대전,전북,2750,89,90,81,56,127,3193,2852,114,85,85,69,135,3340
2020-03-12,대전,충남,15134,462,530,270,216,1116,17728,13546,453,463,233,223,1062,15980
2020-03-12,대전,충북,10383,458,412,218,162,754,12387,9281,396,377,185,119,688,11046
2020-03-12,부산,강원,5,0,1,1,3,0,10,2,0,0,1,5,1,9
2020-03-12,부산,경기,170,30,25,178,289,7,699,155,21,32,217,167,5,597
2020-03-12,부산,경남,80164,2656,2767,1946,5264,5783,98580,80504,2600,2508,1869,5097,5842,98420
2020-03-12,부산,경북,3420,136,204,233,930,191,5114,3162,122,192,226,741,152,4595
2020-03-12,부산,광주,348,17,52,76,100,9,602,333,9,43,51,68,10,514
2020-03-12,부산,대구,1931,88,169,99,244,79,2610,408,37,105,78,118,19,765
2020-03-12,부산,대전,46,2,10,20,23,0,101,52,4,3,20,14,1,94
2020-03-12,부산,부산,41051,701,586,752,2285,3045,48420,41051,701,586,752,2285,3045,48420
2020-03-12,부산,서울,179,19,20,92,66,6,382,193,9,11,72,55,3,343
2020-03-12,부산,세종,9,0,1,4,4,0,18,15,0,0,1,1,0,17
2020-03-12,부산,울산,14286,365,495,667,2784,1021,19618,14239,387,453,432,2562,1046,19119
2020-03-12,부산,전남,1634,89,121,203,546,77,2670,1562,68,104,142,598,67,2541
2020-03-12,부산,전북,182,9,26,39,100,13,369,186,10,22,47,60,2,327
2020-03-12,부산,충남,128,20,18,74,173,3,416,124,18,18,93,212,7,472
2020-03-12,부산,충북,103,13,31,104,211,10,472,93,14,27,121,208,5,468
2020-03-12,서울,강원,751,16,125,5,8,26,931,706,14,154,19,27,24,944
2020-03-12,서울,경기,144406,6976,8996,4970,3734,9655,178737,144228,7317,8617,5465,4050,9466,179143
2020-03-12,서울,경남,2207,46,298,199,121,72,2943,1618,43,293,293,127,48,2422
2020-03-12,서울,경북,1809,85,217,260,128,58,2557,1751,121,241,437,155,53,2758
2020-03-12,서울,광주,635,18,19,53,14,28,767,568,17,21,77,21,19,723
2020-03-12,서울,대구,936,56,63,137,50,22,1264,1521,57,89,203,106,49,2025
2020-03-12,서울,대전,1554,51,133,36,11,70,1855,1508,48,133,35,9,80,1813
2020-03-12,서울,부산,193,9,11,72,55,3,343,179,19,20,92,66,6,382
2020-03-12,서울,서울,226,12,11,6,1,9,265,226,12,11,6,1,9,265
2020-03-12,서울,세종,23,1,1,2,0,1,28,36,0,2,1,0,0,39
2020-03-12,서울,울산,28,1,3,4,1,0,37,21,1,4,13,16,2,57
2020-03-12,서울,전남,845,9,23,51,22,28,978,634,10,32,69,40,18,803
2020-03-12,서울,전북,1157,22,36,32,17,35,1299,1078,36,43,42,28,45,1272
2020-03-12,서울,충남,23786,537,1890,864,828,979,28884,24125,622,1865,1341,1291,942,30186
2020-03-12,서울,충북,12486,540,942,812,762,494,16036,12028,669,950,856,911,497,15911
2020-03-12,세종,강원,4,0,2,0,1,0,7,5,0,1,1,1,0,8
2020-03-12,세종,경기,64,3,7,8,1,1,84,39,2,3,2,0,1,47
2020-03-12,세종,경남,198,5,11,11,14,4,243,128,4,5,11,3,5,156
2020-03-12,세종,경북,185,9,14,24,19,6,257,193,7,16,24,21,6,267
2020-03-12,세종,광주,119,0,7,9,1,5,141,84,1,11,2,5,5,108
2020-03-12,세종,대구,76,3,4,1,3,2,89,122,6,7,3,11,5,154
2020-03-12,세종,대전,3160,118,57,36,67,236,3674,3208,108,76,27,55,244,3718
2020-03-12,세종,부산,15,0,0,1,1,0,17,9,0,1,4,4,0,18
2020-03-12,세종,서울,36,0,2,1,0,0,39,23,1,1,2,0,1,28
2020-03-12,세종,세종,222,21,4,1,2,14,264,222,21,4,1,2,14,264
2020-03-12,세종,울산,3,0,1,0,4,0,8,5,1,0,2,9,0,17
2020-03-12,세종,전남,125,3,5,8,17,5,163,85,2,4,3,12,3,109
2020-03-12,세종,전북,618,17,26,20,34,30,745,636,21,22,35,41,21,776
2020-03-12,세종,충남,5456,159,144,132,199,319,6409,4065,146,143,127,178,227,4886
2020-03-12,세종,충북,356,14,23,20,11,28,452,311,14,12,10,24,23,394
2020-03-12,울산,강원,1,0,0,0,0,0,1,0,0,0,0,0,0,0
2020-03-12,울산,경기,27,4,12,45,75,0,163,15,2,3,10,14,0,44
2020-03-12,울산,경남,8054,586,699,435,656,509,10939,8485,638,683,487,702,541,11536
2020-03-12,울산,경북,4014,147,304,355,1462,234,6516,3926,169,291,441,1124,261,6212
2020-03-12,울산,광주,41,2,7,6,2,0,58,34,4,9,7,3,2,59
2020-03-12,울산,대구,682,43,71,57,181,30,1064,703,47,72,72,166,33,1093
2020-03-12,울산,대전,56,3,2,12,21,1,95,67,2,4,17,22,3,115
2020-03-12,울산,부산,14239,387,453,432,2562,1046,19119,14286,365,495,667,2784,1021,19618
2020-03-12,울산,서울,21,1,4,13,16,2,57,28,1,3,4,1,0,37
2020-03-12,울산,세종,5,1,0,2,9,0,17,3,0,1,0,4,0,8
2020-03-12,울산,울산,7484,312,484,309,567,657,9813,7484,312,484,309,567,657,9813
2020-03-12,울산,전남,156,7,25,11,44,3,246,172,14,30,8,52,4,280
2020-03-12,울산,전북,28,5,4,7,11,1,56,36,0,5,6,6,1,54
2020-03-12,울산,충남,107,3,15,43,129,1,298,91,3,10,27,107,1,239
2020-03-12,울산,충북,11,4,4,25,45,1,90,9,1,2,12,34,0,58
2020-03-12,전남,강원,15,1,1,4,2,0,23,25,0,3,10,10,0,48
2020-03-12,전남,경기,564,20,65,126,102,20,897,645,27,81,192,201,20,1166
2020-03-12,전남,경남,5289,294,418,435,1286,245,7967,5246,264,425,507,1365,236,8043
2020-03-12,전남,경북,696,32,58,83,305,16,1190,904,47,89,116,439,24,1619
2020-03-12,전남,광주,31593,956,960,634,2127,1253,37523,32834,1004,1101,682,2256,1286,39163
2020-03-12,전남,대구,409,19,40,22,48,6,544,388,13,39,30,36,9,515
2020-03-12,전남,대전,107,7,7,13,5,3,142,336,10,8,27,24,10,415
2020-03-12,전남,부산,1562,68,104,142,598,67,2541,1634,89,121,203,546,77,2670
2020-03-12,전남,서울,634,10,32,69,40,18,803,845,9,23,51,22,28,978
2020-03-12,전남,세종,85,2,4,3,12,3,109,125,3,5,8,17,5,163
2020-03-12,전남,울산,172,14,30,8,52,4,280,156,7,25,11,44,3,246
2020-03-12,전남,전남,43264,1397,1581,1613,5122,1765,54742,43264,1397,1581,1613,5122,1765,54742
2020-03-12,전남,전북,7040,328,699,850,2782,224,11923,4895,235,439,617,1359,134,7679
2020-03-12,전남,충남,1646,55,190,445,270,42,2648,4438,83,401,558,995,125,6600
2020-03-12,전남,충북,131,14,25,42,54,2,268,354,24,44,114,252,10,798
2020-03-12,전북,강원,119,7,21,20,35,2,204,92,3,9,9,23,1,137
2020-03-12,전북,경기,1152,50,139,197,261,49,1848,1087,41,155,137,192,32,1644
2020-03-12,전북,경남,893,42,108,112,159,32,1346,889,42,105,101,189,43,1369
2020-03-12,전북,경북,1509,108,176,184,495,51,2523,1519,97,168,192,260,50,2286
2020-03-12,전북,광주,7076,450,472,304,424,274,9000,7057,429,531,349,377,256,8999
2020-03-12,전북,대구,201,16,25,21,24,5,292,195,18,31,25,32,4,305
2020-03-12,전북,대전,2852,114,85,85,69,135,3340,2750,89,90,81,56,127,3193
2020-03-12,전북,부산,186,10,22,47,60,2,327,182,9,26,39,100,13,369
2020-03-12,전북,서울,1078,36,43,42,28,45,1272,1157,22,36,32,17,35,1299
2020-03-12,전북,세종,636,21,22,35,41,21,776,618,17,26,20,34,30,745
2020-03-12,전북,울산,36,0,5,6,6,1,54,28,5,4,7,11,1,56
2020-03-12,전북,전남,4895,235,439,617,1359,134,7679,7040,328,699,850,2782,224,11923
2020-03-12,전북,전북,16790,756,993,791,1369,614,21313,16790,756,993,791,1369,614,21313
2020-03-12,전북,충남,14593,601,1584,1431,2457,451,21117,11939,543,1340,992,1472,418,16704
2020-03-12,전북,충북,1703,136,232,324,441,62,2898,1542,144,207,275,299,47,2514
2020-03-12,충남,강원,310,7,19,40,68,14,458,208,7,19,30,33,14,311
2020-03-12,충남,경기,34322,1575,2703,2585,4456,1718,47359,34530,1625,2847,2785,4659,1789,48235
2020-03-12,충남,경남,1340,72,148,338,557,40,2495,894,53,114,266,270,28,1625
2020-03-12,충남,경북,2431,131,347,490,814,91,4304,2233,148,319,590,604,84,3978
2020-03-12,충남,광주,3687,126,426,604,369,82,5294,3360,101,410,467,252,74,4664
2020-03-12,충남,대구,614,58,104,160,205,17,1158,908,65,121,235,248,19,1596
2020-03-12,충남,대전,13546,453,463,233,223,1062,15980,15134,462,530,270,216,1116,17728
2020-03-12,충남,부산,124,18,18,93,212,7,472,128,20,18,74,173,3,416
2020-03-12,충남,서울,24125,622,1865,1341,1291,942,30186,23786,537,1890,864,828,979,28884
2020-03-12,충남,세종,4065,146,143,127,178,227,4886,5456,159,144,132,199,319,6409
2020-03-12,충남,울산,91,3,10,27,107,1,239,107,3,15,43,129,1,298
2020-03-12,충남,전남,4438,83,401,558,995,125,6600,1646,55,190,445,270,42,2648
2020-03-12,충남,전북,11939,543,1340,992,1472,418,16704,14593,601,1584,1431,2457,451,21117
2020-03-12,충남,충남,89319,3672,7355,7183,11189,4213,122931,89319,3672,7355,7183,11189,4213,122931
2020-03-12,충남,충북,12560,665,870,1007,1552,690,17344,11320,642,809,870,1525,608,15774
2020-03-12,충북,강원,4047,193,217,213,342,245,5257,3805,232,249,240,373,249,5148
2020-03-12,충북,경기,24256,2181,2812,2947,3820,1154,37170,24853,2237,2988,3296,3696,1184,38254
2020-03-12,충북,경남,1118,74,175,503,657,34,2561,858,63,129,287,323,24,1684
2020-03-12,충북,경북,3520,259,516,663,1044,134,6136,3619,230,491,737,932,131,6140
2020-03-12,충북,광주,475,38,95,162,101,8,879,439,30,58,100,80,8,715
2020-03-12,충북,대구,678,84,132,252,133,19,1298,1055,87,169,274,443,28,2056
2020-03-12,충북,대전,9281,396,377,185,119,688,11046,10383,458,412,218,162,754,12387
2020-03-12,충북,부산,93,14,27,121,208,5,468,103,13,31,104,211,10,472
2020-03-12,충북,서울,12028,669,950,856,911,497,15911,12486,540,942,812,762,494,16036
2020-03-12,충북,세종,311,14,12,10,24,23,394,356,14,23,20,11,28,452
2020-03-12,충북,울산,9,1,2,12,34,0,58,11,4,4,25,45,1,90
2020-03-12,충북,전남,354,24,44,114,252,10,798,131,14,25,42,54,2,268
2020-03-12,충북,전북,1542,144,207,275,299,47,2514,1703,136,232,324,441,62,2898
2020-03-12,충북,충남,11320,642,809,870,1525,608,15774,12560,665,870,1007,1552,690,17344
2020-03-12,충북,충북,33394,2004,2323,2268,3346,1995,45330,33394,2004,2323,2268,3346,1995,45330
2020-03-13,강원,강원,68405,2193,2468,1493,2861,4387,81807,68405,2193,2468,1493,2861,4387,81807
2020-03-13,강원,경기,20832,584,935,699,722,991,24763,28197,618,901,737,911,1253,32617
2020-03-13,강원,경남,137,6,9,11,17,7,187,125,2,7,21,24,6,185
2020-03-13,강원,경북,357,20,22,28,28,20,475,376,20,21,24,41,11,493
2020-03-13,강원,광주,94,1,13,6,12,3,129,74,2,10,13,8,2,109
2020-03-13,강원,대구,154,6,9,12,13,3,197,225,4,10,19,14,5,277
2020-03-13,강원,대전,157,4,19,5,5,9,199,169,5,21,6,2,5,208
2020-03-13,강원,부산,6,0,0,0,0,0,6,3,0,0,1,4,1,9
2020-03-13,강원,서울,785,12,198,17,16,21,1049,953,22,176,13,11,28,1203
2020-03-13,강원,세종,6,0,0,0,1,1,8,7,1,0,0,1,0,9
2020-03-13,강원,울산,3,0,1,0,1,0,5,2,0,0,0,0,0,2
2020-03-13,강원,전남,47,3,7,6,13,4,80,19,1,2,1,4,0,27
2020-03-13,강원,전북,124,7,11,8,16,1,167,156,8,7,24,29,5,229
2020-03-13,강원,충남,285,6,20,25,45,22,403,475,9,16,42,61,27,630
2020-03-13,강원,충북,4537,217,249,232,407,292,5934,4930,193,208,241,351,298,6221
2020-03-13,경기,강원,28197,618,901,737,911,1253,32617,20832,584,935,699,722,991,24763
2020-03-13,경기,경기,437792,23448,24970,20934,24559,32157,563860,437792,23448,24970,20934,24559,32157,563860
2020-03-13,경기,경남,3159,87,277,751,603,137,5014,2293,64,235,527,458,90,3667
2020-03-13,경기,경북,3477,197,450,777,611,138,5650,3826,193,424,942,590,119,6094
2020-03-13,경기,광주,1102,41,131,332,142,31,1779,765,31,108,235,135,15,1289
2020-03-13,경기,대구,1360,86,136,399,205,49,2235,2245,124,139,461,473,65,3507
2020-03-13,경기,대전,2634,96,190,110,67,133,3230,2094,100,166,106,53,96,2615
2020-03-13,경기,부산,268,19,33,194,178,7,699,273,16,32,150,270,12,753
2020-03-13,경기,서울,151783,7211,8673,5233,3956,10246,187102,145016,6848,8828,4959,3621,9799,179071
2020-03-13,경기,세종,40,2,4,5,0,0,51,42,2,4,3,1,5,57
2020-03-13,경기,울산,36,1,1,12,17,1,68,41,3,8,30,70,3,155
2020-03-13,경기,전남,1129,30,73,171,169,38,1610,731,13,60,94,75,28,1001
2020-03-13,경기,전북,1848,50,152,127,195,45,2417,1531,59,151,202,253,63,2259
2020-03-13,경기,충남,40731,1544,2785,2642,4601,2228,54531,41706,1498,2647,2504,4369,2215,54939
2020-03-13,경기,충북,29541,2329,2948,3305,3636,1524,43283,28817,2205,2731,2992,3768,1402,41915
2020-03-13,경남,강원,125,2,7,21,24,6,185,137,6,9,11,17,7,187
2020-03-13,경남,경기,2293,64,235,527,458,90,3667,3159,87,277,751,603,137,5014
2020-03-13,경남,경남,194755,10051,9684,7375,14124,14369,250358,194755,10051,9684,7375,14124,14369,250358
2020-03-13,경남,경북,8732,585,907,880,1807,397,13308,12037,842,1151,1228,2748,566,18572
2020-03-13,경남,광주,1301,53,106,176,158,55,1849,1119,38,140,161,113,35,1606
2020-03-13,경남,대구,10760,711,804,1044,1684,433,15436,8250,474,542,432,551,342,10591
2020-03-13,경남,대전,931,21,81,71,27,31,1162,1056,40,81,106,61,46,1390
2020-03-13,경남,부산,88587,2662,2613,1720,5001,6089,106672,85810,2742,2697,1773,5204,5982,104208
2020-03-13,경남,서울,2146,35,321,279,140,68,2989,2619,39,338,184,120,88,3388
2020-03-13,경남,세종,222,3,11,15,6,14,271,298,3,16,12,12,8,349
2020-03-13,경남,울산,9759,654,661,487,739,605,12905,9428,612,696,475,656,594,12461
2020-03-13,경남,전남,6403,247,414,504,1453,302,9323,6712,302,427,451,1383,312,9587
2020-03-13,경남,전북,1239,44,124,97,184,52,1740,1187,58,117,105,184,48,1699
2020-03-13,경남,충남,1118,47,125,285,237,41,1853,2119,65,168,304,528,98,3282
2020-03-13,경남,충북,1113,57,112,258,272,46,1858,1708,64,196,472,685,76,3201
2020-03-13,경북,강원,376,20,21,24,41,11,493,357,20,22,28,28,20,475
2020-03-13,경북,경기,3826,193,424,942,590,119,6094,3477,197,450,777,611,138,5650
2020-03-13,경북,경남,12037,842,1151,1228,2748,566,18572,8732,585,907,880,1807,397,13308
2020-03-13,경북,경북,64903,3904,3922,3027,5463,3359,84578,64903,3904,3922,3027,5463,3359,84578
2020-03-13,경북,광주,907,49,114,177,152,19,1418,637,44,91,150,97,20,1039
2020-03-13,경북,대구,62410,2909,2275,1885,3393,3199,76071,63653,3078,2693,2157,4017,3192,78790
2020-03-13,경북,대전,1703,65,105,107,90,75,2145,1498,60,101,119,76,64,1918
2020-03-13,경북,부산,4338,122,202,213,720,193,5788,4040,125,238,213,870,180,5666
2020-03-13,경북,서울,2408,101,249,324,143,86,3311,2349,82,240,225,114,81,3091
2020-03-13,경북,세종,288,4,18,30,12,11,363,267,5,8,20,12,7,319
2020-03-13,경북,울산,4702,176,298,427,1104,269,6976,4725,162,311,348,1360,280,7186
2020-03-13,경북,전남,1099,51,81,105,426,42,1804,801,44,78,72,285,28,1308
2020-03-13,경북,전북,1812,96,174,165,256,60,2563,1656,106,175,164,499,49,2649
2020-03-13,경북,충남,2886,165,353,568,612,113,4697,3141,149,371,540,791,142,5134
2020-03-13,경북,충북,4498,236,462,698,988,183,7065,4262,252,465,646,1075,174,6874
2020-03-13,광주,강원,74,2,10,13,8,2,109,94,1,13,6,12,3,129
2020-03-13,광주,경기,765,31,108,235,135,15,1289,1102,41,131,332,142,31,1779
2020-03-13,광주,경남,1119,38,140,161,113,35,1606,1301,53,106,176,158,55,1849
2020-03-13,광주,경북,637,44,91,150,97,20,1039,907,49,114,177,152,19,1418
2020-03-13,광주,광주,13942,476,585,412,318,604,16337,13942,476,585,412,318,604,16337
2020-03-13,광주,대구,433,20,59,72,19,7,610,474,21,67,60,19,8,649
2020-03-13,광주,대전,472,18,18,18,11,14,551,556,18,21,24,16,17,652
2020-03-13,광주,부산,363,9,38,28,75,8,521,505,14,50,78,117,11,775
2020-03-13,광주,서울,721,25,15,61,25,15,862,1058,25,21,46,17,29,1196
2020-03-13,광주,세종,147,1,11,2,3,3,167,249,2,9,7,3,8,278
2020-03-13,광주,울산,53,2,4,5,3,0,67,59,2,2,7,16,1,87
2020-03-13,광주,전남,34305,1024,1100,832,2042,1398,40701,34596,996,1021,762,2066,1367,40808
2020-03-13,광주,전북,7679,444,513,349,387,298,9670,8209,478,458,352,416,290,10203
2020-03-13,광주,충남,4338,122,462,449,232,120,5723,5348,118,444,577,365,119,6971
2020-03-13,광주,충북,554,27,72,103,66,18,840,803,38,85,177,110,22,1235
2020-03-13,대구,강원,225,4,10,19,14,5,277,154,6,9,12,13,3,197
2020-03-13,대구,경기,2245,124,139,461,473,65,3507,1360,86,136,399,205,49,2235
2020-03-13,대구,경남,8250,474,542,432,551,342,10591,10760,711,804,1044,1684,433,15436
2020-03-13,대구,경북,63653,3078,2693,2157,4017,3192,78790,62410,2909,2275,1885,3393,3199,76071
2020-03-13,대구,광주,474,21,67,60,19,8,649,433,20,59,72,19,7,610
2020-03-13,대구,대구,52976,2087,1652,871,1278,3436,62300,52976,2087,1652,871,1278,3436,62300
2020-03-13,대구,대전,799,30,23,65,39,20,976,449,23,18,50,26,17,583
2020-03-13,대구,부산,516,66,104,68,139,25,918,2216,81,161,87,240,82,2867
2020-03-13,대구,서울,2205,50,100,241,109,66,2771,1152,52,63,117,60,35,1479
2020-03-13,대구,세종,209,3,4,7,9,6,238,134,0,3,3,6,3,149
2020-03-13,대구,울산,867,52,77,80,164,36,1276,957,38,71,85,163,41,1355
2020-03-13,대구,전남,418,14,33,25,36,14,540,452,22,31,24,60,15,604
2020-03-13,대구,전북,248,15,18,18,29,7,335,238,12,22,11,26,10,319
2020-03-13,대구,충남,1082,75,120,194,239,36,1746,819,53,107,160,180,28,1347
2020-03-13,대구,충북,1375,90,165,270,421,56,2377,963,78,135,229,146,28,1579
2020-03-13,대전,강원,169,5,21,6,2,5,208,157,4,19,5,5,9,199
2020-03-13,대전,경기,2094,100,166,106,53,96,2615,2634,96,190,110,67,133,3230
2020-03-13,대전,경남,1056,40,81,106,61,46,1390,931,21,81,71,27,31,1162
2020-03-13,대전,경북,1498,60,101,119,76,64,1918,1703,65,105,107,90,75,2145
2020-03-13,대전,광주,556,18,21,24,16,17,652,472,18,18,18,11,14,551
2020-03-13,대전,대구,449,23,18,50,26,17,583,799,30,23,65,39,20,976
2020-03-13,대전,대전,13434,406,403,428,263,999,15933,13434,406,403,428,263,999,15933
2020-03-13,대전,부산,89,3,4,11,20,2,129,91,4,9,16,28,2,150
2020-03-13,대전,서울,1819,41,150,35,10,87,2142,2144,42,150,37,7,73,2453
2020-03-13,대전,세종,3261,95,81,24,61,235,3757,3332,118,82,30,60,252,3874
2020-03-13,대전,울산,102,2,4,18,22,6,154,155,4,6,16,24,7,212
2020-03-13,대전,전남,381,8,2,24,28,9,452,139,2,4,7,7,7,166
2020-03-13,대전,전북,3028,64,100,68,61,141,3462,3314,92,94,86,90,144,3820
2020-03-13,대전,충남,15526,538,494,255,230,1163,18206,14792,467,451,222,235,1063,17230
2020-03-13,대전,충북,10774,418,420,201,174,790,12777,10236,374,376,180,154,777,12097
2020-03-13,부산,강원,3,0,0,1,4,1,9,6,0,0,0,0,0,6
2020-03-13,부산,경기,273,16,32,150,270,12,753,268,19,33,194,178,7,699
2020-03-13,부산,경남,85810,2742,2697,1773,5204,5982,104208,88587,2662,2613,1720,5001,6089,106672
2020-03-13,부산,경북,4040,125,238,213,870,180,5666,4338,122,202,213,720,193,5788
2020-03-13,부산,광주,505,14,50,78,117,11,775,363,9,38,28,75,8,521
2020-03-13,부산,대구,2216,81,161,87,240,82,2867,516,66,104,68,139,25,918
2020-03-13,부산,대전,91,4,9,16,28,2,150,89,3,4,11,20,2,129
2020-03-13,부산,부산,43736,704,687,532,2228,3220,51107,43736,704,687,532,2228,3220,51107
2020-03-13,부산,서울,243,12,21,76,54,5,411,203,10,17,65,26,6,327
2020-03-13,부산,세종,20,0,3,4,0,0,27,23,1,1,3,3,2,33
2020-03-13,부산,울산,15360,366,477,686,2616,1088,20593,16926,385,449,487,2513,1234,21994
2020-03-13,부산,전남,2179,84,114,196,530,77,3180,1781,80,105,130,556,86,2738
2020-03-13,부산,전북,319,9,37,40,110,14,529,217,9,23,41,79,12,381
2020-03-13,부산,충남,127,6,23,61,174,7,398,183,9,38,78,159,5,472
2020-03-13,부산,충북,133,6,21,94,222,3,479,149,17,21,133,193,8,521
2020-03-13,서울,강원,953,22,176,13,11,28,1203,785,12,198,17,16,21,1049
2020-03-13,서울,경기,145016,6848,8828,4959,3621,9799,179071,151783,7211,8673,5233,3956,10246,187102
2020-03-13,서울,경남,2619,39,338,184,120,88,3388,2146,35,321,279,140,68,2989
2020-03-13,서울,경북,2349,82,240,225,114,81,3091,2408,101,249,324,143,86,3311
2020-03-13,서울,광주,1058,25,21,46,17,29,1196,721,25,15,61,25,15,862
2020-03-13,서울,대구,1152,52,63,117,60,35,1479,2205,50,100,241,109,66,2771
2020-03-13,서울,대전,2144,42,150,37,7,73,2453,1819,41,150,35,10,87,2142
2020-03-13,서울,부산,203,10,17,65,26,6,327,243,12,21,76,54,5,411
2020-03-13,서울,서울,211,2,15,4,1,8,241,211,2,15,4,1,8,241
2020-03-13,서울,세종,37,0,1,0,2,0,40,40,2,1,1,1,5,50
2020-03-13,서울,울산,27,0,3,3,1,1,35,24,0,2,13,8,1,48
2020-03-13,서울,전남,1176,12,19,33,24,43,1307,810,13,16,50,31,30,950
2020-03-13,서울,전북,1745,17,41,23,34,55,1915,1553,28,52,43,35,47,1758
2020-03-13,서울,충남,29056,535,1952,895,851,1169,34458,28597,619,1980,1260,1345,1197,34998
2020-03-13,서울,충북,14412,506,923,833,696,627,17997,15321,601,973,859,867,629,19250
2020-03-13,세종,강원,7,1,0,0,1,0,9,6,0,0,0,1,1,8
2020-03-13,세종,경기,42,2,4,3,1,5,57,40,2,4,5,0,0,51
2020-03-13,세종,경남,298,3,16,12,12,8,349,222,3,11,15,6,14,271
2020-03-13,세종,경북,267,5,8,20,12,7,319,288,4,18,30,12,11,363
2020-03-13,세종,광주,249,2,9,7,3,8,278,147,1,11,2,3,3,167
2020-03-13,세종,대구,134,0,3,3,6,3,149,209,3,4,7,9,6,238
2020-03-13,세종,대전,3332,118,82,30,60,252,3874,3261,95,81,24,61,235,3757
2020-03-13,세종,부산,23,1,1,3,3,2,33,20,0,3,4,0,0,27
2020-03-13,세종,서울,40,2,1,1,1,5,50,37,0,1,0,2,0,40
2020-03-13,세종,세종,211,29,1,0,1,24,266,211,29,1,0,1,24,266
2020-03-13,세종,울산,11,0,0,2,4,0,17,8,0,3,2,6,0,19
2020-03-13,세종,전남,196,1,7,4,14,3,225,147,1,0,6,5,6,165
2020-03-13,세종,전북,745,21,35,17,41,23,882,781,16,17,26,49,30,919
2020-03-13,세종,충남,5820,155,162,129,188,324,6778,4787,159,168,114,175,241,5644
2020-03-13,세종,충북,358,14,25,16,24,18,455,292,25,24,8,22,24,395
2020-03-13,울산,강원,2,0,0,0,0,0,2,3,0,1,0,1,0,5
2020-03-13,울산,경기,41,3,8,30,70,3,155,36,1,1,12,17,1,68
2020-03-13,울산,경남,9428,612,696,475,656,594,12461,9759,654,661,487,739,605,12905
2020-03-13,울산,경북,4725,162,311,348,1360,280,7186,4702,176,298,427,1104,269,6976
2020-03-13,울산,광주,59,2,2,7,16,1,87,53,2,4,5,3,0,67
2020-03-13,울산,대구,957,38,71,85,163,41,1355,867,52,77,80,164,36,1276
2020-03-13,울산,대전,155,4,6,16,24,7,212,102,2,4,18,22,6,154
2020-03-13,울산,부산,16926,385,449,487,2513,1234,21994,15360,366,477,686,2616,1088,20593
2020-03-13,울산,서울,24,0,2,13,8,1,48,27,0,3,3,1,1,35
2020-03-13,울산,세종,8,0,3,2,6,0,19,11,0,0,2,4,0,17
2020-03-13,울산,울산,7851,318,525,303,534,695,10226,7851,318,525,303,534,695,10226
2020-03-13,울산,전남,236,14,29,12,31,6,328,218,13,24,11,50,6,322
2020-03-13,울산,전북,55,2,8,3,14,3,85,29,1,6,1,4,2,43
2020-03-13,울산,충남,141,3,16,51,132,4,347,152,5,6,36,128,5,332
2020-03-13,울산,충북,13,3,4,21,51,2,94,21,0,9,13,26,1,70
2020-03-13,전남,강원,19,1,2,1,4,0,27,47,3,7,6,13,4,80
2020-03-13,전남,경기,731,13,60,94,75,28,1001,1129,30,73,171,169,38,1610
2020-03-13,전남,경남,6712,302,427,451,1383,312,9587,6403,247,414,504,1453,302,9323
2020-03-13,전남,경북,801,44,78,72,285,28,1308,1099,51,81,105,426,42,1804
2020-03-13,전남,광주,34596,996,1021,762,2066,1367,40808,34305,1024,1100,832,2042,1398,40701
2020-03-13,전남,대구,452,22,31,24,60,15,604,418,14,33,25,36,14,540
2020-03-13,전남,대전,139,2,4,7,7,7,166,381,8,2,24,28,9,452
2020-03-13,전남,부산,1781,80,105,130,556,86,2738,2179,84,114,196,530,77,3180
2020-03-13,전남,서울,810,13,16,50,31,30,950,1176,12,19,33,24,43,1307
2020-03-13,전남,세종,147,1,0,6,5,6,165,196,1,7,4,14,3,225
2020-03-13,전남,울산,218,13,24,11,50,6,322,236,14,29,12,31,6,328
2020-03-13,전남,전남,47268,1367,1530,1464,5205,1919,58753,47268,1367,1530,1464,5205,1919,58753
2020-03-13,전남,전북,8775,360,685,761,2638,248,13467,5336,239,455,573,1369,169,8141
2020-03-13,전남,충남,2068,53,207,359,264,64,3015,6150,87,378,501,931,167,8214
2020-03-13,전남,충북,206,14,16,35,59,4,334,473,16,51,109,286,18,953
2020-03-13,전북,강원,156,8,7,24,29,5,229,124,7,11,8,16,1,167
2020-03-13,전북,경기,1531,59,151,202,253,63,2259,1848,50,152,127,195,45,2417
2020-03-13,전북,경남,1187,58,117,105,184,48,1699,1239,44,124,97,184,52,1740
2020-03-13,전북,경북,1656,106,175,164,499,49,2649,1812,96,174,165,256,60,2563
2020-03-13,전북,광주,8209,478,458,352,416,290,10203,7679,444,513,349,387,298,9670
2020-03-13,전북,대구,238,12,22,11,26,10,319,248,15,18,18,29,7,335
2020-03-13,전북,대전,3314,92,94,86,90,144,3820,3028,64,100,68,61,141,3462
2020-03-13,전북,부산,217,9,23,41,79,12,381,319,9,37,40,110,14,529
2020-03-13,전북,서울,1553,28,52,43,35,47,1758,1745,17,41,23,34,55,1915
2020-03-13,전북,세종,781,16,17,26,49,30,919,745,21,35,17,41,23,882
2020-03-13,전북,울산,29,1,6,1,4,2,43,55,2,8,3,14,3,85
2020-03-13,전북,전남,5336,239,455,573,1369,169,8141,8775,360,685,761,2638,248,13467
2020-03-13,전북,전북,17389,713,942,723,1339,684,21790,17389,713,942,723,1339,684,21790
2020-03-13,전북,충남,17528,586,1564,1400,2295,628,24001,16270,522,1352,1042,1490,607,21283
2020-03-13,전북,충북,2091,120,201,346,436,76,3270,2070,116,221,268,291,67,3033
2020-03-13,충남,강원,475,9,16,42,61,27,630,285,6,20,25,45,22,403
2020-03-13,충남,경기,41706,1498,2647,2504,4369,2215,54939,40731,1544,2785,2642,4601,2228,54531
2020-03-13,충남,경남,2119,65,168,304,528,98,3282,1118,47,125,285,237,41,1853
2020-03-13,충남,경북,3141,149,371,540,791,142,5134,2886,165,353,568,612,113,4697
2020-03-13,충남,광주,5348,118,444,577,365,119,6971,4338,122,462,449,232,120,5723
2020-03-13,충남,대구,819,53,107,160,180,28,1347,1082,75,120,194,239,36,1746
2020-03-13,충남,대전,14792,467,451,222,235,1063,17230,15526,538,494,255,230,1163,18206
2020-03-13,충남,부산,183,9,38,78,159,5,472,127,6,23,61,174,7,398
2020-03-13,충남,서울,28597,619,1980,1260,1345,1197,34998,29056,535,1952,895,851,1169,34458
2020-03-13,충남,세종,4787,159,168,114,175,241,5644,5820,155,162,129,188,324,6778
2020-03-13,충남,울산,152,5,6,36,128,5,332,141,3,16,51,132,4,347
2020-03-13,충남,전남,6150,87,378,501,931,167,8214,2068,53,207,359,264,64,3015
2020-03-13,충남,전북,16270,522,1352,1042,1490,607,21283,17528,586,1564,1400,2295,628,24001
2020-03-13,충남,충남,102056,3644,7327,7004,10970,4884,135885,102056,3644,7327,7004,10970,4884,135885
2020-03-13,충남,충북,13770,651,866,1006,1505,767,18565,12264,622,808,879,1539,680,16792
2020-03-13,충북,강원,4930,193,208,241,351,298,6221,4537,217,249,232,407,292,5934
2020-03-13,충북,경기,28817,2205,2731,2992,3768,1402,41915,29541,2329,2948,3305,3636,1524,43283
2020-03-13,충북,경남,1708,64,196,472,685,76,3201,1113,57,112,258,272,46,1858
2020-03-13,충북,경북,4262,252,465,646,1075,174,6874,4498,236,462,698,988,183,7065
2020-03-13,충북,광주,803,38,85,177,110,22,1235,554,27,72,103,66,18,840
2020-03-13,충북,대구,963,78,135,229,146,28,1579,1375,90,165,270,421,56,2377
2020-03-13,충북,대전,10236,374,376,180,154,777,12097,10774,418,420,201,174,790,12777
2020-03-13,충북,부산,149,17,21,133,193,8,521,133,6,21,94,222,3,479
2020-03-13,충북,서울,15321,601,973,859,867,629,19250,14412,506,923,833,696,627,17997
2020-03-13,충북,세종,292,25,24,8,22,24,395,358,14,25,16,24,18,455
2020-03-13,충북,울산,21,0,9,13,26,1,70,13,3,4,21,51,2,94
2020-03-13,충북,전남,473,16,51,109,286,18,953,206,14,16,35,59,4,334
2020-03-13,충북,전북,2070,116,221,268,291,67,3033,2091,120,201,346,436,76,3270
2020-03-13,충북,충남,12264,622,808,879,1539,680,16792,13770,651,866,1006,1505,767,18565
2020-03-13,충북,충북,35683,2053,2274,2214,3293,2122,47639,35683,2053,2274,2214,3293,2122,47639
2020-03-14,강원,강원,84274,1546,1782,865,2288,4300,95055,84274,1546,1782,865,2288,4300,95055
2020-03-14,강원,경기,31294,314,706,343,434,1279,34370,41682,365,681,396,536,1586,45246
2020-03-14,강원,경남,119,4,9,6,6,8,152,101,1,2,10,4,5,123
2020-03-14,강원,경북,390,13,8,15,9,13,448,422,18,8,11,17,15,491
2020-03-14,강원,광주,65,2,13,5,2,1,88,67,0,7,5,2,1,82
2020-03-14,강원,대구,136,5,3,5,0,3,152,245,3,3,3,5,3,262
2020-03-14,강원,대전,162,4,18,1,0,7,192,191,7,18,4,4,11,235
2020-03-14,강원,부산,3,0,0,1,0,0,4,7,1,0,1,1,1,11
2020-03-14,강원,서울,915,6,169,4,17,44,1155,1570,9,145,10,11,58,1803
2020-03-14,강원,세종,2,0,0,0,0,0,2,9,1,0,0,2,0,12
2020-03-14,강원,울산,4,0,0,0,0,0,4,2,0,0,0,0,1,3
2020-03-14,강원,전남,55,2,1,3,7,1,69,22,1,1,6,4,0,34
2020-03-14,강원,전북,124,2,4,3,5,3,141,162,8,9,10,11,6,206
2020-03-14,강원,충남,305,4,8,14,17,9,357,487,6,13,27,43,16,592
2020-03-14,강원,충북,4522,149,130,153,297,238,5489,5326,128,114,151,259,259,6237
2020-03-14,경기,강원,41682,365,681,396,536,1586,45246,31294,314,706,343,434,1279,34370
2020-03-14,경기,경기,361759,10666,11942,10494,14999,22378,432238,361759,10666,11942,10494,14999,22378,432238
2020-03-14,경기,경남,2530,46,203,459,318,105,3661,1648,27,152,285,214,69,2395
2020-03-14,경기,경북,3295,72,212,423,315,134,4451,2903,66,196,484,275,109,4033
2020-03-14,경기,광주,922,12,83,155,82,31,1285,660,6,58,113,50,25,912
2020-03-14,경기,대구,1109,29,106,276,122,38,1680,1737,43,87,228,195,59,2349
2020-03-14,경기,대전,2709,45,131,78,36,139,3138,2183,53,134,61,18,112,2561
2020-03-14,경기,부산,244,8,23,120,85,15,495,175,7,15,79,118,10,404
2020-03-14,경기,서울,127772,4134,4853,2914,2744,7153,149570,124576,3675,4927,2320,2431,7002,144931
2020-03-14,경기,세종,48,2,3,0,2,3,58,47,1,3,2,2,2,57
2020-03-14,경기,울산,20,0,1,3,7,2,33,32,2,6,14,29,0,83
2020-03-14,경기,전남,1178,6,60,102,94,33,1473,687,8,50,60,43,28,876
2020-03-14,경기,전북,2114,22,109,87,104,81,2517,1641,22,82,102,99,55,2001
2020-03-14,경기,충남,43497,697,1532,1242,2237,2061,51266,40231,701,1523,1246,2336,1936,47973
2020-03-14,경기,충북,29414,978,1379,1668,2236,1387,37062,26789,912,1255,1380,2493,1268,34097
2020-03-14,경남,강원,101,1,2,10,4,5,123,119,4,9,6,6,8,152
2020-03-14,경남,경기,1648,27,152,285,214,69,2395,2530,46,203,459,318,105,3661
2020-03-14,경남,경남,176591,5838,5134,4058,8719,11531,211871,176591,5838,5134,4058,8719,11531,211871
2020-03-14,경남,경북,9690,272,497,436,960,476,12331,12397,398,584,651,1291,576,15897
2020-03-14,경남,광주,1291,20,82,89,73,46,1601,1181,17,80,70,48,49,1445
2020-03-14,경남,대구,10761,336,473,438,669,416,13093,10233,249,353,230,255,417,11737
2020-03-14,경남,대전,899,10,66,27,23,45,1070,1198,14,62,76,35,58,1443
2020-03-14,경남,부산,83554,1508,1587,1161,2760,5272,95842,82743,1515,1690,1072,2864,5312,95196
2020-03-14,경남,서울,1722,17,267,146,85,56,2293,2462,20,322,156,76,71,3107
2020-03-14,경남,세종,170,0,6,6,8,8,198,255,5,7,14,4,10,295
2020-03-14,경남,울산,9521,362,363,258,343,561,11408,9727,312,413,249,296,526,11523
2020-03-14,경남,전남,7605,139,239,251,762,301,9297,7116,139,238,198,744,311,8746
2020-03-14,경남,전북,1366,25,73,44,128,47,1683,1121,28,82,50,147,44,1472
2020-03-14,경남,충남,935,20,53,101,118,35,1262,1566,15,83,183,268,67,2182
2020-03-14,경남,충북,1078,24,59,125,153,56,1495,1460,32,109,260,389,69,2319
2020-03-14,경북,강원,422,18,8,11,17,15,491,390,13,8,15,9,13,448
2020-03-14,경북,경기,2903,66,196,484,275,109,4033,3295,72,212,423,315,134,4451
2020-03-14,경북,경남,12397,398,584,651,1291,576,15897,9690,272,497,436,960,476,12331
2020-03-14,경북,경북,67923,2233,2227,1699,3589,3053,80724,67923,2233,2227,1699,3589,3053,80724
2020-03-14,경북,광주,670,24,72,88,79,22,955,576,19,46,79,38,27,785
2020-03-14,경북,대구,56133,1684,1372,988,2536,2589,65302,61347,1729,1490,1101,2742,2819,71228
2020-03-14,경북,대전,1791,27,56,63,50,85,2072,1763,21,57,91,29,90,2051
2020-03-14,경북,부산,5071,60,156,77,278,237,5879,5468,54,148,92,345,248,6355
2020-03-14,경북,서울,2152,39,162,168,110,82,2713,2509,31,174,149,96,97,3056
2020-03-14,경북,세종,218,4,6,14,8,7,257,245,3,4,6,11,9,278
2020-03-14,경북,울산,5177,64,162,220,686,306,6615,5308,66,179,147,801,256,6757
2020-03-14,경북,전남,1389,32,37,38,255,42,1793,978,26,40,38,205,34,1321
2020-03-14,경북,전북,1813,52,105,105,167,55,2297,1761,62,90,85,288,53,2339
2020-03-14,경북,충남,2779,64,129,240,306,99,3617,3194,69,194,292,369,124,4242
2020-03-14,경북,충북,4607,116,224,304,545,186,5982,4521,137,223,348,693,205,6127
2020-03-14,광주,강원,67,0,7,5,2,1,82,65,2,13,5,2,1,88
2020-03-14,광주,경기,660,6,58,113,50,25,912,922,12,83,155,82,31,1285
2020-03-14,광주,경남,1181,17,80,70,48,49,1445,1291,20,82,89,73,46,1601
2020-03-14,광주,경북,576,19,46,79,38,27,785,670,24,72,88,79,22,955
2020-03-14,광주,광주,13459,321,425,202,224,499,15130,13459,321,425,202,224,499,15130
2020-03-14,광주,대구,363,11,38,47,13,8,480,428,10,42,45,8,14,547
2020-03-14,광주,대전,494,8,8,14,8,14,546,574,3,13,16,9,17,632
2020-03-14,광주,부산,406,5,36,16,33,10,506,458,7,41,38,31,16,591
2020-03-14,광주,서울,603,13,7,40,13,20,696,973,10,11,37,10,34,1075
2020-03-14,광주,세종,155,0,4,2,0,3,164,251,0,4,2,2,11,270
2020-03-14,광주,울산,41,0,3,1,3,2,50,48,0,3,2,10,6,69
2020-03-14,광주,전남,41284,627,797,468,1229,1387,45792,38159,619,729,385,1242,1302,42436
2020-03-14,광주,전북,9068,253,278,165,187,272,10223,8972,290,271,188,246,268,10235
2020-03-14,광주,충남,4502,56,377,229,109,94,5367,5054,70,397,367,200,112,6200
2020-03-14,광주,충북,522,10,29,42,20,20,643,710,11,43,74,66,18,922
2020-03-14,대구,강원,245,3,3,3,5,3,262,136,5,3,5,0,3,152
2020-03-14,대구,경기,1737,43,87,228,195,59,2349,1109,29,106,276,122,38,1680
2020-03-14,대구,경남,10233,249,353,230,255,417,11737,10761,336,473,438,669,416,13093
2020-03-14,대구,경북,61347,1729,1490,1101,2742,2819,71228,56133,1684,1372,988,2536,2589,65302
2020-03-14,대구,광주,428,10,42,45,8,14,547,363,11,38,47,13,8,480
2020-03-14,대구,대구,40384,1158,928,508,949,2391,46318,40384,1158,928,508,949,2391,46318
2020-03-14,대구,대전,722,9,19,43,21,34,848,436,8,14,41,15,26,540
2020-03-14,대구,부산,652,15,75,43,83,27,895,3069,42,119,47,89,124,3490
2020-03-14,대구,서울,1772,24,62,89,48,53,2048,1015,25,54,88,35,33,1250
2020-03-14,대구,세종,155,0,3,3,6,12,179,116,0,0,1,2,7,126
2020-03-14,대구,울산,1016,23,50,38,110,45,1282,993,13,49,32,132,35,1254
2020-03-14,대구,전남,784,7,28,13,19,18,869,710,10,22,24,19,20,805
2020-03-14,대구,전북,294,3,14,4,14,11,340,252,7,15,9,7,13,303
2020-03-14,대구,충남,951,21,50,101,74,26,1223,672,16,54,77,83,20,922
2020-03-14,대구,충북,1229,37,82,113,162,56,1679,833,24,74,147,93,26,1197
2020-03-14,대전,강원,191,7,18,4,4,11,235,162,4,18,1,0,7,192
2020-03-14,대전,경기,2183,53,134,61,18,112,2561,2709,45,131,78,36,139,3138
2020-03-14,대전,경남,1198,14,62,76,35,58,1443,899,10,66,27,23,45,1070
2020-03-14,대전,경북,1763,21,57,91,29,90,2051,1791,27,56,63,50,85,2072
2020-03-14,대전,광주,574,3,13,16,9,17,632,494,8,8,14,8,14,546
2020-03-14,대전,대구,436,8,14,41,15,26,540,722,9,19,43,21,34,848
2020-03-14,대전,대전,11670,271,243,126,263,780,13353,11670,271,243,126,263,780,13353
2020-03-14,대전,부산,78,0,6,11,8,1,104,66,1,9,9,15,4,104
2020-03-14,대전,서울,1886,22,156,17,7,69,2157,2242,18,145,22,4,100,2531
2020-03-14,대전,세종,2572,82,42,21,60,153,2930,2490,80,51,16,68,164,2869
2020-03-14,대전,울산,83,2,0,13,15,1,114,96,2,1,3,15,3,120
2020-03-14,대전,전남,621,6,8,20,16,12,683,173,1,2,5,4,8,193
2020-03-14,대전,전북,4184,52,55,48,29,179,4547,4152,58,67,39,45,176,4537
2020-03-14,대전,충남,14604,300,304,212,220,861,16501,13584,274,300,197,211,822,15388
2020-03-14,대전,충북,9879,254,276,121,123,588,11241,8999,254,269,113,103,546,10284
2020-03-14,부산,강원,7,1,0,1,1,1,11,3,0,0,1,0,0,4
2020-03-14,부산,경기,175,7,15,79,118,10,404,244,8,23,120,85,15,495
2020-03-14,부산,경남,82743,1515,1690,1072,2864,5312,95196,83554,1508,1587,1161,2760,5272,95842
2020-03-14,부산,경북,5468,54,148,92,345,248,6355,5071,60,156,77,278,237,5879
2020-03-14,부산,광주,458,7,41,38,31,16,591,406,5,36,16,33,10,506
2020-03-14,부산,대구,3069,42,119,47,89,124,3490,652,15,75,43,83,27,895
2020-03-14,부산,대전,66,1,9,9,15,4,104,78,0,6,11,8,1,104
2020-03-14,부산,부산,50956,369,305,335,1339,3142,56446,50956,369,305,335,1339,3142,56446
2020-03-14,부산,서울,187,7,6,32,30,4,266,238,6,17,33,33,5,332
2020-03-14,부산,세종,18,0,0,0,3,1,22,21,2,0,0,1,0,24
2020-03-14,부산,울산,16179,197,237,262,1371,1051,19297,17441,203,193,188,1329,1156,20510
2020-03-14,부산,전남,2206,26,69,70,263,85,2719,2089,30,63,67,271,66,2586
2020-03-14,부산,전북,314,3,22,20,34,11,404,267,4,17,14,25,6,333
2020-03-14,부산,충남,125,2,11,25,44,6,213,153,5,11,44,83,6,302
2020-03-14,부산,충북,113,4,11,33,83,2,246,106,5,24,62,81,3,281
2020-03-14,서울,강원,1570,9,145,10,11,58,1803,915,6,169,4,17,44,1155
2020-03-14,서울,경기,124576,3675,4927,2320,2431,7002,144931,127772,4134,4853,2914,2744,7153,149570
2020-03-14,서울,경남,2462,20,322,156,76,71,3107,1722,17,267,146,85,56,2293
2020-03-14,서울,경북,2509,31,174,149,96,97,3056,2152,39,162,168,110,82,2713
2020-03-14,서울,광주,973,10,11,37,10,34,1075,603,13,7,40,13,20,696
2020-03-14,서울,대구,1015,25,54,88,35,33,1250,1772,24,62,89,48,53,2048
2020-03-14,서울,대전,2242,18,145,22,4,100,2531,1886,22,156,17,7,69,2157
2020-03-14,서울,부산,238,6,17,33,33,5,332,187,7,6,32,30,4,266
2020-03-14,서울,서울,203,6,4,2,2,7,224,203,6,4,2,2,7,224
2020-03-14,서울,세종,34,1,0,2,0,1,38,30,0,0,1,0,2,33
2020-03-14,서울,울산,40,0,2,1,1,0,44,23,1,1,5,7,1,38
2020-03-14,서울,전남,1300,2,23,21,19,37,1402,815,5,9,30,18,25,902
2020-03-14,서울,전북,2155,8,33,12,14,77,2299,1481,15,35,12,15,44,1602
2020-03-14,서울,충남,34195,236,1593,447,520,1322,38313,31334,292,1574,568,809,1281,35858
2020-03-14,서울,충북,15656,221,675,456,376,650,18034,14714,227,626,482,570,597,17216
2020-03-14,세종,강원,9,1,0,0,2,0,12,2,0,0,0,0,0,2
2020-03-14,세종,경기,47,1,3,2,2,2,57,48,2,3,0,2,3,58
2020-03-14,세종,경남,255,5,7,14,4,10,295,170,0,6,6,8,8,198
2020-03-14,세종,경북,245,3,4,6,11,9,278,218,4,6,14,8,7,257
2020-03-14,세종,광주,251,0,4,2,2,11,270,155,0,4,2,0,3,164
2020-03-14,세종,대구,116,0,0,1,2,7,126,155,0,3,3,6,12,179
2020-03-14,세종,대전,2490,80,51,16,68,164,2869,2572,82,42,21,60,153,2930
2020-03-14,세종,부산,21,2,0,0,1,0,24,18,0,0,0,3,1,22
2020-03-14,세종,서울,30,0,0,1,0,2,33,34,1,0,2,0,1,38
2020-03-14,세종,세종,212,25,4,0,2,14,257,212,25,4,0,2,14,257
2020-03-14,세종,울산,5,0,0,0,1,1,7,10,0,1,0,2,1,14
2020-03-14,세종,전남,291,1,3,6,5,8,314,95,1,3,0,2,2,103
2020-03-14,세종,전북,1057,13,13,6,16,32,1137,966,10,12,8,18,18,1032
2020-03-14,세종,충남,6686,120,95,76,114,298,7389,4870,111,95,66,126,190,5458
2020-03-14,세종,충북,367,5,16,5,11,28,432,315,10,17,6,25,23,396
2020-03-14,울산,강원,2,0,0,0,0,1,3,4,0,0,0,0,0,4
2020-03-14,울산,경기,32,2,6,14,29,0,83,20,0,1,3,7,2,33
2020-03-14,울산,경남,9727,312,413,249,296,526,11523,9521,362,363,258,343,561,11408
2020-03-14,울산,경북,5308,66,179,147,801,256,6757,5177,64,162,220,686,306,6615
2020-03-14,울산,광주,48,0,3,2,10,6,69,41,0,3,1,3,2,50
2020-03-14,울산,대구,993,13,49,32,132,35,1254,1016,23,50,38,110,45,1282
2020-03-14,울산,대전,96,2,1,3,15,3,120,83,2,0,13,15,1,114
2020-03-14,울산,부산,17441,203,193,188,1329,1156,20510,16179,197,237,262,1371,1051,19297
2020-03-14,울산,서울,23,1,1,5,7,1,38,40,0,2,1,1,0,44
2020-03-14,울산,세종,10,0,1,0,2,1,14,5,0,0,0,1,1,7
2020-03-14,울산,울산,5643,132,200,106,305,449,6835,5643,132,200,106,305,449,6835
2020-03-14,울산,전남,206,3,11,3,15,5,243,242,9,15,4,8,6,284
2020-03-14,울산,전북,59,2,6,1,10,1,79,43,0,6,3,4,1,57
2020-03-14,울산,충남,102,2,6,19,42,2,173,82,2,8,18,54,1,165
2020-03-14,울산,충북,13,0,1,10,23,3,50,13,0,4,6,26,0,49
2020-03-14,전남,강원,22,1,1,6,4,0,34,55,2,1,3,7,1,69
2020-03-14,전남,경기,687,8,50,60,43,28,876,1178,6,60,102,94,33,1473
2020-03-14,전남,경남,7116,139,238,198,744,311,8746,7605,139,239,251,762,301,9297
2020-03-14,전남,경북,978,26,40,38,205,34,1321,1389,32,37,38,255,42,1793
2020-03-14,전남,광주,38159,619,729,385,1242,1302,42436,41284,627,797,468,1229,1387,45792
2020-03-14,전남,대구,710,10,22,24,19,20,805,784,7,28,13,19,18,869
2020-03-14,전남,대전,173,1,2,5,4,8,193,621,6,8,20,16,12,683
2020-03-14,전남,부산,2089,30,63,67,271,66,2586,2206,26,69,70,263,85,2719
2020-03-14,전남,서울,815,5,9,30,18,25,902,1300,2,23,21,19,37,1402
2020-03-14,전남,세종,95,1,3,0,2,2,103,291,1,3,6,5,8,314
2020-03-14,전남,울산,242,9,15,4,8,6,284,206,3,11,3,15,5,243
2020-03-14,전남,전남,51855,817,936,1064,3368,1789,59829,51855,817,936,1064,3368,1789,59829
2020-03-14,전남,전북,10025,193,492,348,1362,271,12691,7237,147,314,365,941,200,9204
2020-03-14,전남,충남,2000,25,123,168,105,58,2479,7215,38,294,266,472,217,8502
2020-03-14,전남,충북,185,7,5,22,36,8,263,603,7,17,48,145,15,835
2020-03-14,전북,강원,162,8,9,10,11,6,206,124,2,4,3,5,3,141
2020-03-14,전북,경기,1641,22,82,102,99,55,2001,2114,22,109,87,104,81,2517
2020-03-14,전북,경남,1121,28,82,50,147,44,1472,1366,25,73,44,128,47,1683
2020-03-14,전북,경북,1761,62,90,85,288,53,2339,1813,52,105,105,167,55,2297
2020-03-14,전북,광주,8972,290,271,188,246,268,10235,9068,253,278,165,187,272,10223
2020-03-14,전북,대구,252,7,15,9,7,13,303,294,3,14,4,14,11,340
2020-03-14,전북,대전,4152,58,67,39,45,176,4537,4184,52,55,48,29,179,4547
2020-03-14,전북,부산,267,4,17,14,25,6,333,314,3,22,20,34,11,404
2020-03-14,전북,서울,1481,15,35,12,15,44,1602,2155,8,33,12,14,77,2299
2020-03-14,전북,세종,966,10,12,8,18,18,1032,1057,13,13,6,16,32,1137
2020-03-14,전북,울산,43,0,6,3,4,1,57,59,2,6,1,10,1,79
2020-03-14,전북,전남,7237,147,314,365,941,200,9204,10025,193,492,348,1362,271,12691
2020-03-14,전북,전북,18280,484,612,409,836,634,21255,18280,484,612,409,836,634,21255
2020-03-14,전북,충남,19587,278,1072,547,1038,719,23241,19007,256,967,481,825,679,22215
2020-03-14,전북,충북,2152,62,90,137,201,76,2718,2268,73,106,128,193,71,2839
2020-03-14,충남,강원,487,6,13,27,43,16,592,305,4,8,14,17,9,357
2020-03-14,충남,경기,40231,701,1523,1246,2336,1936,47973,43497,697,1532,1242,2237,2061,51266
2020-03-14,충남,경남,1566,15,83,183,268,67,2182,935,20,53,101,118,35,1262
2020-03-14,충남,경북,3194,69,194,292,369,124,4242,2779,64,129,240,306,99,3617
2020-03-14,충남,광주,5054,70,397,367,200,112,6200,4502,56,377,229,109,94,5367
2020-03-14,충남,대구,672,16,54,77,83,20,922,951,21,50,101,74,26,1223
2020-03-14,충남,대전,13584,274,300,197,211,822,15388,14604,300,304,212,220,861,16501
2020-03-14,충남,부산,153,5,11,44,83,6,302,125,2,11,25,44,6,213
2020-03-14,충남,서울,31334,292,1574,568,809,1281,35858,34195,236,1593,447,520,1322,38313
2020-03-14,충남,세종,4870,111,95,66,126,190,5458,6686,120,95,76,114,298,7389
2020-03-14,충남,울산,82,2,8,18,54,1,165,102,2,6,19,42,2,173
2020-03-14,충남,전남,7215,38,294,266,472,217,8502,2000,25,123,168,105,58,2479
2020-03-14,충남,전북,19007,256,967,481,825,679,22215,19587,278,1072,547,1038,719,23241
2020-03-14,충남,충남,103058,1860,4545,3520,5708,4266,122957,103058,1860,4545,3520,5708,4266,122957
2020-03-14,충남,충북,11436,347,422,487,862,571,14125,10417,357,421,392,906,538,13031
2020-03-14,충북,강원,5326,128,114,151,259,259,6237,4522,149,130,153,297,238,5489
2020-03-14,충북,경기,26789,912,1255,1380,2493,1268,34097,29414,978,1379,1668,2236,1387,37062
2020-03-14,충북,경남,1460,32,109,260,389,69,2319,1078,24,59,125,153,56,1495
2020-03-14,충북,경북,4521,137,223,348,693,205,6127,4607,116,224,304,545,186,5982
2020-03-14,충북,광주,710,11,43,74,66,18,922,522,10,29,42,20,20,643
2020-03-14,충북,대구,833,24,74,147,93,26,1197,1229,37,82,113,162,56,1679
2020-03-14,충북,대전,8999,254,269,113,103,546,10284,9879,254,276,121,123,588,11241
2020-03-14,충북,부산,106,5,24,62,81,3,281,113,4,11,33,83,2,246
2020-03-14,충북,서울,14714,227,626,482,570,597,17216,15656,221,675,456,376,650,18034
2020-03-14,충북,세종,315,10,17,6,25,23,396,367,5,16,5,11,28,432
2020-03-14,충북,울산,13,0,4,6,26,0,49,13,0,1,10,23,3,50
2020-03-14,충북,전남,603,7,17,48,145,15,835,185,7,5,22,36,8,263
2020-03-14,충북,전북,2268,73,106,128,193,71,2839,2152,62,90,137,201,76,2718
2020-03-14,충북,충남,10417,357,421,392,906,538,13031,11436,347,422,487,862,571,14125
2020-03-14,충북,충북,30492,1068,1064,1069,2162,1641,37496,30492,1068,1064,1069,2162,1641,37496
2020-03-15,강원,강원,64393,688,1268,489,615,3358,70811,64393,688,1268,489,615,3358,70811
2020-03-15,강원,경기,40085,212,481,210,147,1540,42675,25009,130,484,142,200,1143,27108
2020-03-15,강원,경남,195,2,4,0,1,6,208,96,1,2,2,0,8,109
2020-03-15,강원,경북,454,12,4,1,3,19,493,356,7,5,7,6,16,397
2020-03-15,강원,광주,75,0,10,9,0,2,96,81,1,13,4,2,1,102
2020-03-15,강원,대구,215,0,2,3,1,5,226,176,2,1,3,4,8,194
2020-03-15,강원,대전,212,6,16,0,1,10,245,203,1,18,1,0,7,230
2020-03-15,강원,부산,4,0,0,0,0,0,4,3,0,0,0,0,0,3
2020-03-15,강원,서울,1642,6,176,5,4,54,1887,883,10,146,0,1,26,1066
2020-03-15,강원,세종,7,0,0,0,0,0,7,4,0,0,0,1,0,5
2020-03-15,강원,울산,1,0,0,0,0,0,1,0,0,0,0,0,0,0
2020-03-15,강원,전남,44,1,3,1,3,2,54,19,0,1,0,1,0,21
2020-03-15,강원,전북,129,1,4,2,0,4,140,168,3,4,10,6,7,198
2020-03-15,강원,충남,441,3,7,2,7,22,482,379,2,9,6,15,12,423
2020-03-15,강원,충북,4678,67,80,43,87,210,5165,3925,53,73,36,78,190,4355
2020-03-15,경기,강원,25009,130,484,142,200,1143,27108,40085,212,481,210,147,1540,42675
2020-03-15,경기,경기,279604,4737,6177,3337,3606,16449,313910,279604,4737,6177,3337,3606,16449,313910
2020-03-15,경기,경남,2386,25,152,137,66,112,2878,2377,15,103,135,82,100,2812
2020-03-15,경기,경북,3120,35,117,171,75,141,3659,3420,46,90,188,87,175,4006
2020-03-15,경기,광주,642,3,61,28,10,25,769,932,9,53,35,31,41,1101
2020-03-15,경기,대구,1226,11,42,72,19,39,1409,1795,13,48,89,61,74,2080
2020-03-15,경기,대전,1918,14,119,22,4,118,2195,2776,32,115,16,11,165,3115
2020-03-15,경기,부산,202,1,5,37,12,12,269,396,4,10,20,32,20,482
2020-03-15,경기,서울,95188,1645,3451,1243,560,5354,107441,107099,1809,3519,1152,575,6092,120246
2020-03-15,경기,세종,24,0,2,0,0,1,27,49,0,1,3,1,3,57
2020-03-15,경기,울산,25,2,0,1,1,1,30,27,0,2,3,8,2,42
2020-03-15,경기,전남,691,6,46,29,30,17,819,1077,12,42,51,29,36,1247
2020-03-15,경기,전북,1248,8,67,30,30,48,1431,2440,11,70,46,44,82,2693
2020-03-15,경기,충남,33441,284,1004,504,642,1619,37494,39540,310,968,408,551,1719,43496
2020-03-15,경기,충북,22441,454,675,492,471,1097,25630,27015,471,646,435,432,1285,30284
2020-03-15,경남,강원,96,1,2,2,0,8,109,195,2,4,0,1,6,208
2020-03-15,경남,경기,2377,15,103,135,82,100,2812,2386,25,152,137,66,112,2878
2020-03-15,경남,경남,146172,2017,2335,984,1264,9006,161778,146172,2017,2335,984,1264,9006,161778
2020-03-15,경남,경북,9873,146,244,146,151,503,11063,11840,217,325,206,207,595,13390
2020-03-15,경남,광주,1151,11,44,34,11,40,1291,1447,13,64,34,7,54,1619
2020-03-15,경남,대구,11583,142,261,261,318,525,13090,8342,88,193,105,55,353,9136
2020-03-15,경남,대전,977,6,58,26,10,31,1108,1157,9,59,15,2,61,1303
2020-03-15,경남,부산,70715,565,1006,265,673,4185,77409,65904,606,1016,257,807,4172,72762
2020-03-15,경남,서울,2069,16,282,128,57,60,2612,2429,11,308,33,20,78,2879
2020-03-15,경남,세종,231,1,3,1,0,12,248,253,1,5,0,0,10,269
2020-03-15,경남,울산,8939,120,173,44,66,570,9912,8650,98,172,45,82,571,9618
2020-03-15,경남,전남,6390,60,129,98,135,281,7093,7459,67,138,104,131,281,8180
2020-03-15,경남,전북,1268,13,47,27,22,37,1414,1379,13,59,20,16,39,1526
2020-03-15,경남,충남,1354,9,21,42,37,77,1540,1449,9,37,52,72,57,1676
2020-03-15,경남,충북,1364,10,37,54,60,64,1589,1312,13,53,89,73,58,1598
2020-03-15,경북,강원,356,7,5,7,6,16,397,454,12,4,1,3,19,493
2020-03-15,경북,경기,3420,46,90,188,87,175,4006,3120,35,117,171,75,141,3659
2020-03-15,경북,경남,11840,217,325,206,207,595,13390,9873,146,244,146,151,503,11063
2020-03-15,경북,경북,61713,868,864,453,610,2757,67265,61713,868,864,453,610,2757,67265
2020-03-15,경북,광주,576,15,38,42,23,18,712,847,14,30,36,15,20,962
2020-03-15,경북,대구,48966,545,481,281,419,2102,52794,49452,570,581,298,446,2160,53507
2020-03-15,경북,대전,1571,15,29,28,25,84,1752,1799,13,31,18,9,83,1953
2020-03-15,경북,부산,5362,28,85,31,99,214,5819,6052,34,108,30,119,273,6616
2020-03-15,경북,서울,2501,20,156,137,33,89,2936,2390,15,146,54,21,84,2710
2020-03-15,경북,세종,241,1,3,3,1,10,259,246,0,4,6,1,10,267
2020-03-15,경북,울산,5357,24,76,72,205,254,5988,4885,29,60,43,208,264,5489
2020-03-15,경북,전남,1207,21,34,20,80,43,1405,1185,11,33,15,66,49,1359
2020-03-15,경북,전북,1489,29,47,32,43,41,1681,1830,31,42,42,102,55,2102
2020-03-15,경북,충남,3037,28,38,69,78,109,3359,2788,34,76,56,84,95,3133
2020-03-15,경북,충북,4527,59,85,134,152,195,5152,4329,58,89,109,133,181,4899
2020-03-15,광주,강원,81,1,13,4,2,1,102,75,0,10,9,0,2,96
2020-03-15,광주,경기,932,9,53,35,31,41,1101,642,3,61,28,10,25,769
2020-03-15,광주,경남,1447,13,64,34,7,54,1619,1151,11,44,34,11,40,1291
2020-03-15,광주,경북,847,14,30,36,15,20,962,576,15,38,42,23,18,712
2020-03-15,광주,광주,11668,136,371,86,40,397,12698,11668,136,371,86,40,397,12698
2020-03-15,광주,대구,446,7,32,42,7,23,557,331,8,37,25,8,12,421
2020-03-15,광주,대전,526,2,2,3,6,19,558,495,4,3,1,6,18,527
2020-03-15,광주,부산,451,1,24,12,10,10,508,453,0,31,5,14,13,516
2020-03-15,광주,서울,933,7,8,8,3,28,987,607,10,11,6,6,17,657
2020-03-15,광주,세종,219,0,4,0,1,4,228,140,0,3,0,0,3,146
2020-03-15,광주,울산,68,0,3,0,0,3,74,56,0,5,1,0,0,62
2020-03-15,광주,전남,34950,265,589,153,182,1090,37229,35692,240,534,221,169,1142,37998
2020-03-15,광주,전북,7795,82,153,54,34,223,8341,7940,93,167,62,29,265,8556
2020-03-15,광주,충남,5651,32,314,124,90,172,6383,4156,32,339,104,56,127,4814
2020-03-15,광주,충북,697,4,22,16,11,18,768,544,9,25,30,10,17,635
2020-03-15,대구,강원,176,2,1,3,4,8,194,215,0,2,3,1,5,226
2020-03-15,대구,경기,1795,13,48,89,61,74,2080,1226,11,42,72,19,39,1409
2020-03-15,대구,경남,8342,88,193,105,55,353,9136,11583,142,261,261,318,525,13090
2020-03-15,대구,경북,49452,570,581,298,446,2160,53507,48966,545,481,281,419,2102,52794
2020-03-15,대구,광주,331,8,37,25,8,12,421,446,7,32,42,7,23,557
2020-03-15,대구,대구,28077,364,348,155,259,1515,30718,28077,364,348,155,259,1515,30718
2020-03-15,대구,대전,662,3,4,15,10,33,727,437,1,4,10,2,24,478
2020-03-15,대구,부산,456,8,44,19,9,21,557,3519,24,86,31,26,172,3858
2020-03-15,대구,서울,1522,11,53,47,18,55,1706,1306,4,35,26,11,47,1429
2020-03-15,대구,세종,191,0,2,1,0,9,203,118,0,1,0,1,7,127
2020-03-15,대구,울산,917,8,29,10,31,46,1041,957,5,31,6,29,37,1065
2020-03-15,대구,전남,613,5,22,11,20,28,699,888,5,22,7,12,32,966
2020-03-15,대구,전북,242,0,5,2,3,16,268,305,0,4,3,1,11,324
2020-03-15,대구,충남,1054,10,16,31,36,45,1192,661,6,9,40,14,16,746
2020-03-15,대구,충북,1155,12,48,48,64,33,1360,841,7,19,42,23,41,973
2020-03-15,대전,강원,203,1,18,1,0,7,230,212,6,16,0,1,10,245
2020-03-15,대전,경기,2776,32,115,16,11,165,3115,1918,14,119,22,4,118,2195
2020-03-15,대전,경남,1157,9,59,15,2,61,1303,977,6,58,26,10,31,1108
2020-03-15,대전,경북,1799,13,31,18,9,83,1953,1571,15,29,28,25,84,1752
2020-03-15,대전,광주,495,4,3,1,6,18,527,526,2,2,3,6,19,558
2020-03-15,대전,대구,437,1,4,10,2,24,478,662,3,4,15,10,33,727
2020-03-15,대전,대전,8561,84,123,21,31,586,9406,8561,84,123,21,31,586,9406
2020-03-15,대전,부산,96,0,0,0,0,2,98,108,0,0,0,2,8,118
2020-03-15,대전,서울,2189,10,128,3,2,87,2419,1704,5,142,4,2,91,1948
2020-03-15,대전,세종,1853,31,34,6,2,128,2054,1622,22,27,6,6,108,1791
2020-03-15,대전,울산,142,0,1,3,10,10,166,95,0,0,1,4,3,103
2020-03-15,대전,전남,508,4,5,3,6,17,543,203,0,4,3,1,4,215
2020-03-15,대전,전북,3283,15,45,10,5,150,3508,4222,24,46,24,15,171,4502
2020-03-15,대전,충남,11146,80,173,56,36,611,12102,10587,88,175,61,38,576,11525
2020-03-15,대전,충북,7904,120,188,34,42,472,8760,6971,85,181,32,32,426,7727
2020-03-15,부산,강원,3,0,0,0,0,0,3,4,0,0,0,0,0,4
2020-03-15,부산,경기,396,4,10,20,32,20,482,202,1,5,37,12,12,269
2020-03-15,부산,경남,65904,606,1016,257,807,4172,72762,70715,565,1006,265,673,4185,77409
2020-03-15,부산,경북,6052,34,108,30,119,273,6616,5362,28,85,31,99,214,5819
2020-03-15,부산,광주,453,0,31,5,14,13,516,451,1,24,12,10,10,508
2020-03-15,부산,대구,3519,24,86,31,26,172,3858,456,8,44,19,9,21,557
2020-03-15,부산,대전,108,0,0,0,2,8,118,96,0,0,0,0,2,98
2020-03-15,부산,부산,47591,129,126,88,316,2655,50905,47591,129,126,88,316,2655,50905
2020-03-15,부산,서울,294,4,7,22,13,15,355,243,4,3,16,10,6,282
2020-03-15,부산,세종,31,0,0,1,1,0,33,21,0,0,0,1,0,22
2020-03-15,부산,울산,15982,64,97,73,309,993,17518,14855,70,48,43,319,927,16262
2020-03-15,부산,전남,2126,11,59,31,79,86,2392,2024,8,39,68,96,76,2311
2020-03-15,부산,전북,306,0,19,6,10,13,354,320,0,23,6,14,10,373
2020-03-15,부산,충남,208,2,7,6,15,14,252,131,0,5,9,14,4,163
2020-03-15,부산,충북,161,1,8,14,21,8,213,91,2,1,15,13,3,125
2020-03-15,서울,강원,883,10,146,0,1,26,1066,1642,6,176,5,4,54,1887
2020-03-15,서울,경기,107099,1809,3519,1152,575,6092,120246,95188,1645,3451,1243,560,5354,107441
2020-03-15,서울,경남,2429,11,308,33,20,78,2879,2069,16,282,128,57,60,2612
2020-03-15,서울,경북,2390,15,146,54,21,84,2710,2501,20,156,137,33,89,2936
2020-03-15,서울,광주,607,10,11,6,6,17,657,933,7,8,8,3,28,987
2020-03-15,서울,대구,1306,4,35,26,11,47,1429,1522,11,53,47,18,55,1706
2020-03-15,서울,대전,1704,5,142,4,2,91,1948,2189,10,128,3,2,87,2419
2020-03-15,서울,부산,243,4,3,16,10,6,282,294,4,7,22,13,15,355
2020-03-15,서울,서울,189,3,8,0,1,14,215,189,3,8,0,1,14,215
2020-03-15,서울,세종,19,0,1,0,0,0,20,21,0,1,0,0,2,24
2020-03-15,서울,울산,22,1,2,0,0,1,26,20,0,2,1,0,0,23
2020-03-15,서울,전남,756,6,9,8,4,22,805,1300,2,12,45,22,40,1421
2020-03-15,서울,전북,1174,6,18,8,1,28,1235,2299,6,21,13,16,92,2447
2020-03-15,서울,충남,29759,139,1510,211,198,1246,33063,35402,186,1424,546,294,1319,39171
2020-03-15,서울,충북,13703,92,535,220,97,609,15256,14435,113,549,219,87,614,16017
2020-03-15,세종,강원,4,0,0,0,1,0,5,7,0,0,0,0,0,7
2020-03-15,세종,경기,49,0,1,3,1,3,57,24,0,2,0,0,1,27
2020-03-15,세종,경남,253,1,5,0,0,10,269,231,1,3,1,0,12,248
2020-03-15,세종,경북,246,0,4,6,1,10,267,241,1,3,3,1,10,259
2020-03-15,세종,광주,140,0,3,0,0,3,146,219,0,4,0,1,4,228
2020-03-15,세종,대구,118,0,1,0,1,7,127,191,0,2,1,0,9,203
2020-03-15,세종,대전,1622,22,27,6,6,108,1791,1853,31,34,6,2,128,2054
2020-03-15,세종,부산,21,0,0,0,1,0,22,31,0,0,1,1,0,33
2020-03-15,세종,서울,21,0,1,0,0,2,24,19,0,1,0,0,0,20
2020-03-15,세종,세종,181,9,1,0,1,6,198,181,9,1,0,1,6,198
2020-03-15,세종,울산,4,0,0,0,0,0,4,6,0,0,0,0,0,6
2020-03-15,세종,전남,175,0,1,0,3,3,182,176,0,2,4,3,6,191
2020-03-15,세종,전북,693,1,7,1,5,27,734,1134,2,5,4,6,54,1205
2020-03-15,세종,충남,4927,44,60,35,40,182,5288,4787,34,60,55,24,177,5137
2020-03-15,세종,충북,291,5,7,8,2,17,330,284,5,3,4,0,25,321
2020-03-15,울산,강원,0,0,0,0,0,0,0,1,0,0,0,0,0,1
2020-03-15,울산,경기,27,0,2,3,8,2,42,25,2,0,1,1,1,30
2020-03-15,울산,경남,8650,98,172,45,82,571,9618,8939,120,173,44,66,570,9912
2020-03-15,울산,경북,4885,29,60,43,208,264,5489,5357,24,76,72,205,254,5988
2020-03-15,울산,광주,56,0,5,1,0,0,62,68,0,3,0,0,3,74
2020-03-15,울산,대구,957,5,31,6,29,37,1065,917,8,29,10,31,46,1041
2020-03-15,울산,대전,95,0,0,1,4,3,103,142,0,1,3,10,10,166
2020-03-15,울산,부산,14855,70,48,43,319,927,16262,15982,64,97,73,309,993,17518
2020-03-15,울산,서울,20,0,2,1,0,0,23,22,1,2,0,0,1,26
2020-03-15,울산,세종,6,0,0,0,0,0,6,4,0,0,0,0,0,4
2020-03-15,울산,울산,4425,42,81,23,82,335,4988,4425,42,81,23,82,335,4988
2020-03-15,울산,전남,206,1,1,5,3,3,219,216,1,3,1,4,7,232
2020-03-15,울산,전북,37,0,4,1,6,3,51,50,0,4,0,0,1,55
2020-03-15,울산,충남,136,1,2,3,31,4,177,109,1,1,3,21,6,141
2020-03-15,울산,충북,19,1,2,0,6,1,29,16,0,0,1,3,1,21
2020-03-15,전남,강원,19,0,1,0,1,0,21,44,1,3,1,3,2,54
2020-03-15,전남,경기,1077,12,42,51,29,36,1247,691,6,46,29,30,17,819
2020-03-15,전남,경남,7459,67,138,104,131,281,8180,6390,60,129,98,135,281,7093
2020-03-15,전남,경북,1185,11,33,15,66,49,1359,1207,21,34,20,80,43,1405
2020-03-15,전남,광주,35692,240,534,221,169,1142,37998,34950,265,589,153,182,1090,37229
2020-03-15,전남,대구,888,5,22,7,12,32,966,613,5,22,11,20,28,699
2020-03-15,전남,대전,203,0,4,3,1,4,215,508,4,5,3,6,17,543
2020-03-15,전남,부산,2024,8,39,68,96,76,2311,2126,11,59,31,79,86,2392
2020-03-15,전남,서울,1300,2,12,45,22,40,1421,756,6,9,8,4,22,805
2020-03-15,전남,세종,176,0,2,4,3,6,191,175,0,1,0,3,3,182
2020-03-15,전남,울산,216,1,3,1,4,7,232,206,1,1,5,3,3,219
2020-03-15,전남,전남,48527,437,593,462,790,1641,52450,48527,437,593,462,790,1641,52450
2020-03-15,전남,전북,11884,118,267,280,784,323,13656,6515,80,169,115,310,194,7383
2020-03-15,전남,충남,3182,15,110,311,108,94,3820,4874,25,272,100,182,161,5614
2020-03-15,전남,충북,221,4,4,20,13,9,271,439,7,13,19,44,21,543
2020-03-15,전북,강원,168,3,4,10,6,7,198,129,1,4,2,0,4,140
2020-03-15,전북,경기,2440,11,70,46,44,82,2693,1248,8,67,30,30,48,1431
2020-03-15,전북,경남,1379,13,59,20,16,39,1526,1268,13,47,27,22,37,1414
2020-03-15,전북,경북,1830,31,42,42,102,55,2102,1489,29,47,32,43,41,1681
2020-03-15,전북,광주,7940,93,167,62,29,265,8556,7795,82,153,54,34,223,8341
2020-03-15,전북,대구,305,0,4,3,1,11,324,242,0,5,2,3,16,268
2020-03-15,전북,대전,4222,24,46,24,15,171,4502,3283,15,45,10,5,150,3508
2020-03-15,전북,부산,320,0,23,6,14,10,373,306,0,19,6,10,13,354
2020-03-15,전북,서울,2299,6,21,13,16,92,2447,1174,6,18,8,1,28,1235
2020-03-15,전북,세종,1134,2,5,4,6,54,1205,693,1,7,1,5,27,734
2020-03-15,전북,울산,50,0,4,0,0,1,55,37,0,4,1,6,3,51
2020-03-15,전북,전남,6515,80,169,115,310,194,7383,11884,118,267,280,784,323,13656
2020-03-15,전북,전북,15185,164,332,164,219,491,16555,15185,164,332,164,219,491,16555
2020-03-15,전북,충남,25038,170,833,347,619,848,27855,14117,123,693,161,224,555,15873
2020-03-15,전북,충북,2701,40,45,119,90,124,3119,1701,38,42,67,48,77,1973
2020-03-15,충남,강원,379,2,9,6,15,12,423,441,3,7,2,7,22,482
2020-03-15,충남,경기,39540,310,968,408,551,1719,43496,33441,284,1004,504,642,1619,37494
2020-03-15,충남,경남,1449,9,37,52,72,57,1676,1354,9,21,42,37,77,1540
2020-03-15,충남,경북,2788,34,76,56,84,95,3133,3037,28,38,69,78,109,3359
2020-03-15,충남,광주,4156,32,339,104,56,127,4814,5651,32,314,124,90,172,6383
2020-03-15,충남,대구,661,6,9,40,14,16,746,1054,10,16,31,36,45,1192
2020-03-15,충남,대전,10587,88,175,61,38,576,11525,11146,80,173,56,36,611,12102
2020-03-15,충남,부산,131,0,5,9,14,4,163,208,2,7,6,15,14,252
2020-03-15,충남,서울,35402,186,1424,546,294,1319,39171,29759,139,1510,211,198,1246,33063
2020-03-15,충남,세종,4787,34,60,55,24,177,5137,4927,44,60,35,40,182,5288
2020-03-15,충남,울산,109,1,1,3,21,6,141,136,1,2,3,31,4,177
2020-03-15,충남,전남,4874,25,272,100,182,161,5614,3182,15,110,311,108,94,3820
2020-03-15,충남,전북,14117,123,693,161,224,555,15873,25038,170,833,347,619,848,27855
2020-03-15,충남,충남,95135,920,3351,1562,1828,3880,106676,95135,920,3351,1562,1828,3880,106676
2020-03-15,충남,충북,9129,160,219,195,237,473,10413,8562,124,240,182,282,458,9848
2020-03-15,충북,강원,3925,53,73,36,78,190,4355,4678,67,80,43,87,210,5165
2020-03-15,충북,경기,27015,471,646,435,432,1285,30284,22441,454,675,492,471,1097,25630
2020-03-15,충북,경남,1312,13,53,89,73,58,1598,1364,10,37,54,60,64,1589
2020-03-15,충북,경북,4329,58,89,109,133,181,4899,4527,59,85,134,152,195,5152
2020-03-15,충북,광주,544,9,25,30,10,17,635,697,4,22,16,11,18,768
2020-03-15,충북,대구,841,7,19,42,23,41,973,1155,12,48,48,64,33,1360
2020-03-15,충북,대전,6971,85,181,32,32,426,7727,7904,120,188,34,42,472,8760
2020-03-15,충북,부산,91,2,1,15,13,3,125,161,1,8,14,21,8,213
2020-03-15,충북,서울,14435,113,549,219,87,614,16017,13703,92,535,220,97,609,15256
2020-03-15,충북,세종,284,5,3,4,0,25,321,291,5,7,8,2,17,330
2020-03-15,충북,울산,16,0,0,1,3,1,21,19,1,2,0,6,1,29
2020-03-15,충북,전남,439,7,13,19,44,21,543,221,4,4,20,13,9,271
2020-03-15,충북,전북,1701,38,42,67,48,77,1973,2701,40,45,119,90,124,3119
2020-03-15,충북,충남,8562,124,240,182,282,458,9848,9129,160,219,195,237,473,10413
2020-03-15,충북,충북,24917,465,541,394,506,1328,28151,24917,465,541,394,506,1328,28151
2020-03-16,강원,강원,57239,2126,2223,1437,2238,3841,69104,57239,2126,2223,1437,2238,3841,69104
2020-03-16,강원,경기,19881,545,793,607,687,906,23419,19083,592,828,593,861,910,22867
2020-03-16,강원,경남,146,4,6,12,18,5,191,95,3,2,17,5,6,128
2020-03-16,강원,경북,332,22,22,18,32,14,440,320,19,20,24,39,14,436
2020-03-16,강원,광주,70,3,9,10,4,0,96,66,1,10,11,9,2,99
2020-03-16,강원,대구,114,4,7,9,6,4,144,193,6,9,17,11,5,241
2020-03-16,강원,대전,138,2,13,4,1,4,162,167,3,13,5,2,3,193
2020-03-16,강원,부산,3,0,1,0,1,0,5,3,0,0,1,0,0,4
2020-03-16,강원,서울,658,9,145,10,17,31,870,746,8,143,14,12,25,948
2020-03-16,강원,세종,3,1,0,0,0,0,4,8,0,0,1,0,1,10
2020-03-16,강원,울산,3,0,0,0,0,0,3,0,0,1,0,0,0,1
2020-03-16,강원,전남,35,0,3,2,7,1,48,17,1,3,0,3,0,24
2020-03-16,강원,전북,120,1,9,14,11,6,161,153,4,11,19,13,5,205
2020-03-16,강원,충남,290,7,13,21,34,16,381,373,11,12,29,58,12,495
2020-03-16,강원,충북,4233,196,246,274,387,259,5595,4339,182,206,167,349,252,5495
2020-03-16,경기,강원,19083,592,828,593,861,910,22867,19881,545,793,607,687,906,23419
2020-03-16,경기,경기,415924,22922,23753,18943,23822,30899,536263,415924,22922,23753,18943,23822,30899,536263
2020-03-16,경기,경남,2404,59,236,421,409,81,3610,1843,56,151,403,373,69,2895
2020-03-16,경기,경북,3206,163,381,594,532,96,4972,2656,187,397,797,499,103,4639
2020-03-16,경기,광주,680,31,140,247,117,24,1239,694,16,104,209,125,29,1177
2020-03-16,경기,대구,1122,66,120,262,152,31,1753,1861,80,145,343,383,78,2890
2020-03-16,경기,대전,1726,96,149,66,43,98,2178,2270,112,165,87,60,114,2808
2020-03-16,경기,부산,185,14,18,73,83,10,383,211,14,34,88,210,11,568
2020-03-16,경기,서울,140476,6905,8156,4545,3658,9412,173152,147977,6665,8608,4774,3323,10030,181377
2020-03-16,경기,세종,39,2,3,4,1,0,49,45,3,2,1,1,2,54
2020-03-16,경기,울산,27,0,2,5,7,0,41,40,0,6,20,48,3,117
2020-03-16,경기,전남,674,15,72,120,108,18,1007,570,17,55,85,62,19,808
2020-03-16,경기,전북,1160,51,124,108,180,41,1664,1294,49,111,192,198,50,1894
2020-03-16,경기,충남,37445,1560,2703,2404,4488,2009,50609,34007,1443,2561,2281,4339,1863,46494
2020-03-16,경기,충북,27164,2228,2798,2960,3357,1315,39822,25144,2125,2521,2791,3543,1244,37368
2020-03-16,경남,강원,95,3,2,17,5,6,128,146,4,6,12,18,5,191
2020-03-16,경남,경기,1843,56,151,403,373,69,2895,2404,59,236,421,409,81,3610
2020-03-16,경남,경남,181059,9756,9547,6801,13674,13627,234464,181059,9756,9547,6801,13674,13627,234464
2020-03-16,경남,경북,8381,613,867,903,1877,379,13020,9682,817,1094,1107,2602,422,15724
2020-03-16,경남,광주,895,47,128,131,135,31,1367,1046,36,138,140,94,34,1488
2020-03-16,경남,대구,9682,657,705,893,1636,383,13956,7475,471,473,389,497,321,9626
2020-03-16,경남,대전,620,16,75,67,24,19,821,905,28,71,61,54,32,1151
2020-03-16,경남,부산,80198,2581,2416,2011,5125,5796,98127,82307,2743,2644,2159,5335,5895,101083
2020-03-16,경남,서울,1634,32,300,213,117,48,2344,2356,49,286,109,65,83,2948
2020-03-16,경남,세종,132,2,2,11,8,5,160,215,2,10,16,11,14,268
2020-03-16,경남,울산,9281,622,634,479,691,603,12310,8444,590,676,436,612,577,11335
2020-03-16,경남,전남,5868,273,445,471,1368,275,8700,5463,292,404,417,1324,242,8142
2020-03-16,경남,전북,1041,48,104,106,191,34,1524,970,46,98,97,163,39,1413
2020-03-16,경남,충남,1022,40,105,253,227,39,1686,1376,38,132,245,399,55,2245
2020-03-16,경남,충북,901,52,126,267,256,30,1632,1120,59,155,313,575,27,2249
2020-03-16,경북,강원,320,19,20,24,39,14,436,332,22,22,18,32,14,440
2020-03-16,경북,경기,2656,187,397,797,499,103,4639,3206,163,381,594,532,96,4972
2020-03-16,경북,경남,9682,817,1094,1107,2602,422,15724,8381,613,867,903,1877,379,13020
2020-03-16,경북,경북,61382,3750,3745,2864,5543,3279,80563,61382,3750,3745,2864,5543,3279,80563
2020-03-16,경북,광주,605,46,112,182,97,19,1061,651,39,98,143,73,11,1015
2020-03-16,경북,대구,57460,2666,2115,1315,3354,3112,70022,64024,2924,2564,1744,3944,3282,78482
2020-03-16,경북,대전,1361,53,86,87,81,67,1735,1652,38,90,91,65,58,1994
2020-03-16,경북,부산,3291,102,185,179,626,161,4544,4178,100,195,201,795,168,5637
2020-03-16,경북,서울,1863,78,212,340,143,68,2704,2430,53,203,172,75,94,3027
2020-03-16,경북,세종,202,4,15,28,17,6,272,244,6,11,19,7,13,300
2020-03-16,경북,울산,4264,148,287,368,1018,267,6352,4208,152,277,346,1230,261,6474
2020-03-16,경북,전남,895,38,73,93,378,34,1511,740,38,54,87,305,25,1249
2020-03-16,경북,전북,1630,75,159,184,230,54,2332,1525,102,154,150,445,45,2421
2020-03-16,경북,충남,2686,127,329,514,600,114,4370,2667,114,326,435,686,112,4340
2020-03-16,경북,충북,3956,220,464,684,992,170,6486,4049,216,483,595,1067,164,6574
2020-03-16,광주,강원,66,1,10,11,9,2,99,70,3,9,10,4,0,96
2020-03-16,광주,경기,694,16,104,209,125,29,1177,680,31,140,247,117,24,1239
2020-03-16,광주,경남,1046,36,138,140,94,34,1488,895,47,128,131,135,31,1367
2020-03-16,광주,경북,651,39,98,143,73,11,1015,605,46,112,182,97,19,1061
2020-03-16,광주,광주,13111,458,545,385,392,490,15381,13111,458,545,385,392,490,15381
2020-03-16,광주,대구,369,27,40,74,23,10,543,419,34,45,63,28,13,602
2020-03-16,광주,대전,368,14,15,15,12,15,439,420,14,11,11,14,19,489
2020-03-16,광주,부산,316,5,28,31,64,8,452,306,11,38,62,112,13,542
2020-03-16,광주,서울,560,17,21,51,19,18,686,619,19,15,20,17,18,708
2020-03-16,광주,세종,134,1,8,1,1,4,149,160,2,8,5,0,3,178
2020-03-16,광주,울산,52,1,11,2,6,0,72,40,1,8,6,5,3,63
2020-03-16,광주,전남,33450,974,1112,758,2028,1306,39628,30171,910,936,661,1882,1241,35801
2020-03-16,광주,전북,7422,394,454,358,403,282,9313,7039,425,450,330,391,256,8891
2020-03-16,광주,충남,4052,100,419,447,253,108,5379,3751,116,396,491,298,114,5166
2020-03-16,광주,충북,594,15,57,112,80,15,873,520,28,74,165,80,17,884
2020-03-16,대구,강원,193,6,9,17,11,5,241,114,4,7,9,6,4,144
2020-03-16,대구,경기,1861,80,145,343,383,78,2890,1122,66,120,262,152,31,1753
2020-03-16,대구,경남,7475,471,473,389,497,321,9626,9682,657,705,893,1636,383,13956
2020-03-16,대구,경북,64024,2924,2564,1744,3944,3282,78482,57460,2666,2115,1315,3354,3112,70022
2020-03-16,대구,광주,419,34,45,63,28,13,602,369,27,40,74,23,10,543
2020-03-16,대구,대구,50791,1946,1438,755,1146,3346,59422,50791,1946,1438,755,1146,3346,59422
2020-03-16,대구,대전,657,31,19,47,30,22,806,399,13,16,25,22,24,499
2020-03-16,대구,부산,427,48,71,42,132,20,740,2233,82,105,96,224,108,2848
2020-03-16,대구,서울,1707,48,74,162,91,59,2141,1130,28,57,69,21,27,1332
2020-03-16,대구,세종,191,2,4,6,8,7,218,114,2,2,3,0,2,123
2020-03-16,대구,울산,899,51,63,59,146,29,1247,795,57,63,65,175,38,1193
2020-03-16,대구,전남,394,8,33,21,42,7,505,355,13,29,23,45,9,474
2020-03-16,대구,전북,222,10,22,17,29,11,311,180,12,15,20,17,11,255
2020-03-16,대구,충남,1103,55,116,172,232,43,1721,601,50,84,121,168,20,1044
2020-03-16,대구,충북,1234,87,127,246,397,55,2146,704,73,100,132,122,36,1167
2020-03-16,대전,강원,167,3,13,5,2,3,193,138,2,13,4,1,4,162
2020-03-16,대전,경기,2270,112,165,87,60,114,2808,1726,96,149,66,43,98,2178
2020-03-16,대전,경남,905,28,71,61,54,32,1151,620,16,75,67,24,19,821
2020-03-16,대전,경북,1652,38,90,91,65,58,1994,1361,53,86,87,81,67,1735
2020-03-16,대전,광주,420,14,11,11,14,19,489,368,14,15,15,12,15,439
2020-03-16,대전,대구,399,13,16,25,22,24,499,657,31,19,47,30,22,806
2020-03-16,대전,대전,12964,401,419,397,216,1012,15409,12964,401,419,397,216,1012,15409
2020-03-16,대전,부산,76,2,7,2,12,3,102,60,3,5,8,12,3,91
2020-03-16,대전,서울,1756,39,129,25,16,81,2046,1563,44,123,22,8,80,1840
2020-03-16,대전,세종,3125,90,81,25,75,255,3651,3249,94,76,33,81,243,3776
2020-03-16,대전,울산,121,1,3,7,30,4,166,97,4,0,10,21,3,135
2020-03-16,대전,전남,294,4,3,14,25,14,354,98,3,2,9,10,6,128
2020-03-16,대전,전북,3046,74,69,50,36,135,3410,2865,87,79,70,66,122,3289
2020-03-16,대전,충남,15753,471,466,241,241,1181,18353,13423,425,442,229,232,1059,15810
2020-03-16,대전,충북,10744,438,444,209,200,785,12820,9124,378,363,164,160,699,10888
2020-03-16,부산,강원,3,0,0,1,0,0,4,3,0,1,0,1,0,5
2020-03-16,부산,경기,211,14,34,88,210,11,568,185,14,18,73,83,10,383
2020-03-16,부산,경남,82307,2743,2644,2159,5335,5895,101083,80198,2581,2416,2011,5125,5796,98127
2020-03-16,부산,경북,4178,100,195,201,795,168,5637,3291,102,185,179,626,161,4544
2020-03-16,부산,광주,306,11,38,62,112,13,542,316,5,28,31,64,8,452
2020-03-16,부산,대구,2233,82,105,96,224,108,2848,427,48,71,42,132,20,740
2020-03-16,부산,대전,60,3,5,8,12,3,91,76,2,7,2,12,3,102
2020-03-16,부산,부산,40105,706,556,683,2278,2953,47281,40105,706,556,683,2278,2953,47281
2020-03-16,부산,서울,183,10,7,58,52,7,317,176,12,4,25,23,3,243
2020-03-16,부산,세종,13,0,1,7,2,0,23,14,0,2,0,2,0,18
2020-03-16,부산,울산,15606,356,466,598,2524,1114,20664,14409,372,407,418,2513,1047,19166
2020-03-16,부산,전남,1795,81,108,181,508,71,2744,1454,67,84,115,522,69,2311
2020-03-16,부산,전북,239,8,23,26,82,6,384,202,8,21,37,58,7,333
2020-03-16,부산,충남,159,5,17,55,130,5,371,141,8,16,35,127,4,331
2020-03-16,부산,충북,116,9,20,57,152,5,359,73,12,20,70,179,4,358
2020-03-16,서울,강원,746,8,143,14,12,25,948,658,9,145,10,17,31,870
2020-03-16,서울,경기,147977,6665,8608,4774,3323,10030,181377,140476,6905,8156,4545,3658,9412,173152
2020-03-16,서울,경남,2356,49,286,109,65,83,2948,1634,32,300,213,117,48,2344
2020-03-16,서울,경북,2430,53,203,172,75,94,3027,1863,78,212,340,143,68,2704
2020-03-16,서울,광주,619,19,15,20,17,18,708,560,17,21,51,19,18,686
2020-03-16,서울,대구,1130,28,57,69,21,27,1332,1707,48,74,162,91,59,2141
2020-03-16,서울,대전,1563,44,123,22,8,80,1840,1756,39,129,25,16,81,2046
2020-03-16,서울,부산,176,12,4,25,23,3,243,183,10,7,58,52,7,317
2020-03-16,서울,서울,192,8,8,3,6,11,228,192,8,8,3,6,11,228
2020-03-16,서울,세종,27,0,0,0,0,1,28,29,0,0,1,1,1,32
2020-03-16,서울,울산,25,0,2,0,1,0,28,17,0,2,5,10,1,35
2020-03-16,서울,전남,745,11,25,29,16,34,860,650,6,16,53,25,17,767
2020-03-16,서울,전북,1183,18,32,20,30,55,1338,1085,26,33,37,27,46,1254
2020-03-16,서울,충남,26844,492,1857,708,761,1133,31795,24263,536,1808,1228,1226,974,30035
2020-03-16,서울,충북,14274,527,883,702,656,627,17669,11529,615,915,761,767,554,15141
2020-03-16,세종,강원,8,0,0,1,0,1,10,3,1,0,0,0,0,4
2020-03-16,세종,경기,45,3,2,1,1,2,54,39,2,3,4,1,0,49
2020-03-16,세종,경남,215,2,10,16,11,14,268,132,2,2,11,8,5,160
2020-03-16,세종,경북,244,6,11,19,7,13,300,202,4,15,28,17,6,272
2020-03-16,세종,광주,160,2,8,5,0,3,178,134,1,8,1,1,4,149
2020-03-16,세종,대구,114,2,2,3,0,2,123,191,2,4,6,8,7,218
2020-03-16,세종,대전,3249,94,76,33,81,243,3776,3125,90,81,25,75,255,3651
2020-03-16,세종,부산,14,0,2,0,2,0,18,13,0,1,7,2,0,23
2020-03-16,세종,서울,29,0,0,1,1,1,32,27,0,0,0,0,1,28
2020-03-16,세종,세종,214,20,2,4,1,16,257,214,20,2,4,1,16,257
2020-03-16,세종,울산,7,0,0,3,4,0,14,8,0,0,0,4,0,12
2020-03-16,세종,전남,155,4,3,9,14,3,188,90,2,0,6,5,2,105
2020-03-16,세종,전북,644,23,21,16,27,30,761,612,13,17,22,47,25,736
2020-03-16,세종,충남,5856,144,156,130,220,293,6799,3978,128,133,124,166,217,4746
2020-03-16,세종,충북,360,15,18,19,17,30,459,299,20,23,8,30,20,400
2020-03-16,울산,강원,0,0,1,0,0,0,1,3,0,0,0,0,0,3
2020-03-16,울산,경기,40,0,6,20,48,3,117,27,0,2,5,7,0,41
2020-03-16,울산,경남,8444,590,676,436,612,577,11335,9281,622,634,479,691,603,12310
2020-03-16,울산,경북,4208,152,277,346,1230,261,6474,4264,148,287,368,1018,267,6352
2020-03-16,울산,광주,40,1,8,6,5,3,63,52,1,11,2,6,0,72
2020-03-16,울산,대구,795,57,63,65,175,38,1193,899,51,63,59,146,29,1247
2020-03-16,울산,대전,97,4,0,10,21,3,135,121,1,3,7,30,4,166
2020-03-16,울산,부산,14409,372,407,418,2513,1047,19166,15606,356,466,598,2524,1114,20664
2020-03-16,울산,서울,17,0,2,5,10,1,35,25,0,2,0,1,0,28
2020-03-16,울산,세종,8,0,0,0,4,0,12,7,0,0,3,4,0,14
2020-03-16,울산,울산,7354,296,481,307,577,619,9634,7354,296,481,307,577,619,9634
2020-03-16,울산,전남,184,11,27,19,26,9,276,136,16,28,6,41,8,235
2020-03-16,울산,전북,31,0,5,2,13,1,52,40,0,4,4,1,5,54
2020-03-16,울산,충남,143,3,9,33,130,4,322,143,4,9,21,95,0,272
2020-03-16,울산,충북,20,2,4,15,38,0,79,15,4,0,9,35,0,63
2020-03-16,전남,강원,17,1,3,0,3,0,24,35,0,3,2,7,1,48
2020-03-16,전남,경기,570,17,55,85,62,19,808,674,15,72,120,108,18,1007
2020-03-16,전남,경남,5463,292,404,417,1324,242,8142,5868,273,445,471,1368,275,8700
2020-03-16,전남,경북,740,38,54,87,305,25,1249,895,38,73,93,378,34,1511
2020-03-16,전남,광주,30171,910,936,661,1882,1241,35801,33450,974,1112,758,2028,1306,39628
2020-03-16,전남,대구,355,13,29,23,45,9,474,394,8,33,21,42,7,505
2020-03-16,전남,대전,98,3,2,9,10,6,128,294,4,3,14,25,14,354
2020-03-16,전남,부산,1454,67,84,115,522,69,2311,1795,81,108,181,508,71,2744
2020-03-16,전남,서울,650,6,16,53,25,17,767,745,11,25,29,16,34,860
2020-03-16,전남,세종,90,2,0,6,5,2,105,155,4,3,9,14,3,188
2020-03-16,전남,울산,136,16,28,6,41,8,235,184,11,27,19,26,9,276
2020-03-16,전남,전남,42657,1335,1478,1478,4701,1748,53397,42657,1335,1478,1478,4701,1748,53397
2020-03-16,전남,전북,6751,295,689,777,2696,202,11410,4597,211,466,534,1297,133,7238
2020-03-16,전남,충남,1638,44,165,405,255,48,2555,4365,83,354,394,894,134,6224
2020-03-16,전남,충북,120,14,18,44,48,5,249,382,17,48,96,225,13,781
2020-03-16,전북,강원,153,4,11,19,13,5,205,120,1,9,14,11,6,161
2020-03-16,전북,경기,1294,49,111,192,198,50,1894,1160,51,124,108,180,41,1664
2020-03-16,전북,경남,970,46,98,97,163,39,1413,1041,48,104,106,191,34,1524
2020-03-16,전북,경북,1525,102,154,150,445,45,2421,1630,75,159,184,230,54,2332
2020-03-16,전북,광주,7039,425,450,330,391,256,8891,7422,394,454,358,403,282,9313
2020-03-16,전북,대구,180,12,15,20,17,11,255,222,10,22,17,29,11,311
2020-03-16,전북,대전,2865,87,79,70,66,122,3289,3046,74,69,50,36,135,3410
2020-03-16,전북,부산,202,8,21,37,58,7,333,239,8,23,26,82,6,384
2020-03-16,전북,서울,1085,26,33,37,27,46,1254,1183,18,32,20,30,55,1338
2020-03-16,전북,세종,612,13,17,22,47,25,736,644,23,21,16,27,30,761
2020-03-16,전북,울산,40,0,4,4,1,5,54,31,0,5,2,13,1,52
2020-03-16,전북,전남,4597,211,466,534,1297,133,7238,6751,295,689,777,2696,202,11410
2020-03-16,전북,전북,16034,655,825,653,1237,617,20021,16034,655,825,653,1237,617,20021
2020-03-16,전북,충남,15154,531,1436,1316,2305,580,21322,12405,481,1227,827,1258,457,16655
2020-03-16,전북,충북,1841,126,174,302,440,74,2957,1579,136,190,246,270,70,2491
2020-03-16,충남,강원,373,11,12,29,58,12,495,290,7,13,21,34,16,381
2020-03-16,충남,경기,34007,1443,2561,2281,4339,1863,46494,37445,1560,2703,2404,4488,2009,50609
2020-03-16,충남,경남,1376,38,132,245,399,55,2245,1022,40,105,253,227,39,1686
2020-03-16,충남,경북,2667,114,326,435,686,112,4340,2686,127,329,514,600,114,4370
2020-03-16,충남,광주,3751,116,396,491,298,114,5166,4052,100,419,447,253,108,5379
2020-03-16,충남,대구,601,50,84,121,168,20,1044,1103,55,116,172,232,43,1721
2020-03-16,충남,대전,13423,425,442,229,232,1059,15810,15753,471,466,241,241,1181,18353
2020-03-16,충남,부산,141,8,16,35,127,4,331,159,5,17,55,130,5,371
2020-03-16,충남,서울,24263,536,1808,1228,1226,974,30035,26844,492,1857,708,761,1133,31795
2020-03-16,충남,세종,3978,128,133,124,166,217,4746,5856,144,156,130,220,293,6799
2020-03-16,충남,울산,143,4,9,21,95,0,272,143,3,9,33,130,4,322
2020-03-16,충남,전남,4365,83,354,394,894,134,6224,1638,44,165,405,255,48,2555
2020-03-16,충남,전북,12405,481,1227,827,1258,457,16655,15154,531,1436,1316,2305,580,21322
2020-03-16,충남,충남,91202,3515,6862,6380,10187,4561,122707,91202,3515,6862,6380,10187,4561,122707
2020-03-16,충남,충북,12709,632,796,857,1431,704,17129,11607,618,789,800,1395,673,15882
2020-03-16,충북,강원,4339,182,206,167,349,252,5495,4233,196,246,274,387,259,5595
2020-03-16,충북,경기,25144,2125,2521,2791,3543,1244,37368,27164,2228,2798,2960,3357,1315,39822
2020-03-16,충북,경남,1120,59,155,313,575,27,2249,901,52,126,267,256,30,1632
2020-03-16,충북,경북,4049,216,483,595,1067,164,6574,3956,220,464,684,992,170,6486
2020-03-16,충북,광주,520,28,74,165,80,17,884,594,15,57,112,80,15,873
2020-03-16,충북,대구,704,73,100,132,122,36,1167,1234,87,127,246,397,55,2146
2020-03-16,충북,대전,9124,378,363,164,160,699,10888,10744,438,444,209,200,785,12820
2020-03-16,충북,부산,73,12,20,70,179,4,358,116,9,20,57,152,5,359
2020-03-16,충북,서울,11529,615,915,761,767,554,15141,14274,527,883,702,656,627,17669
2020-03-16,충북,세종,299,20,23,8,30,20,400,360,15,18,19,17,30,459
2020-03-16,충북,울산,15,4,0,9,35,0,63,20,2,4,15,38,0,79
2020-03-16,충북,전남,382,17,48,96,225,13,781,120,14,18,44,48,5,249
2020-03-16,충북,전북,1579,136,190,246,270,70,2491,1841,126,174,302,440,74,2957
2020-03-16,충북,충남,11607,618,789,800,1395,673,15882,12709,632,796,857,1431,704,17129
2020-03-16,충북,충북,33141,1920,2238,2092,3194,2045,44630,33141,1920,2238,2092,3194,2045,44630
2020-03-17,강원,강원,54488,2193,2356,1391,2829,3878,67135,54488,2193,2356,1391,2829,3878,67135
2020-03-17,강원,경기,16253,593,897,679,811,793,20026,17295,649,889,713,969,886,21401
2020-03-17,강원,경남,82,4,12,9,19,4,130,70,0,4,17,12,1,104
2020-03-17,강원,경북,276,18,24,18,26,8,370,233,13,17,31,29,3,326
2020-03-17,강원,광주,52,1,11,13,7,5,89,57,4,5,12,2,0,80
2020-03-17,강원,대구,109,3,10,8,7,3,140,185,7,11,18,14,6,241
2020-03-17,강원,대전,117,0,12,4,2,4,139,135,13,10,7,3,1,169
2020-03-17,강원,부산,3,1,1,1,7,0,13,2,1,2,2,0,0,7
2020-03-17,강원,서울,542,19,119,7,22,20,729,636,26,114,13,17,24,830
2020-03-17,강원,세종,5,0,0,1,0,0,6,11,0,0,2,2,1,16
2020-03-17,강원,울산,1,0,0,0,1,0,2,1,0,0,0,1,0,2
2020-03-17,강원,전남,37,0,2,1,14,2,56,19,0,1,0,9,0,29
2020-03-17,강원,전북,87,3,10,4,17,4,125,130,7,15,26,38,7,223
2020-03-17,강원,충남,248,5,17,28,40,3,341,330,13,21,44,66,14,488
2020-03-17,강원,충북,3671,241,258,271,442,206,5089,3832,206,246,236,374,223,5117
2020-03-17,경기,강원,17295,649,889,713,969,886,21401,16253,593,897,679,811,793,20026
2020-03-17,경기,경기,409035,23538,24784,20744,24779,30468,533348,409035,23538,24784,20744,24779,30468,533348
2020-03-17,경기,경남,2161,111,268,793,639,55,4027,1444,65,239,578,485,60,2871
2020-03-17,경기,경북,2574,181,447,724,642,89,4657,2442,206,418,987,610,92,4755
2020-03-17,경기,광주,666,38,130,337,189,25,1385,559,26,107,276,137,15,1120
2020-03-17,경기,대구,1013,88,145,420,226,35,1927,1607,115,162,480,520,44,2928
2020-03-17,경기,대전,1762,91,152,124,50,80,2259,1745,107,143,115,47,78,2235
2020-03-17,경기,부산,163,17,52,203,139,1,575,151,25,29,189,317,3,714
2020-03-17,경기,서울,139428,7270,8441,5430,4073,9382,174024,141710,6931,8672,5077,3786,9522,175698
2020-03-17,경기,세종,32,3,2,2,2,0,41,45,3,3,2,3,1,57
2020-03-17,경기,울산,31,3,3,11,9,0,57,23,4,9,44,68,0,148
2020-03-17,경기,전남,673,26,89,168,160,15,1131,516,17,63,116,94,9,815
2020-03-17,경기,전북,1070,55,131,147,207,28,1638,1185,54,131,229,258,29,1886
2020-03-17,경기,충남,33294,1630,2802,2689,4913,1718,47046,32305,1559,2663,2515,4610,1705,45357
2020-03-17,경기,충북,23847,2249,2880,3393,3643,1178,37190,23360,2167,2684,2943,3849,1155,36158
2020-03-17,경남,강원,70,0,4,17,12,1,104,82,4,12,9,19,4,130
2020-03-17,경남,경기,1444,65,239,578,485,60,2871,2161,111,268,793,639,55,4027
2020-03-17,경남,경남,181241,10247,9876,7814,14910,13793,237881,181241,10247,9876,7814,14910,13793,237881
2020-03-17,경남,경북,7496,627,928,958,1977,336,12322,9151,884,1079,1258,2729,435,15536
2020-03-17,경남,광주,918,52,138,200,142,28,1478,894,54,131,154,115,19,1367
2020-03-17,경남,대구,9186,724,760,1059,1975,339,14043,7169,489,544,439,522,281,9444
2020-03-17,경남,대전,537,17,86,80,61,17,798,749,39,90,125,64,29,1096
2020-03-17,경남,부산,80497,2617,2471,1919,5056,5789,98349,80641,2747,2736,2025,5230,5704,99083
2020-03-17,경남,서울,1494,35,281,317,169,39,2335,2186,51,301,219,109,58,2924
2020-03-17,경남,세종,98,1,13,12,8,2,134,176,5,10,11,16,4,222
2020-03-17,경남,울산,8683,621,658,486,652,578,11678,8389,560,693,431,647,533,11253
2020-03-17,경남,전남,5635,289,441,526,1534,262,8687,5279,301,428,422,1376,259,8065
2020-03-17,경남,전북,862,48,118,109,217,34,1388,891,53,112,105,211,27,1399
2020-03-17,경남,충남,817,46,121,282,282,21,1569,1155,46,149,332,572,40,2294
2020-03-17,경남,충북,802,60,126,316,344,18,1666,1044,70,210,515,642,26,2507
2020-03-17,경북,강원,233,13,17,31,29,3,326,276,18,24,18,26,8,370
2020-03-17,경북,경기,2442,206,418,987,610,92,4755,2574,181,447,724,642,89,4657
2020-03-17,경북,경남,9151,884,1079,1258,2729,435,15536,7496,627,928,958,1977,336,12322
2020-03-17,경북,경북,61239,3838,3795,3199,5929,3281,81281,61239,3838,3795,3199,5929,3281,81281
2020-03-17,경북,광주,542,69,101,189,141,14,1056,539,48,99,155,92,12,945
2020-03-17,경북,대구,59607,2955,2293,1725,3541,3170,73291,62527,3074,2658,2167,4158,3269,77853
2020-03-17,경북,대전,1166,67,95,120,91,47,1586,1216,69,88,125,83,55,1636
2020-03-17,경북,부산,3235,118,199,209,660,142,4563,3413,131,183,199,744,158,4828
2020-03-17,경북,서울,1679,103,244,452,174,46,2698,1794,79,195,254,118,56,2496
2020-03-17,경북,세종,185,6,16,22,23,9,261,201,14,13,17,14,5,264
2020-03-17,경북,울산,4011,175,305,427,1168,230,6316,4017,163,295,359,1369,215,6418
2020-03-17,경북,전남,818,43,81,120,444,20,1526,668,37,64,79,329,17,1194
2020-03-17,경북,전북,1529,91,194,191,299,41,2345,1436,107,186,144,497,45,2415
2020-03-17,경북,충남,2184,149,341,584,605,71,3934,2367,136,371,519,830,83,4306
2020-03-17,경북,충북,3703,258,491,743,1029,139,6363,3611,276,526,681,1186,133,6413
2020-03-17,광주,강원,57,4,5,12,2,0,80,52,1,11,13,7,5,89
2020-03-17,광주,경기,559,26,107,276,137,15,1120,666,38,130,337,189,25,1385
2020-03-17,광주,경남,894,54,131,154,115,19,1367,918,52,138,200,142,28,1478
2020-03-17,광주,경북,539,48,99,155,92,12,945,542,69,101,189,141,14,1056
2020-03-17,광주,광주,13265,526,580,530,330,550,15781,13265,526,580,530,330,550,15781
2020-03-17,광주,대구,317,29,70,81,35,10,542,347,29,74,71,31,4,556
2020-03-17,광주,대전,337,19,15,24,16,13,424,407,24,20,29,12,14,506
2020-03-17,광주,부산,310,7,45,38,72,10,482,285,14,50,68,87,9,513
2020-03-17,광주,서울,499,20,27,60,31,13,650,670,15,26,57,23,17,808
2020-03-17,광주,세종,108,2,5,6,3,2,126,113,5,6,8,3,1,136
2020-03-17,광주,울산,47,0,5,7,4,0,63,39,1,7,8,8,0,63
2020-03-17,광주,전남,31889,1014,1131,878,2232,1249,38393,30523,995,975,769,2093,1182,36537
2020-03-17,광주,전북,6842,467,515,401,388,243,8856,7023,506,496,396,414,273,9108
2020-03-17,광주,충남,3414,132,409,502,273,111,4841,3474,166,447,646,383,93,5209
2020-03-17,광주,충북,452,30,67,131,63,10,753,498,35,85,199,118,15,950
2020-03-17,대구,강원,185,7,11,18,14,6,241,109,3,10,8,7,3,140
2020-03-17,대구,경기,1607,115,162,480,520,44,2928,1013,88,145,420,226,35,1927
2020-03-17,대구,경남,7169,489,544,439,522,281,9444,9186,724,760,1059,1975,339,14043
2020-03-17,대구,경북,62527,3074,2658,2167,4158,3269,77853,59607,2955,2293,1725,3541,3170,73291
2020-03-17,대구,광주,347,29,74,71,31,4,556,317,29,70,81,35,10,542
2020-03-17,대구,대구,52093,2073,1627,1257,1375,3458,61883,52093,2073,1627,1257,1375,3458,61883
2020-03-17,대구,대전,559,32,43,94,42,27,797,324,18,19,55,28,16,460
2020-03-17,대구,부산,409,51,101,55,168,13,797,1991,100,149,84,232,95,2651
2020-03-17,대구,서울,1447,63,88,263,102,51,2014,924,52,68,150,63,25,1282
2020-03-17,대구,세종,150,5,7,8,8,3,181,73,5,3,5,5,1,92
2020-03-17,대구,울산,746,50,70,85,123,28,1102,783,44,71,70,167,29,1164
2020-03-17,대구,전남,389,16,33,27,55,8,528,424,23,30,32,52,10,571
2020-03-17,대구,전북,186,13,24,16,30,4,273,176,20,27,15,36,2,276
2020-03-17,대구,충남,872,66,126,222,261,26,1573,577,55,98,192,208,15,1145
2020-03-17,대구,충북,1035,97,175,271,439,33,2050,670,78,145,255,169,21,1338
2020-03-17,대전,강원,135,13,10,7,3,1,169,117,0,12,4,2,4,139
2020-03-17,대전,경기,1745,107,143,115,47,78,2235,1762,91,152,124,50,80,2259
2020-03-17,대전,경남,749,39,90,125,64,29,1096,537,17,86,80,61,17,798
2020-03-17,대전,경북,1216,69,88,125,83,55,1636,1166,67,95,120,91,47,1586
2020-03-17,대전,광주,407,24,20,29,12,14,506,337,19,15,24,16,13,424
2020-03-17,대전,대구,324,18,19,55,28,16,460,559,32,43,94,42,27,797
2020-03-17,대전,대전,13049,414,396,326,400,948,15533,13049,414,396,326,400,948,15533
2020-03-17,대전,부산,54,4,7,20,17,2,104,51,1,9,16,23,0,100
2020-03-17,대전,서울,1449,45,128,40,7,50,1719,1456,35,133,38,6,55,1723
2020-03-17,대전,세종,3024,82,62,54,73,239,3534,3054,89,68,64,80,221,3576
2020-03-17,대전,울산,82,4,7,17,29,1,140,71,4,7,16,20,0,118
2020-03-17,대전,전남,286,6,7,31,23,10,363,89,1,6,11,9,2,118
2020-03-17,대전,전북,2574,92,83,92,42,115,2998,2749,102,84,80,65,112,3192
2020-03-17,대전,충남,14998,477,515,279,208,1138,17615,13410,458,465,246,244,1013,15836
2020-03-17,대전,충북,10111,450,432,186,205,784,12168,9098,408,377,188,191,728,10990
2020-03-17,부산,강원,2,1,2,2,0,0,7,3,1,1,1,7,0,13
2020-03-17,부산,경기,151,25,29,189,317,3,714,163,17,52,203,139,1,575
2020-03-17,부산,경남,80641,2747,2736,2025,5230,5704,99083,80497,2617,2471,1919,5056,5789,98349
2020-03-17,부산,경북,3413,131,183,199,744,158,4828,3235,118,199,209,660,142,4563
2020-03-17,부산,광주,285,14,50,68,87,9,513,310,7,45,38,72,10,482
2020-03-17,부산,대구,1991,100,149,84,232,95,2651,409,51,101,55,168,13,797
2020-03-17,부산,대전,51,1,9,16,23,0,100,54,4,7,20,17,2,104
2020-03-17,부산,부산,40212,709,584,705,2246,3075,47531,40212,709,584,705,2246,3075,47531
2020-03-17,부산,서울,141,19,18,103,69,5,355,204,13,17,58,37,5,334
2020-03-17,부산,세종,8,1,0,3,4,0,16,16,2,1,1,5,0,25
2020-03-17,부산,울산,14448,362,441,646,2570,1055,19522,14399,385,425,439,2505,1074,19227
2020-03-17,부산,전남,1550,90,103,184,538,61,2526,1471,99,101,134,548,64,2417
2020-03-17,부산,전북,222,3,27,28,105,7,392,183,4,20,38,74,8,327
2020-03-17,부산,충남,105,12,28,57,144,7,353,105,11,25,89,217,4,451
2020-03-17,부산,충북,74,15,23,102,211,2,427,66,25,21,118,213,2,445
2020-03-17,서울,강원,636,26,114,13,17,24,830,542,19,119,7,22,20,729
2020-03-17,서울,경기,141710,6931,8672,5077,3786,9522,175698,139428,7270,8441,5430,4073,9382,174024
2020-03-17,서울,경남,2186,51,301,219,109,58,2924,1494,35,281,317,169,39,2335
2020-03-17,서울,경북,1794,79,195,254,118,56,2496,1679,103,244,452,174,46,2698
2020-03-17,서울,광주,670,15,26,57,23,17,808,499,20,27,60,31,13,650
2020-03-17,서울,대구,924,52,68,150,63,25,1282,1447,63,88,263,102,51,2014
2020-03-17,서울,대전,1456,35,133,38,6,55,1723,1449,45,128,40,7,50,1719
2020-03-17,서울,부산,204,13,17,58,37,5,334,141,19,18,103,69,5,355
2020-03-17,서울,서울,179,8,7,2,1,14,211,179,8,7,2,1,14,211
2020-03-17,서울,세종,41,0,0,0,0,0,41,24,0,0,0,0,0,24
2020-03-17,서울,울산,22,1,2,4,2,2,33,19,0,3,9,12,1,44
2020-03-17,서울,전남,752,13,20,42,26,20,873,582,14,27,64,36,18,741
2020-03-17,서울,전북,1100,12,44,29,31,36,1252,979,29,41,42,35,38,1164
2020-03-17,서울,충남,23225,610,1846,842,751,957,28231,22346,689,1764,1379,1272,902,28352
2020-03-17,서울,충북,11937,537,911,841,761,509,15496,11413,662,925,884,855,451,15190
2020-03-17,세종,강원,11,0,0,2,2,1,16,5,0,0,1,0,0,6
2020-03-17,세종,경기,45,3,3,2,3,1,57,32,3,2,2,2,0,41
2020-03-17,세종,경남,176,5,10,11,16,4,222,98,1,13,12,8,2,134
2020-03-17,세종,경북,201,14,13,17,14,5,264,185,6,16,22,23,9,261
2020-03-17,세종,광주,113,5,6,8,3,1,136,108,2,5,6,3,2,126
2020-03-17,세종,대구,73,5,3,5,5,1,92,150,5,7,8,8,3,181
2020-03-17,세종,대전,3054,89,68,64,80,221,3576,3024,82,62,54,73,239,3534
2020-03-17,세종,부산,16,2,1,1,5,0,25,8,1,0,3,4,0,16
2020-03-17,세종,서울,24,0,0,0,0,0,24,41,0,0,0,0,0,41
2020-03-17,세종,세종,208,22,4,4,3,17,258,208,22,4,4,3,17,258
2020-03-17,세종,울산,11,0,0,2,4,0,17,10,0,0,2,7,1,20
2020-03-17,세종,전남,127,3,4,11,25,5,175,52,3,4,7,7,2,75
2020-03-17,세종,전북,549,17,23,17,35,21,662,571,10,17,17,46,23,684
2020-03-17,세종,충남,5181,162,159,131,205,265,6103,3947,129,156,122,174,208,4736
2020-03-17,세종,충북,348,15,17,15,16,28,439,305,20,22,17,33,30,427
2020-03-17,울산,강원,1,0,0,0,1,0,2,1,0,0,0,1,0,2
2020-03-17,울산,경기,23,4,9,44,68,0,148,31,3,3,11,9,0,57
2020-03-17,울산,경남,8389,560,693,431,647,533,11253,8683,621,658,486,652,578,11678
2020-03-17,울산,경북,4017,163,295,359,1369,215,6418,4011,175,305,427,1168,230,6316
2020-03-17,울산,광주,39,1,7,8,8,0,63,47,0,5,7,4,0,63
2020-03-17,울산,대구,783,44,71,70,167,29,1164,746,50,70,85,123,28,1102
2020-03-17,울산,대전,71,4,7,16,20,0,118,82,4,7,17,29,1,140
2020-03-17,울산,부산,14399,385,425,439,2505,1074,19227,14448,362,441,646,2570,1055,19522
2020-03-17,울산,서울,19,0,3,9,12,1,44,22,1,2,4,2,2,33
2020-03-17,울산,세종,10,0,0,2,7,1,20,11,0,0,2,4,0,17
2020-03-17,울산,울산,7630,295,482,374,635,683,10099,7630,295,482,374,635,683,10099
2020-03-17,울산,전남,140,14,17,17,33,4,225,150,14,22,16,48,3,253
2020-03-17,울산,전북,28,2,6,1,17,2,56,36,0,6,2,7,1,52
2020-03-17,울산,충남,104,10,21,53,125,3,316,71,6,11,37,106,2,233
2020-03-17,울산,충북,19,2,4,22,48,0,95,19,3,3,15,34,1,75
2020-03-17,전남,강원,19,0,1,0,9,0,29,37,0,2,1,14,2,56
2020-03-17,전남,경기,516,17,63,116,94,9,815,673,26,89,168,160,15,1131
2020-03-17,전남,경남,5279,301,428,422,1376,259,8065,5635,289,441,526,1534,262,8687
2020-03-17,전남,경북,668,37,64,79,329,17,1194,818,43,81,120,444,20,1526
2020-03-17,전남,광주,30523,995,975,769,2093,1182,36537,31889,1014,1131,878,2232,1249,38393
2020-03-17,전남,대구,424,23,30,32,52,10,571,389,16,33,27,55,8,528
2020-03-17,전남,대전,89,1,6,11,9,2,118,286,6,7,31,23,10,363
2020-03-17,전남,부산,1471,99,101,134,548,64,2417,1550,90,103,184,538,61,2526
2020-03-17,전남,서울,582,14,27,64,36,18,741,752,13,20,42,26,20,873
2020-03-17,전남,세종,52,3,4,7,7,2,75,127,3,4,11,25,5,175
2020-03-17,전남,울산,150,14,22,16,48,3,253,140,14,17,17,33,4,225
2020-03-17,전남,전남,42756,1438,1537,1757,5192,1794,54474,42756,1438,1537,1757,5192,1794,54474
2020-03-17,전남,전북,6293,343,690,869,2959,176,11330,4527,242,486,581,1383,116,7335
2020-03-17,전남,충남,1520,55,185,434,286,39,2519,4055,89,402,609,1105,119,6379
2020-03-17,전남,충북,107,16,28,45,61,4,261,327,12,70,120,288,10,827
2020-03-17,전북,강원,130,7,15,26,38,7,223,87,3,10,4,17,4,125
2020-03-17,전북,경기,1185,54,131,229,258,29,1886,1070,55,131,147,207,28,1638
2020-03-17,전북,경남,891,53,112,105,211,27,1399,862,48,118,109,217,34,1388
2020-03-17,전북,경북,1436,107,186,144,497,45,2415,1529,91,194,191,299,41,2345
2020-03-17,전북,광주,7023,506,496,396,414,273,9108,6842,467,515,401,388,243,8856
2020-03-17,전북,대구,176,20,27,15,36,2,276,186,13,24,16,30,4,273
2020-03-17,전북,대전,2749,102,84,80,65,112,3192,2574,92,83,92,42,115,2998
2020-03-17,전북,부산,183,4,20,38,74,8,327,222,3,27,28,105,7,392
2020-03-17,전북,서울,979,29,41,42,35,38,1164,1100,12,44,29,31,36,1252
2020-03-17,전북,세종,571,10,17,17,46,23,684,549,17,23,17,35,21,662
2020-03-17,전북,울산,36,0,6,2,7,1,52,28,2,6,1,17,2,56
2020-03-17,전북,전남,4527,242,486,581,1383,116,7335,6293,343,690,869,2959,176,11330
2020-03-17,전북,전북,15995,727,940,680,1196,605,20143,15995,727,940,680,1196,605,20143
2020-03-17,전북,충남,13341,568,1505,1492,2516,418,19840,11435,494,1293,1079,1485,378,16164
2020-03-17,전북,충북,1687,135,199,369,452,58,2900,1511,125,232,233,280,51,2432
2020-03-17,충남,강원,330,13,21,44,66,14,488,248,5,17,28,40,3,341
2020-03-17,충남,경기,32305,1559,2663,2515,4610,1705,45357,33294,1630,2802,2689,4913,1718,47046
2020-03-17,충남,경남,1155,46,149,332,572,40,2294,817,46,121,282,282,21,1569
2020-03-17,충남,경북,2367,136,371,519,830,83,4306,2184,149,341,584,605,71,3934
2020-03-17,충남,광주,3474,166,447,646,383,93,5209,3414,132,409,502,273,111,4841
2020-03-17,충남,대구,577,55,98,192,208,15,1145,872,66,126,222,261,26,1573
2020-03-17,충남,대전,13410,458,465,246,244,1013,15836,14998,477,515,279,208,1138,17615
2020-03-17,충남,부산,105,11,25,89,217,4,451,105,12,28,57,144,7,353
2020-03-17,충남,서울,22346,689,1764,1379,1272,902,28352,23225,610,1846,842,751,957,28231
2020-03-17,충남,세종,3947,129,156,122,174,208,4736,5181,162,159,131,205,265,6103
2020-03-17,충남,울산,71,6,11,37,106,2,233,104,10,21,53,125,3,316
2020-03-17,충남,전남,4055,89,402,609,1105,119,6379,1520,55,185,434,286,39,2519
2020-03-17,충남,전북,11435,494,1293,1079,1485,378,16164,13341,568,1505,1492,2516,418,19840
2020-03-17,충남,충남,85127,3747,7131,7415,10875,3947,118242,85127,3747,7131,7415,10875,3947,118242
2020-03-17,충남,충북,12221,691,867,1039,1512,741,17071,11292,662,851,881,1621,621,15928
2020-03-17,충북,강원,3832,206,246,236,374,223,5117,3671,241,258,271,442,206,5089
2020-03-17,충북,경기,23360,2167,2684,2943,3849,1155,36158,23847,2249,2880,3393,3643,1178,37190
2020-03-17,충북,경남,1044,70,210,515,642,26,2507,802,60,126,316,344,18,1666
2020-03-17,충북,경북,3611,276,526,681,1186,133,6413,3703,258,491,743,1029,139,6363
2020-03-17,충북,광주,498,35,85,199,118,15,950,452,30,67,131,63,10,753
2020-03-17,충북,대구,670,78,145,255,169,21,1338,1035,97,175,271,439,33,2050
2020-03-17,충북,대전,9098,408,377,188,191,728,10990,10111,450,432,186,205,784,12168
2020-03-17,충북,부산,66,25,21,118,213,2,445,74,15,23,102,211,2,427
2020-03-17,충북,서울,11413,662,925,884,855,451,15190,11937,537,911,841,761,509,15496
2020-03-17,충북,세종,305,20,22,17,33,30,427,348,15,17,15,16,28,439
2020-03-17,충북,울산,19,3,3,15,34,1,75,19,2,4,22,48,0,95
2020-03-17,충북,전남,327,12,70,120,288,10,827,107,16,28,45,61,4,261
2020-03-17,충북,전북,1511,125,232,233,280,51,2432,1687,135,199,369,452,58,2900
2020-03-17,충북,충남,11292,662,851,881,1621,621,15928,12221,691,867,1039,1512,741,17071
2020-03-17,충북,충북,32399,1982,2360,2277,3442,1947,44407,32399,1982,2360,2277,3442,1947,44407
2020-03-18,강원,강원,60077,2326,2348,1453,3250,4038,73492,60077,2326,2348,1453,3250,4038,73492
2020-03-18,강원,경기,18412,607,855,691,776,881,22222,19732,625,875,752,950,910,23844
2020-03-18,강원,경남,104,0,7,18,20,5,154,76,2,4,17,10,4,113
2020-03-18,강원,경북,304,25,21,24,26,4,404,301,15,14,31,37,9,407
2020-03-18,강원,광주,57,4,12,10,8,1,92,46,2,11,12,6,2,79
2020-03-18,강원,대구,107,3,5,10,13,1,139,174,11,10,21,22,2,240
2020-03-18,강원,대전,121,5,12,7,2,4,151,131,4,12,5,2,5,159
2020-03-18,강원,부산,2,0,1,0,3,0,6,3,0,0,0,2,0,5
2020-03-18,강원,서울,720,19,123,14,27,30,933,831,22,117,15,15,27,1027
2020-03-18,강원,세종,9,0,0,0,1,1,11,11,0,1,0,1,0,13
2020-03-18,강원,울산,2,1,0,0,0,0,3,1,0,0,0,2,0,3
2020-03-18,강원,전남,26,0,5,6,15,0,52,16,1,2,3,9,0,31
2020-03-18,강원,전북,90,6,11,9,20,3,139,136,10,12,24,31,4,217
2020-03-18,강원,충남,230,9,13,28,42,8,330,319,8,20,42,86,13,488
2020-03-18,강원,충북,4076,246,257,281,406,231,5497,4189,227,228,237,354,253,5488
2020-03-18,경기,강원,19732,625,875,752,950,910,23844,18412,607,855,691,776,881,22222
2020-03-18,경기,경기,424663,23308,24419,20566,24696,31163,548815,424663,23308,24419,20566,24696,31163,548815
2020-03-18,경기,경남,2069,105,293,789,676,75,4007,1445,68,192,558,461,54,2778
2020-03-18,경기,경북,2746,157,473,735,617,104,4832,2644,190,433,918,573,85,4843
2020-03-18,경기,광주,649,39,128,362,181,15,1374,529,19,104,251,139,14,1056
2020-03-18,경기,대구,1028,81,153,387,201,21,1871,1618,95,142,459,501,39,2854
2020-03-18,경기,대전,1671,102,162,110,58,95,2198,1742,103,150,94,59,97,2245
2020-03-18,경기,부산,157,15,57,194,149,2,574,202,19,38,153,315,7,734
2020-03-18,경기,서울,144190,7220,8432,5579,3988,9533,178942,145560,6917,8784,5157,3557,9819,179794
2020-03-18,경기,세종,36,2,1,3,1,2,45,49,3,6,4,3,2,67
2020-03-18,경기,울산,23,3,1,14,22,1,64,42,3,5,47,65,1,163
2020-03-18,경기,전남,671,21,79,160,158,25,1114,561,20,56,91,103,20,851
2020-03-18,경기,전북,1117,53,121,128,195,41,1655,1167,59,129,210,261,47,1873
2020-03-18,경기,충남,34828,1552,2713,2664,4880,1816,48453,34263,1543,2574,2536,4651,1737,47304
2020-03-18,경기,충북,25171,2243,2850,3431,3670,1181,38546,24756,2165,2679,2956,3956,1170,37682
2020-03-18,경남,강원,76,2,4,17,10,4,113,104,0,7,18,20,5,154
2020-03-18,경남,경기,1445,68,192,558,461,54,2778,2069,105,293,789,676,75,4007
2020-03-18,경남,경남,185557,10051,9598,7737,14023,14028,240994,185557,10051,9598,7737,14023,14028,240994
2020-03-18,경남,경북,7436,655,915,941,2062,347,12356,9497,889,1124,1329,2936,418,16193
2020-03-18,경남,광주,919,53,116,181,156,18,1443,890,46,122,178,120,21,1377
2020-03-18,경남,대구,9449,704,729,1027,1905,349,14163,7501,490,550,428,549,324,9842
2020-03-18,경남,대전,575,22,85,78,42,16,818,759,25,79,114,74,26,1077
2020-03-18,경남,부산,83309,2651,2552,1872,4833,5877,101094,81738,2727,2753,1845,4976,5802,99841
2020-03-18,경남,서울,1455,44,270,292,149,34,2244,2186,53,299,195,120,53,2906
2020-03-18,경남,세종,118,0,9,10,15,9,161,182,2,11,14,23,9,241
2020-03-18,경남,울산,8691,663,644,519,793,589,11899,8417,576,684,469,715,560,11421
2020-03-18,경남,전남,5423,254,417,594,1455,223,8366,5623,311,413,473,1435,226,8481
2020-03-18,경남,전북,882,37,119,114,239,33,1424,905,41,117,104,193,28,1388
2020-03-18,경남,충남,878,51,106,297,253,28,1613,1200,59,158,356,589,36,2398
2020-03-18,경남,충북,846,51,111,276,301,22,1607,1066,62,196,482,705,29,2540
2020-03-18,경북,강원,301,15,14,31,37,9,407,304,25,21,24,26,4,404
2020-03-18,경북,경기,2644,190,433,918,573,85,4843,2746,157,473,735,617,104,4832
2020-03-18,경북,경남,9497,889,1124,1329,2936,418,16193,7436,655,915,941,2062,347,12356
2020-03-18,경북,경북,63577,3733,3833,3076,5513,3354,83086,63577,3733,3833,3076,5513,3354,83086
2020-03-18,경북,광주,574,52,110,185,157,10,1088,515,53,82,169,111,12,942
2020-03-18,경북,대구,62433,2822,2238,1715,3343,3279,75830,65143,3108,2604,2027,3957,3362,80201
2020-03-18,경북,대전,1271,52,90,123,104,48,1688,1292,57,75,131,65,46,1666
2020-03-18,경북,부산,3239,115,188,212,683,138,4575,3574,117,216,218,830,166,5121
2020-03-18,경북,서울,1781,95,217,399,178,47,2717,2001,80,212,229,128,57,2707
2020-03-18,경북,세종,181,8,13,18,24,5,249,166,8,13,24,17,6,234
2020-03-18,경북,울산,4318,190,295,422,1188,253,6666,4261,182,303,339,1351,244,6680
2020-03-18,경북,전남,880,55,68,103,505,31,1642,724,53,70,75,318,17,1257
2020-03-18,경북,전북,1536,96,170,192,309,60,2363,1465,100,185,164,566,49,2529
2020-03-18,경북,충남,2412,150,349,606,641,87,4245,2588,138,376,544,761,89,4496
2020-03-18,경북,충북,3776,237,505,711,1031,135,6395,3735,248,509,649,1135,129,6405
2020-03-18,광주,강원,46,2,11,12,6,2,79,57,4,12,10,8,1,92
2020-03-18,광주,경기,529,19,104,251,139,14,1056,649,39,128,362,181,15,1374
2020-03-18,광주,경남,890,46,122,178,120,21,1377,919,53,116,181,156,18,1443
2020-03-18,광주,경북,515,53,82,169,111,12,942,574,52,110,185,157,10,1088
2020-03-18,광주,광주,13996,474,555,629,485,558,16697,13996,474,555,629,485,558,16697
2020-03-18,광주,대구,335,17,62,83,32,4,533,350,25,61,67,36,7,546
2020-03-18,광주,대전,379,14,14,21,13,16,457,393,17,13,28,15,19,485
2020-03-18,광주,부산,258,13,24,41,61,10,407,339,17,39,69,92,10,566
2020-03-18,광주,서울,532,24,15,56,25,18,670,626,21,28,45,16,22,758
2020-03-18,광주,세종,115,1,12,4,4,5,141,117,2,11,4,3,8,145
2020-03-18,광주,울산,33,0,9,2,6,0,50,41,2,8,8,10,0,69
2020-03-18,광주,전남,33206,1023,1132,773,2148,1292,39574,32205,990,964,714,2022,1239,38134
2020-03-18,광주,전북,7110,459,513,366,406,275,9129,7236,460,454,330,419,262,9161
2020-03-18,광주,충남,3305,118,390,454,246,98,4611,3475,136,429,609,380,83,5112
2020-03-18,광주,충북,434,28,59,106,99,8,734,481,24,77,154,132,10,878
2020-03-18,대구,강원,174,11,10,21,22,2,240,107,3,5,10,13,1,139
2020-03-18,대구,경기,1618,95,142,459,501,39,2854,1028,81,153,387,201,21,1871
2020-03-18,대구,경남,7501,490,550,428,549,324,9842,9449,704,729,1027,1905,349,14163
2020-03-18,대구,경북,65143,3108,2604,2027,3957,3362,80201,62433,2822,2238,1715,3343,3279,75830
2020-03-18,대구,광주,350,25,61,67,36,7,546,335,17,62,83,32,4,533
2020-03-18,대구,대구,53361,2123,1614,848,1256,3538,62740,53361,2123,1614,848,1256,3538,62740
2020-03-18,대구,대전,538,30,22,74,38,28,730,346,23,18,54,23,7,471
2020-03-18,대구,부산,378,45,90,61,148,16,738,2167,100,168,106,237,94,2872
2020-03-18,대구,서울,1580,50,92,231,96,55,2104,975,55,47,136,38,22,1273
2020-03-18,대구,세종,137,1,10,10,17,6,181,83,0,3,8,3,3,100
2020-03-18,대구,울산,798,45,81,69,151,26,1170,746,47,81,77,173,32,1156
2020-03-18,대구,전남,429,12,34,36,39,12,562,435,18,34,31,53,14,585
2020-03-18,대구,전북,212,8,22,18,21,8,289,197,7,29,27,15,3,278
2020-03-18,대구,충남,974,76,107,216,265,30,1668,606,65,115,175,217,18,1196
2020-03-18,대구,충북,1030,102,166,276,420,27,2021,736,90,118,228,149,25,1346
2020-03-18,대전,강원,131,4,12,5,2,5,159,121,5,12,7,2,4,151
2020-03-18,대전,경기,1742,103,150,94,59,97,2245,1671,102,162,110,58,95,2198
2020-03-18,대전,경남,759,25,79,114,74,26,1077,575,22,85,78,42,16,818
2020-03-18,대전,경북,1292,57,75,131,65,46,1666,1271,52,90,123,104,48,1688
2020-03-18,대전,광주,393,17,13,28,15,19,485,379,14,14,21,13,16,457
2020-03-18,대전,대구,346,23,18,54,23,7,471,538,30,22,74,38,28,730
2020-03-18,대전,대전,13483,429,399,363,296,980,15950,13483,429,399,363,296,980,15950
2020-03-18,대전,부산,56,6,8,15,16,0,101,78,3,5,20,16,1,123
2020-03-18,대전,서울,1443,36,131,42,18,67,1737,1482,37,136,34,8,67,1764
2020-03-18,대전,세종,3181,83,66,41,60,263,3694,3145,94,75,38,79,253,3684
2020-03-18,대전,울산,58,5,5,17,28,3,116,70,3,3,6,27,0,109
2020-03-18,대전,전남,309,5,6,31,29,8,388,101,4,4,10,2,4,125
2020-03-18,대전,전북,2769,101,79,69,42,119,3179,2940,98,87,87,53,125,3390
2020-03-18,대전,충남,15358,485,488,239,202,1163,17935,14087,461,439,220,222,1093,16522
2020-03-18,대전,충북,10517,483,403,213,186,780,12582,9410,428,359,174,159,754,11284
2020-03-18,부산,강원,3,0,0,0,2,0,5,2,0,1,0,3,0,6
2020-03-18,부산,경기,202,19,38,153,315,7,734,157,15,57,194,149,2,574
2020-03-18,부산,경남,81738,2727,2753,1845,4976,5802,99841,83309,2651,2552,1872,4833,5877,101094
2020-03-18,부산,경북,3574,117,216,218,830,166,5121,3239,115,188,212,683,138,4575
2020-03-18,부산,광주,339,17,39,69,92,10,566,258,13,24,41,61,10,407
2020-03-18,부산,대구,2167,100,168,106,237,94,2872,378,45,90,61,148,16,738
2020-03-18,부산,대전,78,3,5,20,16,1,123,56,6,8,15,16,0,101
2020-03-18,부산,부산,41641,697,666,690,2620,3139,49453,41641,697,666,690,2620,3139,49453
2020-03-18,부산,서울,158,16,13,96,68,1,352,162,12,19,58,27,6,284
2020-03-18,부산,세종,14,0,3,4,3,0,24,14,2,0,1,4,0,21
2020-03-18,부산,울산,14724,353,457,641,2540,1111,19826,14890,393,425,463,2581,1081,19833
2020-03-18,부산,전남,1678,87,108,222,558,67,2720,1479,72,110,123,600,63,2447
2020-03-18,부산,전북,217,13,34,46,90,6,406,174,8,20,41,70,4,317
2020-03-18,부산,충남,137,15,16,53,163,2,386,114,15,24,99,190,4,446
2020-03-18,부산,충북,84,11,24,90,227,4,440,75,11,30,135,174,2,427
2020-03-18,서울,강원,831,22,117,15,15,27,1027,720,19,123,14,27,30,933
2020-03-18,서울,경기,145560,6917,8784,5157,3557,9819,179794,144190,7220,8432,5579,3988,9533,178942
2020-03-18,서울,경남,2186,53,299,195,120,53,2906,1455,44,270,292,149,34,2244
2020-03-18,서울,경북,2001,80,212,229,128,57,2707,1781,95,217,399,178,47,2717
2020-03-18,서울,광주,626,21,28,45,16,22,758,532,24,15,56,25,18,670
2020-03-18,서울,대구,975,55,47,136,38,22,1273,1580,50,92,231,96,55,2104
2020-03-18,서울,대전,1482,37,136,34,8,67,1764,1443,36,131,42,18,67,1737
2020-03-18,서울,부산,162,12,19,58,27,6,284,158,16,13,96,68,1,352
2020-03-18,서울,서울,188,6,11,3,2,10,220,188,6,11,3,2,10,220
2020-03-18,서울,세종,21,0,0,2,1,1,25,27,2,1,0,0,2,32
2020-03-18,서울,울산,26,1,3,1,2,1,34,22,0,5,6,9,0,42
2020-03-18,서울,전남,763,9,28,44,24,21,889,684,3,17,78,21,17,820
2020-03-18,서울,전북,1054,20,46,30,33,33,1216,1060,28,39,43,36,44,1250
2020-03-18,서울,충남,23599,523,1734,866,838,949,28509,22835,606,1735,1302,1271,935,28684
2020-03-18,서울,충북,12549,562,926,829,787,487,16140,12047,672,917,859,881,444,15820
2020-03-18,세종,강원,11,0,1,0,1,0,13,9,0,0,0,1,1,11
2020-03-18,세종,경기,49,3,6,4,3,2,67,36,2,1,3,1,2,45
2020-03-18,세종,경남,182,2,11,14,23,9,241,118,0,9,10,15,9,161
2020-03-18,세종,경북,166,8,13,24,17,6,234,181,8,13,18,24,5,249
2020-03-18,세종,광주,117,2,11,4,3,8,145,115,1,12,4,4,5,141
2020-03-18,세종,대구,83,0,3,8,3,3,100,137,1,10,10,17,6,181
2020-03-18,세종,대전,3145,94,75,38,79,253,3684,3181,83,66,41,60,263,3694
2020-03-18,세종,부산,14,2,0,1,4,0,21,14,0,3,4,3,0,24
2020-03-18,세종,서울,27,2,1,0,0,2,32,21,0,0,2,1,1,25
2020-03-18,세종,세종,216,27,3,2,3,11,262,216,27,3,2,3,11,262
2020-03-18,세종,울산,12,0,0,1,6,0,19,6,0,0,2,9,0,17
2020-03-18,세종,전남,142,1,9,9,16,3,180,84,2,1,6,11,2,106
2020-03-18,세종,전북,580,26,27,11,30,32,706,594,15,24,13,40,24,710
2020-03-18,세종,충남,5460,150,150,134,233,290,6417,4183,141,144,131,175,195,4969
2020-03-18,세종,충북,382,17,19,14,23,31,486,338,15,15,13,38,31,450
2020-03-18,울산,강원,1,0,0,0,2,0,3,2,1,0,0,0,0,3
2020-03-18,울산,경기,42,3,5,47,65,1,163,23,3,1,14,22,1,64
2020-03-18,울산,경남,8417,576,684,469,715,560,11421,8691,663,644,519,793,589,11899
2020-03-18,울산,경북,4261,182,303,339,1351,244,6680,4318,190,295,422,1188,253,6666
2020-03-18,울산,광주,41,2,8,8,10,0,69,33,0,9,2,6,0,50
2020-03-18,울산,대구,746,47,81,77,173,32,1156,798,45,81,69,151,26,1170
2020-03-18,울산,대전,70,3,3,6,27,0,109,58,5,5,17,28,3,116
2020-03-18,울산,부산,14890,393,425,463,2581,1081,19833,14724,353,457,641,2540,1111,19826
2020-03-18,울산,서울,22,0,5,6,9,0,42,26,1,3,1,2,1,34
2020-03-18,울산,세종,6,0,0,2,9,0,17,12,0,0,1,6,0,19
2020-03-18,울산,울산,7492,316,506,344,678,679,10015,7492,316,506,344,678,679,10015
2020-03-18,울산,전남,189,7,22,22,34,4,278,170,14,34,7,51,3,279
2020-03-18,울산,전북,21,1,3,2,14,0,41,31,1,4,5,2,0,43
2020-03-18,울산,충남,69,5,15,58,119,2,268,78,5,9,33,108,3,236
2020-03-18,울산,충북,14,5,3,14,51,3,90,23,1,1,10,37,0,72
2020-03-18,전남,강원,16,1,2,3,9,0,31,26,0,5,6,15,0,52
2020-03-18,전남,경기,561,20,56,91,103,20,851,671,21,79,160,158,25,1114
2020-03-18,전남,경남,5623,311,413,473,1435,226,8481,5423,254,417,594,1455,223,8366
2020-03-18,전남,경북,724,53,70,75,318,17,1257,880,55,68,103,505,31,1642
2020-03-18,전남,광주,32205,990,964,714,2022,1239,38134,33206,1023,1132,773,2148,1292,39574
2020-03-18,전남,대구,435,18,34,31,53,14,585,429,12,34,36,39,12,562
2020-03-18,전남,대전,101,4,4,10,2,4,125,309,5,6,31,29,8,388
2020-03-18,전남,부산,1479,72,110,123,600,63,2447,1678,87,108,222,558,67,2720
2020-03-18,전남,서울,684,3,17,78,21,17,820,763,9,28,44,24,21,889
2020-03-18,전남,세종,84,2,1,6,11,2,106,142,1,9,9,16,3,180
2020-03-18,전남,울산,170,14,34,7,51,3,279,189,7,22,22,34,4,278
2020-03-18,전남,전남,43610,1433,1527,2053,5370,1734,55727,43610,1433,1527,2053,5370,1734,55727
2020-03-18,전남,전북,7019,348,649,831,2816,219,11882,4663,257,440,567,1357,145,7429
2020-03-18,전남,충남,1519,49,180,458,265,44,2515,4111,93,400,519,1009,116,6248
2020-03-18,전남,충북,121,18,12,43,80,2,276,356,18,43,113,253,10,793
2020-03-18,전북,강원,136,10,12,24,31,4,217,90,6,11,9,20,3,139
2020-03-18,전북,경기,1167,59,129,210,261,47,1873,1117,53,121,128,195,41,1655
2020-03-18,전북,경남,905,41,117,104,193,28,1388,882,37,119,114,239,33,1424
2020-03-18,전북,경북,1465,100,185,164,566,49,2529,1536,96,170,192,309,60,2363
2020-03-18,전북,광주,7236,460,454,330,419,262,9161,7110,459,513,366,406,275,9129
2020-03-18,전북,대구,197,7,29,27,15,3,278,212,8,22,18,21,8,289
2020-03-18,전북,대전,2940,98,87,87,53,125,3390,2769,101,79,69,42,119,3179
2020-03-18,전북,부산,174,8,20,41,70,4,317,217,13,34,46,90,6,406
2020-03-18,전북,서울,1060,28,39,43,36,44,1250,1054,20,46,30,33,33,1216
2020-03-18,전북,세종,594,15,24,13,40,24,710,580,26,27,11,30,32,706
2020-03-18,전북,울산,31,1,4,5,2,0,43,21,1,3,2,14,0,41
2020-03-18,전북,전남,4663,257,440,567,1357,145,7429,7019,348,649,831,2816,219,11882
2020-03-18,전북,전북,16715,717,936,673,1340,604,20985,16715,717,936,673,1340,604,20985
2020-03-18,전북,충남,14128,577,1461,1426,2400,466,20458,11995,511,1275,960,1427,409,16577
2020-03-18,전북,충북,1773,150,191,336,467,47,2964,1630,139,206,287,294,57,2613
2020-03-18,충남,강원,319,8,20,42,86,13,488,230,9,13,28,42,8,330
2020-03-18,충남,경기,34263,1543,2574,2536,4651,1737,47304,34828,1552,2713,2664,4880,1816,48453
2020-03-18,충남,경남,1200,59,158,356,589,36,2398,878,51,106,297,253,28,1613
2020-03-18,충남,경북,2588,138,376,544,761,89,4496,2412,150,349,606,641,87,4245
2020-03-18,충남,광주,3475,136,429,609,380,83,5112,3305,118,390,454,246,98,4611
2020-03-18,충남,대구,606,65,115,175,217,18,1196,974,76,107,216,265,30,1668
2020-03-18,충남,대전,14087,461,439,220,222,1093,16522,15358,485,488,239,202,1163,17935
2020-03-18,충남,부산,114,15,24,99,190,4,446,137,15,16,53,163,2,386
2020-03-18,충남,서울,22835,606,1735,1302,1271,935,28684,23599,523,1734,866,838,949,28509
2020-03-18,충남,세종,4183,141,144,131,175,195,4969,5460,150,150,134,233,290,6417
2020-03-18,충남,울산,78,5,9,33,108,3,236,69,5,15,58,119,2,268
2020-03-18,충남,전남,4111,93,400,519,1009,116,6248,1519,49,180,458,265,44,2515
2020-03-18,충남,전북,11995,511,1275,960,1427,409,16577,14128,577,1461,1426,2400,466,20458
2020-03-18,충남,충남,88084,3620,7079,7468,11257,4230,121738,88084,3620,7079,7468,11257,4230,121738
2020-03-18,충남,충북,12750,683,881,1019,1539,687,17559,11809,664,853,869,1607,622,16424
2020-03-18,충북,강원,4189,227,228,237,354,253,5488,4076,246,257,281,406,231,5497
2020-03-18,충북,경기,24756,2165,2679,2956,3956,1170,37682,25171,2243,2850,3431,3670,1181,38546
2020-03-18,충북,경남,1066,62,196,482,705,29,2540,846,51,111,276,301,22,1607
2020-03-18,충북,경북,3735,248,509,649,1135,129,6405,3776,237,505,711,1031,135,6395
2020-03-18,충북,광주,481,24,77,154,132,10,878,434,28,59,106,99,8,734
2020-03-18,충북,대구,736,90,118,228,149,25,1346,1030,102,166,276,420,27,2021
2020-03-18,충북,대전,9410,428,359,174,159,754,11284,10517,483,403,213,186,780,12582
2020-03-18,충북,부산,75,11,30,135,174,2,427,84,11,24,90,227,4,440
2020-03-18,충북,서울,12047,672,917,859,881,444,15820,12549,562,926,829,787,487,16140
2020-03-18,충북,세종,338,15,15,13,38,31,450,382,17,19,14,23,31,486
2020-03-18,충북,울산,23,1,1,10,37,0,72,14,5,3,14,51,3,90
2020-03-18,충북,전남,356,18,43,113,253,10,793,121,18,12,43,80,2,276
2020-03-18,충북,전북,1630,139,206,287,294,57,2613,1773,150,191,336,467,47,2964
2020-03-18,충북,충남,11809,664,853,869,1607,622,16424,12750,683,881,1019,1539,687,17559
2020-03-18,충북,충북,33951,2056,2252,2260,3527,2018,46064,33951,2056,2252,2260,3527,2018,46064
2020-03-19,강원,강원,50173,2152,2231,1307,2962,3366,62191,50173,2152,2231,1307,2962,3366,62191
2020-03-19,강원,경기,15583,592,854,611,719,675,19034,15713,614,830,690,838,736,19421
2020-03-19,강원,경남,91,3,6,16,21,5,142,70,1,5,20,12,0,108
2020-03-19,강원,경북,248,23,23,12,28,8,342,272,17,13,34,33,9,378
2020-03-19,강원,광주,50,1,8,7,7,0,73,45,0,6,10,3,3,67
2020-03-19,강원,대구,121,1,12,15,12,2,163,162,4,19,25,23,3,236
2020-03-19,강원,대전,111,5,14,3,4,5,142,120,5,11,8,2,6,152
2020-03-19,강원,부산,2,1,0,0,1,0,4,1,0,0,0,2,0,3
2020-03-19,강원,서울,629,10,120,11,23,23,816,637,10,110,10,11,22,800
2020-03-19,강원,세종,6,0,0,1,0,0,7,4,0,0,0,1,0,5
2020-03-19,강원,울산,2,0,0,0,1,0,3,2,0,0,0,0,0,2
2020-03-19,강원,전남,23,1,2,3,16,0,45,10,0,1,6,5,0,22
2020-03-19,강원,전북,83,3,13,13,24,2,138,119,6,13,17,31,3,189
2020-03-19,강원,충남,223,9,19,33,46,7,337,301,5,20,39,60,12,437
2020-03-19,강원,충북,3542,237,246,265,419,232,4941,3563,202,215,221,388,225,4814
2020-03-19,경기,강원,15713,614,830,690,838,736,19421,15583,592,854,611,719,675,19034
2020-03-19,경기,경기,400401,22830,24021,19881,24106,29107,520346,400401,22830,24021,19881,24106,29107,520346
2020-03-19,경기,경남,2296,106,278,796,610,75,4161,1627,51,221,526,488,47,2960
2020-03-19,경기,경북,2566,180,419,723,599,80,4567,2659,176,381,938,591,81,4826
2020-03-19,경기,광주,655,23,126,319,172,22,1317,570,19,99,239,114,12,1053
2020-03-19,경기,대구,1078,81,161,372,208,35,1935,1604,98,165,455,469,51,2842
2020-03-19,경기,대전,1671,97,129,107,54,74,2132,1681,98,134,93,41,68,2115
2020-03-19,경기,부산,194,20,40,208,179,5,646,202,20,43,176,295,7,743
2020-03-19,경기,서울,140813,7069,8278,5112,3886,9223,174381,141456,6859,8652,4822,3443,9274,174506
2020-03-19,경기,세종,20,1,2,4,2,1,30,37,3,3,3,3,3,52
2020-03-19,경기,울산,30,2,0,14,13,0,59,35,1,6,37,63,1,143
2020-03-19,경기,전남,589,17,80,170,164,20,1040,555,23,53,115,85,11,842
2020-03-19,경기,전북,892,44,123,131,195,27,1412,1069,52,112,203,263,45,1744
2020-03-19,경기,충남,31676,1547,2681,2478,4678,1570,44630,31821,1474,2491,2454,4405,1549,44194
2020-03-19,경기,충북,23386,2182,2757,3259,3465,1144,36193,23331,2067,2664,2853,3702,1094,35711
2020-03-19,경남,강원,70,1,5,20,12,0,108,91,3,6,16,21,5,142
2020-03-19,경남,경기,1627,51,221,526,488,47,2960,2296,106,278,796,610,75,4161
2020-03-19,경남,경남,177927,10080,9440,7492,14393,13192,232524,177927,10080,9440,7492,14393,13192,232524
2020-03-19,경남,경북,7231,587,893,959,1993,295,11958,9080,798,1089,1298,2679,363,15307
2020-03-19,경남,광주,844,45,114,178,158,31,1370,823,39,125,171,114,26,1298
2020-03-19,경남,대구,8963,676,761,1020,1831,325,13576,6668,462,534,390,526,253,8833
2020-03-19,경남,대전,598,20,76,76,50,28,848,823,31,86,115,94,23,1172
2020-03-19,경남,부산,80196,2586,2487,1954,4704,5511,97438,79289,2717,2606,2012,5062,5488,97174
2020-03-19,경남,서울,1720,37,293,290,171,43,2554,2219,39,292,188,134,65,2937
2020-03-19,경남,세종,147,5,9,5,9,8,183,172,3,9,9,17,7,217
2020-03-19,경남,울산,8529,635,681,474,786,542,11647,8103,558,706,445,633,520,10965
2020-03-19,경남,전남,5060,246,380,478,1408,225,7797,5364,253,419,392,1362,217,8007
2020-03-19,경남,전북,841,39,100,105,213,29,1327,786,38,104,106,177,33,1244
2020-03-19,경남,충남,840,51,128,290,278,30,1617,1304,55,175,376,574,36,2520
2020-03-19,경남,충북,858,59,133,300,356,32,1738,1123,85,215,502,655,33,2613
2020-03-19,경북,강원,272,17,13,34,33,9,378,248,23,23,12,28,8,342
2020-03-19,경북,경기,2659,176,381,938,591,81,4826,2566,180,419,723,599,80,4567
2020-03-19,경북,경남,9080,798,1089,1298,2679,363,15307,7231,587,893,959,1993,295,11958
2020-03-19,경북,경북,58433,3793,3757,2940,5457,2902,77282,58433,3793,3757,2940,5457,2902,77282
2020-03-19,경북,광주,554,55,109,184,150,14,1066,525,49,101,181,109,7,972
2020-03-19,경북,대구,57906,2809,2216,1728,3462,2998,71119,60116,2967,2606,2046,4000,2976,74711
2020-03-19,경북,대전,1290,57,91,92,85,51,1666,1325,72,77,106,72,50,1702
2020-03-19,경북,부산,3269,133,179,200,693,146,4620,3381,118,196,238,842,169,4944
2020-03-19,경북,서울,1909,81,204,399,155,64,2812,1907,68,207,251,117,61,2611
2020-03-19,경북,세종,208,6,13,29,16,8,280,221,6,11,11,7,10,266
2020-03-19,경북,울산,3910,178,278,445,1090,241,6142,3902,167,279,341,1369,212,6270
2020-03-19,경북,전남,798,53,64,118,506,18,1557,708,39,60,81,299,20,1207
2020-03-19,경북,전북,1449,84,151,182,277,42,2185,1340,104,175,152,479,42,2292
2020-03-19,경북,충남,2274,157,334,585,609,68,4027,2436,145,364,499,773,75,4292
2020-03-19,경북,충북,3625,253,488,708,1032,116,6222,3463,268,465,662,1121,116,6095
2020-03-19,광주,강원,45,0,6,10,3,3,67,50,1,8,7,7,0,73
2020-03-19,광주,경기,570,19,99,239,114,12,1053,655,23,126,319,172,22,1317
2020-03-19,광주,경남,823,39,125,171,114,26,1298,844,45,114,178,158,31,1370
2020-03-19,광주,경북,525,49,101,181,109,7,972,554,55,109,184,150,14,1066
2020-03-19,광주,광주,12875,507,546,700,508,531,15667,12875,507,546,700,508,531,15667
2020-03-19,광주,대구,354,26,61,79,26,11,557,353,35,69,76,39,10,582
2020-03-19,광주,대전,372,23,15,14,13,9,446,410,21,14,30,18,11,504
2020-03-19,광주,부산,307,14,42,44,75,14,496,352,16,51,72,117,10,618
2020-03-19,광주,서울,507,16,20,64,19,22,648,629,24,31,54,21,19,778
2020-03-19,광주,세종,100,1,9,8,0,5,123,136,4,5,9,1,3,158
2020-03-19,광주,울산,48,1,8,3,3,0,63,39,1,7,9,12,0,68
2020-03-19,광주,전남,30554,981,1092,731,2046,1200,36604,29396,989,975,671,1929,1159,35119
2020-03-19,광주,전북,6652,414,485,384,396,222,8553,6826,440,442,373,432,245,8758
2020-03-19,광주,충남,3418,116,425,491,260,97,4807,3633,152,409,633,367,87,5281
2020-03-19,광주,충북,444,32,58,104,80,12,730,490,39,93,187,125,14,948
2020-03-19,대구,강원,162,4,19,25,23,3,236,121,1,12,15,12,2,163
2020-03-19,대구,경기,1604,98,165,455,469,51,2842,1078,81,161,372,208,35,1935
2020-03-19,대구,경남,6668,462,534,390,526,253,8833,8963,676,761,1020,1831,325,13576
2020-03-19,대구,경북,60116,2967,2606,2046,4000,2976,74711,57906,2809,2216,1728,3462,2998,71119
2020-03-19,대구,광주,353,35,69,76,39,10,582,354,26,61,79,26,11,557
2020-03-19,대구,대구,50390,1984,1588,902,1200,3308,59372,50390,1984,1588,902,1200,3308,59372
2020-03-19,대구,대전,575,38,27,79,47,18,784,367,21,28,45,14,21,496
2020-03-19,대구,부산,376,61,101,71,139,17,765,1980,104,176,85,236,77,2658
2020-03-19,대구,서울,1587,62,81,257,103,45,2135,994,42,64,137,52,24,1313
2020-03-19,대구,세종,152,3,4,7,13,4,183,83,3,2,5,2,2,97
2020-03-19,대구,울산,738,53,64,74,165,34,1128,736,48,72,69,195,31,1151
2020-03-19,대구,전남,345,13,36,19,50,8,471,359,16,33,22,56,9,495
2020-03-19,대구,전북,170,14,24,11,18,5,242,193,9,22,19,30,6,279
2020-03-19,대구,충남,1008,65,136,224,233,27,1693,595,54,115,149,200,11,1124
2020-03-19,대구,충북,1019,94,174,247,405,34,1973,705,77,115,217,163,18,1295
2020-03-19,대전,강원,120,5,11,8,2,6,152,111,5,14,3,4,5,142
2020-03-19,대전,경기,1681,98,134,93,41,68,2115,1671,97,129,107,54,74,2132
2020-03-19,대전,경남,823,31,86,115,94,23,1172,598,20,76,76,50,28,848
2020-03-19,대전,경북,1325,72,77,106,72,50,1702,1290,57,91,92,85,51,1666
2020-03-19,대전,광주,410,21,14,30,18,11,504,372,23,15,14,13,9,446
2020-03-19,대전,대구,367,21,28,45,14,21,496,575,38,27,79,47,18,784
2020-03-19,대전,대전,12770,385,419,225,279,896,14974,12770,385,419,225,279,896,14974
2020-03-19,대전,부산,65,4,4,24,7,2,106,54,5,8,24,17,1,109
2020-03-19,대전,서울,1553,38,117,36,7,46,1797,1524,32,118,30,12,63,1779
2020-03-19,대전,세종,3019,97,65,43,48,232,3504,2980,95,65,37,56,227,3460
2020-03-19,대전,울산,78,2,4,16,30,3,133,89,4,5,11,27,1,137
2020-03-19,대전,전남,224,6,6,25,26,5,292,102,5,4,7,6,2,126
2020-03-19,대전,전북,2461,88,79,70,42,98,2838,2667,102,69,79,67,92,3076
2020-03-19,대전,충남,14562,470,502,262,234,1098,17128,13185,451,460,241,268,965,15570
2020-03-19,대전,충북,9957,473,395,217,188,714,11944,8952,391,368,200,165,664,10740
2020-03-19,부산,강원,1,0,0,0,2,0,3,2,1,0,0,1,0,4
2020-03-19,부산,경기,202,20,43,176,295,7,743,194,20,40,208,179,5,646
2020-03-19,부산,경남,79289,2717,2606,2012,5062,5488,97174,80196,2586,2487,1954,4704,5511,97438
2020-03-19,부산,경북,3381,118,196,238,842,169,4944,3269,133,179,200,693,146,4620
2020-03-19,부산,광주,352,16,51,72,117,10,618,307,14,42,44,75,14,496
2020-03-19,부산,대구,1980,104,176,85,236,77,2658,376,61,101,71,139,17,765
2020-03-19,부산,대전,54,5,8,24,17,1,109,65,4,4,24,7,2,106
2020-03-19,부산,부산,39939,652,527,605,2581,2812,47116,39939,652,527,605,2581,2812,47116
2020-03-19,부산,서울,168,14,22,97,80,4,385,167,12,20,65,52,2,318
2020-03-19,부산,세종,13,0,1,3,5,0,22,18,0,0,1,1,0,20
2020-03-19,부산,울산,14258,377,458,655,2543,1000,19291,14124,390,422,455,2417,1023,18831
2020-03-19,부산,전남,1721,81,124,200,558,63,2747,1614,75,104,139,648,57,2637
2020-03-19,부산,전북,214,10,26,42,85,6,383,204,5,23,38,55,3,328
2020-03-19,부산,충남,123,11,23,75,180,5,417,114,12,22,78,194,1,421
2020-03-19,부산,충북,96,8,30,105,227,1,467,94,19,33,122,209,1,478
2020-03-19,서울,강원,637,10,110,10,11,22,800,629,10,120,11,23,23,816
2020-03-19,서울,경기,141456,6859,8652,4822,3443,9274,174506,140813,7069,8278,5112,3886,9223,174381
2020-03-19,서울,경남,2219,39,292,188,134,65,2937,1720,37,293,290,171,43,2554
2020-03-19,서울,경북,1907,68,207,251,117,61,2611,1909,81,204,399,155,64,2812
2020-03-19,서울,광주,629,24,31,54,21,19,778,507,16,20,64,19,22,648
2020-03-19,서울,대구,994,42,64,137,52,24,1313,1587,62,81,257,103,45,2135
2020-03-19,서울,대전,1524,32,118,30,12,63,1779,1553,38,117,36,7,46,1797
2020-03-19,서울,부산,167,12,20,65,52,2,318,168,14,22,97,80,4,385
2020-03-19,서울,서울,161,2,14,3,0,9,189,161,2,14,3,0,9,189
2020-03-19,서울,세종,21,0,0,1,0,0,22,29,1,0,1,1,2,34
2020-03-19,서울,울산,22,1,1,1,1,1,27,38,1,1,11,18,1,70
2020-03-19,서울,전남,672,9,18,23,20,25,767,615,6,21,54,23,14,733
2020-03-19,서울,전북,995,25,47,24,21,37,1149,978,24,55,48,32,35,1172
2020-03-19,서울,충남,22321,534,1743,811,799,855,27063,23593,656,1688,1308,1239,870,29354
2020-03-19,서울,충북,12311,519,889,840,782,492,15833,12016,647,869,851,850,479,15712
2020-03-19,세종,강원,4,0,0,0,1,0,5,6,0,0,1,0,0,7
2020-03-19,세종,경기,37,3,3,3,3,3,52,20,1,2,4,2,1,30
2020-03-19,세종,경남,172,3,9,9,17,7,217,147,5,9,5,9,8,183
2020-03-19,세종,경북,221,6,11,11,7,10,266,208,6,13,29,16,8,280
2020-03-19,세종,광주,136,4,5,9,1,3,158,100,1,9,8,0,5,123
2020-03-19,세종,대구,83,3,2,5,2,2,97,152,3,4,7,13,4,183
2020-03-19,세종,대전,2980,95,65,37,56,227,3460,3019,97,65,43,48,232,3504
2020-03-19,세종,부산,18,0,0,1,1,0,20,13,0,1,3,5,0,22
2020-03-19,세종,서울,29,1,0,1,1,2,34,21,0,0,1,0,0,22
2020-03-19,세종,세종,229,26,2,2,0,17,276,229,26,2,2,0,17,276
2020-03-19,세종,울산,5,0,0,2,3,1,11,7,0,1,2,7,0,17
2020-03-19,세종,전남,128,3,6,8,14,2,161,89,0,4,4,5,0,102
2020-03-19,세종,전북,495,19,26,20,33,20,613,499,17,19,22,37,16,610
2020-03-19,세종,충남,4998,140,140,113,226,247,5864,3798,143,135,120,177,138,4511
2020-03-19,세종,충북,323,12,17,16,23,19,410,275,13,22,8,25,20,363
2020-03-19,울산,강원,2,0,0,0,0,0,2,2,0,0,0,1,0,3
2020-03-19,울산,경기,35,1,6,37,63,1,143,30,2,0,14,13,0,59
2020-03-19,울산,경남,8103,558,706,445,633,520,10965,8529,635,681,474,786,542,11647
2020-03-19,울산,경북,3902,167,279,341,1369,212,6270,3910,178,278,445,1090,241,6142
2020-03-19,울산,광주,39,1,7,9,12,0,68,48,1,8,3,3,0,63
2020-03-19,울산,대구,736,48,72,69,195,31,1151,738,53,64,74,165,34,1128
2020-03-19,울산,대전,89,4,5,11,27,1,137,78,2,4,16,30,3,133
2020-03-19,울산,부산,14124,390,422,455,2417,1023,18831,14258,377,458,655,2543,1000,19291
2020-03-19,울산,서울,38,1,1,11,18,1,70,22,1,1,1,1,1,27
2020-03-19,울산,세종,7,0,1,2,7,0,17,5,0,0,2,3,1,11
2020-03-19,울산,울산,7696,325,492,293,592,670,10068,7696,325,492,293,592,670,10068
2020-03-19,울산,전남,175,16,24,13,33,4,265,170,14,24,9,42,10,269
2020-03-19,울산,전북,28,0,3,4,13,2,50,29,0,5,5,3,0,42
2020-03-19,울산,충남,90,3,24,41,126,3,287,100,6,10,31,118,6,271
2020-03-19,울산,충북,17,3,4,23,41,1,89,13,1,2,12,30,1,59
2020-03-19,전남,강원,10,0,1,6,5,0,22,23,1,2,3,16,0,45
2020-03-19,전남,경기,555,23,53,115,85,11,842,589,17,80,170,164,20,1040
2020-03-19,전남,경남,5364,253,419,392,1362,217,8007,5060,246,380,478,1408,225,7797
2020-03-19,전남,경북,708,39,60,81,299,20,1207,798,53,64,118,506,18,1557
2020-03-19,전남,광주,29396,989,975,671,1929,1159,35119,30554,981,1092,731,2046,1200,36604
2020-03-19,전남,대구,359,16,33,22,56,9,495,345,13,36,19,50,8,471
2020-03-19,전남,대전,102,5,4,7,6,2,126,224,6,6,25,26,5,292
2020-03-19,전남,부산,1614,75,104,139,648,57,2637,1721,81,124,200,558,63,2747
2020-03-19,전남,서울,615,6,21,54,23,14,733,672,9,18,23,20,25,767
2020-03-19,전남,세종,89,0,4,4,5,0,102,128,3,6,8,14,2,161
2020-03-19,전남,울산,170,14,24,9,42,10,269,175,16,24,13,33,4,265
2020-03-19,전남,전남,40378,1302,1496,1538,5201,1557,51472,40378,1302,1496,1538,5201,1557,51472
2020-03-19,전남,전북,6370,324,657,846,2882,178,11257,3961,245,457,558,1366,115,6702
2020-03-19,전남,충남,1607,47,176,433,277,40,2580,3739,97,361,514,1020,101,5832
2020-03-19,전남,충북,135,13,19,36,63,2,268,276,21,35,115,279,8,734
2020-03-19,전북,강원,119,6,13,17,31,3,189,83,3,13,13,24,2,138
2020-03-19,전북,경기,1069,52,112,203,263,45,1744,892,44,123,131,195,27,1412
2020-03-19,전북,경남,786,38,104,106,177,33,1244,841,39,100,105,213,29,1327
2020-03-19,전북,경북,1340,104,175,152,479,42,2292,1449,84,151,182,277,42,2185
2020-03-19,전북,광주,6826,440,442,373,432,245,8758,6652,414,485,384,396,222,8553
2020-03-19,전북,대구,193,9,22,19,30,6,279,170,14,24,11,18,5,242
2020-03-19,전북,대전,2667,102,69,79,67,92,3076,2461,88,79,70,42,98,2838
2020-03-19,전북,부산,204,5,23,38,55,3,328,214,10,26,42,85,6,383
2020-03-19,전북,서울,978,24,55,48,32,35,1172,995,25,47,24,21,37,1149
2020-03-19,전북,세종,499,17,19,22,37,16,610,495,19,26,20,33,20,613
2020-03-19,전북,울산,29,0,5,5,3,0,42,28,0,3,4,13,2,50
2020-03-19,전북,전남,3961,245,457,558,1366,115,6702,6370,324,657,846,2882,178,11257
2020-03-19,전북,전북,14888,648,904,856,1437,541,19274,14888,648,904,856,1437,541,19274
2020-03-19,전북,충남,13472,569,1467,1458,2419,446,19831,10906,474,1298,1037,1441,375,15531
2020-03-19,전북,충북,1653,124,181,346,525,58,2887,1425,139,181,269,298,41,2353
2020-03-19,충남,강원,301,5,20,39,60,12,437,223,9,19,33,46,7,337
2020-03-19,충남,경기,31821,1474,2491,2454,4405,1549,44194,31676,1547,2681,2478,4678,1570,44630
2020-03-19,충남,경남,1304,55,175,376,574,36,2520,840,51,128,290,278,30,1617
2020-03-19,충남,경북,2436,145,364,499,773,75,4292,2274,157,334,585,609,68,4027
2020-03-19,충남,광주,3633,152,409,633,367,87,5281,3418,116,425,491,260,97,4807
2020-03-19,충남,대구,595,54,115,149,200,11,1124,1008,65,136,224,233,27,1693
2020-03-19,충남,대전,13185,451,460,241,268,965,15570,14562,470,502,262,234,1098,17128
2020-03-19,충남,부산,114,12,22,78,194,1,421,123,11,23,75,180,5,417
2020-03-19,충남,서울,23593,656,1688,1308,1239,870,29354,22321,534,1743,811,799,855,27063
2020-03-19,충남,세종,3798,143,135,120,177,138,4511,4998,140,140,113,226,247,5864
2020-03-19,충남,울산,100,6,10,31,118,6,271,90,3,24,41,126,3,287
2020-03-19,충남,전남,3739,97,361,514,1020,101,5832,1607,47,176,433,277,40,2580
2020-03-19,충남,전북,10906,474,1298,1037,1441,375,15531,13472,569,1467,1458,2419,446,19831
2020-03-19,충남,충남,83926,3602,6826,7519,10881,3907,116661,83926,3602,6826,7519,10881,3907,116661
2020-03-19,충남,충북,12003,634,845,970,1482,725,16659,10976,612,776,847,1462,620,15293
2020-03-19,충북,강원,3563,202,215,221,388,225,4814,3542,237,246,265,419,232,4941
2020-03-19,충북,경기,23331,2067,2664,2853,3702,1094,35711,23386,2182,2757,3259,3465,1144,36193
2020-03-19,충북,경남,1123,85,215,502,655,33,2613,858,59,133,300,356,32,1738
2020-03-19,충북,경북,3463,268,465,662,1121,116,6095,3625,253,488,708,1032,116,6222
2020-03-19,충북,광주,490,39,93,187,125,14,948,444,32,58,104,80,12,730
2020-03-19,충북,대구,705,77,115,217,163,18,1295,1019,94,174,247,405,34,1973
2020-03-19,충북,대전,8952,391,368,200,165,664,10740,9957,473,395,217,188,714,11944
2020-03-19,충북,부산,94,19,33,122,209,1,478,96,8,30,105,227,1,467
2020-03-19,충북,서울,12016,647,869,851,850,479,15712,12311,519,889,840,782,492,15833
2020-03-19,충북,세종,275,13,22,8,25,20,363,323,12,17,16,23,19,410
2020-03-19,충북,울산,13,1,2,12,30,1,59,17,3,4,23,41,1,89
2020-03-19,충북,전남,276,21,35,115,279,8,734,135,13,19,36,63,2,268
2020-03-19,충북,전북,1425,139,181,269,298,41,2353,1653,124,181,346,525,58,2887
2020-03-19,충북,충남,10976,612,776,847,1462,620,15293,12003,634,845,970,1482,725,16659
2020-03-19,충북,충북,32012,1876,2209,2091,3430,1910,43528,32012,1876,2209,2091,3430,1910,43528
2020-03-20,강원,강원,72200,2464,2517,1508,2856,4613,86158,72200,2464,2517,1508,2856,4613,86158
2020-03-20,강원,경기,21211,576,885,751,695,990,25108,30648,644,892,854,848,1356,35242
2020-03-20,강원,경남,141,0,6,10,23,7,187,118,2,9,19,24,4,176
2020-03-20,강원,경북,376,19,21,18,23,19,476,416,17,23,23,31,14,524
2020-03-20,강원,광주,89,0,10,6,9,3,117,71,1,12,9,2,2,97
2020-03-20,강원,대구,163,2,3,7,7,7,189,235,7,7,21,21,5,296
2020-03-20,강원,대전,170,13,11,7,2,8,211,201,10,8,5,3,9,236
2020-03-20,강원,부산,4,0,1,0,0,0,5,4,0,0,0,4,0,8
2020-03-20,강원,서울,815,10,153,11,25,32,1046,990,14,136,9,19,37,1205
2020-03-20,강원,세종,8,0,1,1,0,0,10,5,1,0,0,0,0,6
2020-03-20,강원,울산,1,0,0,0,0,1,2,4,0,0,0,2,0,6
2020-03-20,강원,전남,58,1,3,6,12,0,80,23,0,1,4,6,0,34
2020-03-20,강원,전북,130,2,9,15,12,6,174,143,6,9,17,27,8,210
2020-03-20,강원,충남,336,5,16,23,46,18,444,545,11,15,39,76,27,713
2020-03-20,강원,충북,4701,228,271,282,425,279,6186,5316,211,228,202,399,315,6671
2020-03-20,경기,강원,30648,644,892,854,848,1356,35242,21211,576,885,751,695,990,25108
2020-03-20,경기,경기,452858,23813,24394,20757,24937,32614,579373,452858,23813,24394,20757,24937,32614,579373
2020-03-20,경기,경남,3588,91,302,737,585,118,5421,2446,68,220,561,417,93,3805
2020-03-20,경기,경북,3894,173,458,711,614,145,5995,4093,201,416,956,605,141,6412
2020-03-20,경기,광주,1271,30,117,303,144,38,1903,777,19,111,250,118,22,1297
2020-03-20,경기,대구,1561,93,146,349,190,40,2379,2556,125,175,452,432,80,3820
2020-03-20,경기,대전,2710,100,147,123,57,133,3270,2211,108,153,112,49,89,2722
2020-03-20,경기,부산,247,14,47,187,181,9,685,298,18,39,160,250,8,773
2020-03-20,경기,서울,154023,7296,8411,5108,4049,10090,188977,147632,6844,8744,4732,3547,9771,181270
2020-03-20,경기,세종,56,2,2,0,4,0,64,58,2,3,5,4,4,76
2020-03-20,경기,울산,35,0,1,18,23,2,79,54,4,8,23,60,0,149
2020-03-20,경기,전남,1176,33,69,166,165,41,1650,767,16,56,95,87,28,1049
2020-03-20,경기,전북,2054,51,136,131,183,76,2631,1598,57,123,201,252,41,2272
2020-03-20,경기,충남,43703,1600,2757,2621,4616,2262,57559,43271,1531,2679,2471,4439,2185,56576
2020-03-20,경기,충북,31409,2282,2804,3241,3728,1558,45022,30232,2158,2614,2898,3914,1456,43272
2020-03-20,경남,강원,118,2,9,19,24,4,176,141,0,6,10,23,7,187
2020-03-20,경남,경기,2446,68,220,561,417,93,3805,3588,91,302,737,585,118,5421
2020-03-20,경남,경남,199517,10110,9635,7488,14362,14597,255709,199517,10110,9635,7488,14362,14597,255709
2020-03-20,경남,경북,9357,593,875,981,1963,416,14185,12881,869,1119,1309,2767,647,19592
2020-03-20,경남,광주,1449,60,118,184,156,46,2013,1166,49,151,159,98,37,1660
2020-03-20,경남,대구,11363,725,763,1065,1600,459,15975,9044,485,542,399,575,367,11412
2020-03-20,경남,대전,937,18,88,72,69,46,1230,1168,30,95,112,89,64,1558
2020-03-20,경남,부산,89812,2655,2551,2109,4728,6284,108139,87969,2732,2675,2087,4808,6141,106412
2020-03-20,경남,서울,2188,37,318,297,165,63,3068,2875,48,327,213,120,91,3674
2020-03-20,경남,세종,222,2,11,9,7,9,260,365,0,9,14,21,12,421
2020-03-20,경남,울산,9981,633,674,500,697,624,13109,9663,619,707,481,673,595,12738
2020-03-20,경남,전남,6431,270,418,518,1377,279,9293,6900,311,455,426,1309,305,9706
2020-03-20,경남,전북,1345,47,93,88,201,35,1809,1246,51,103,119,180,49,1748
2020-03-20,경남,충남,1205,46,111,306,298,54,2020,2397,60,173,347,577,99,3653
2020-03-20,경남,충북,1189,53,112,291,316,41,2002,1793,59,193,497,644,77,3263
2020-03-20,경북,강원,416,17,23,23,31,14,524,376,19,21,18,23,19,476
2020-03-20,경북,경기,4093,201,416,956,605,141,6412,3894,173,458,711,614,145,5995
2020-03-20,경북,경남,12881,869,1119,1309,2767,647,19592,9357,593,875,981,1963,416,14185
2020-03-20,경북,경북,69627,3963,3763,3103,5344,3687,89487,69627,3963,3763,3103,5344,3687,89487
2020-03-20,경북,광주,927,57,107,198,160,13,1462,680,42,109,158,98,13,1100
2020-03-20,경북,대구,66126,2890,2296,1696,3253,3379,79640,68812,3039,2555,2056,3899,3467,83828
2020-03-20,경북,대전,1845,76,90,98,76,89,2274,1562,48,88,117,57,88,1960
2020-03-20,경북,부산,4725,111,204,205,693,209,6147,4272,115,208,236,828,206,5865
2020-03-20,경북,서울,2617,96,242,331,158,102,3546,2770,78,208,231,128,77,3492
2020-03-20,경북,세종,302,7,15,22,11,10,367,281,8,7,28,10,11,345
2020-03-20,경북,울산,5022,154,315,419,1042,290,7242,5010,158,318,339,1272,296,7393
2020-03-20,경북,전남,1158,44,67,98,463,30,1860,842,38,70,87,320,17,1374
2020-03-20,경북,전북,1777,89,168,190,253,70,2547,1661,96,177,159,490,50,2633
2020-03-20,경북,충남,3055,154,362,598,688,124,4981,3466,167,368,489,869,149,5508
2020-03-20,경북,충북,4950,233,456,712,1018,207,7576,4696,252,511,621,1063,169,7312
2020-03-20,광주,강원,71,1,12,9,2,2,97,89,0,10,6,9,3,117
2020-03-20,광주,경기,777,19,111,250,118,22,1297,1271,30,117,303,144,38,1903
2020-03-20,광주,경남,1166,49,151,159,98,37,1660,1449,60,118,184,156,46,2013
2020-03-20,광주,경북,680,42,109,158,98,13,1100,927,57,107,198,160,13,1462
2020-03-20,광주,광주,14518,529,582,418,366,555,16968,14518,529,582,418,366,555,16968
2020-03-20,광주,대구,480,26,72,65,25,14,682,500,30,69,68,30,16,713
2020-03-20,광주,대전,444,17,13,15,15,13,517,568,24,18,26,13,14,663
2020-03-20,광주,부산,330,11,29,35,99,17,521,460,13,39,65,126,10,713
2020-03-20,광주,서울,708,13,15,61,15,24,836,1135,14,25,47,29,29,1279
2020-03-20,광주,세종,181,2,11,3,2,4,203,257,1,8,2,2,9,279
2020-03-20,광주,울산,63,0,6,3,4,1,77,62,0,6,6,11,4,89
2020-03-20,광주,전남,35476,988,1086,821,1965,1419,41755,35487,975,940,706,1960,1375,41443
2020-03-20,광주,전북,7857,454,526,390,396,280,9903,8388,467,489,355,422,294,10415
2020-03-20,광주,충남,4612,116,446,454,240,140,6008,5584,119,482,577,332,153,7247
2020-03-20,광주,충북,571,29,47,104,82,22,855,865,36,75,178,110,34,1298
2020-03-20,대구,강원,235,7,7,21,21,5,296,163,2,3,7,7,7,189
2020-03-20,대구,경기,2556,125,175,452,432,80,3820,1561,93,146,349,190,40,2379
2020-03-20,대구,경남,9044,485,542,399,575,367,11412,11363,725,763,1065,1600,459,15975
2020-03-20,대구,경북,68812,3039,2555,2056,3899,3467,83828,66126,2890,2296,1696,3253,3379,79640
2020-03-20,대구,광주,500,30,69,68,30,16,713,480,26,72,65,25,14,682
2020-03-20,대구,대구,53945,2047,1647,1095,1201,3568,63503,53945,2047,1647,1095,1201,3568,63503
2020-03-20,대구,대전,912,35,25,80,44,35,1131,529,19,18,45,18,12,641
2020-03-20,대구,부산,551,39,122,67,140,30,949,2407,82,169,91,264,92,3105
2020-03-20,대구,서울,2270,61,87,225,106,62,2811,1257,45,76,123,38,38,1577
2020-03-20,대구,세종,216,1,5,8,11,8,249,141,0,2,6,3,3,155
2020-03-20,대구,울산,961,52,72,67,156,43,1351,1070,45,78,78,193,55,1519
2020-03-20,대구,전남,473,11,35,30,47,16,612,490,15,31,23,47,14,620
2020-03-20,대구,전북,295,11,27,15,20,10,378,296,11,25,22,22,12,388
2020-03-20,대구,충남,1225,74,121,222,254,34,1930,1027,43,97,175,180,40,1562
2020-03-20,대구,충북,1443,106,166,266,387,58,2426,1008,76,106,245,126,32,1593
2020-03-20,대전,강원,201,10,8,5,3,9,236,170,13,11,7,2,8,211
2020-03-20,대전,경기,2211,108,153,112,49,89,2722,2710,100,147,123,57,133,3270
2020-03-20,대전,경남,1168,30,95,112,89,64,1558,937,18,88,72,69,46,1230
2020-03-20,대전,경북,1562,48,88,117,57,88,1960,1845,76,90,98,76,89,2274
2020-03-20,대전,광주,568,24,18,26,13,14,663,444,17,13,15,15,13,517
2020-03-20,대전,대구,529,19,18,45,18,12,641,912,35,25,80,44,35,1131
2020-03-20,대전,대전,14011,435,434,246,241,1060,16427,14011,435,434,246,241,1060,16427
2020-03-20,대전,부산,92,3,6,16,14,2,133,73,3,12,18,25,5,136
2020-03-20,대전,서울,1859,44,131,26,14,93,2167,2173,45,134,24,16,97,2489
2020-03-20,대전,세종,3356,114,73,39,62,261,3905,3368,102,80,45,77,251,3923
2020-03-20,대전,울산,113,3,3,17,22,3,161,161,5,4,17,25,7,219
2020-03-20,대전,전남,414,13,6,27,25,14,499,175,3,7,9,8,4,206
2020-03-20,대전,전북,3207,91,93,69,40,139,3639,3449,102,83,81,65,154,3934
2020-03-20,대전,충남,16536,474,454,263,287,1186,19200,15754,464,437,237,302,1150,18344
2020-03-20,대전,충북,11152,474,396,212,199,830,13263,10550,419,373,196,192,763,12493
2020-03-20,부산,강원,4,0,0,0,4,0,8,4,0,1,0,0,0,5
2020-03-20,부산,경기,298,18,39,160,250,8,773,247,14,47,187,181,9,685
2020-03-20,부산,경남,87969,2732,2675,2087,4808,6141,106412,89812,2655,2551,2109,4728,6284,108139
2020-03-20,부산,경북,4272,115,208,236,828,206,5865,4725,111,204,205,693,209,6147
2020-03-20,부산,광주,460,13,39,65,126,10,713,330,11,29,35,99,17,521
2020-03-20,부산,대구,2407,82,169,91,264,92,3105,551,39,122,67,140,30,949
2020-03-20,부산,대전,73,3,12,18,25,5,136,92,3,6,16,14,2,133
2020-03-20,부산,부산,44888,706,648,696,2293,3180,52411,44888,706,648,696,2293,3180,52411
2020-03-20,부산,서울,218,8,17,69,63,4,379,190,9,16,68,39,5,327
2020-03-20,부산,세종,21,0,2,5,5,0,33,26,0,2,0,1,0,29
2020-03-20,부산,울산,15535,351,470,621,2616,1137,20730,17206,361,452,456,2440,1240,22155
2020-03-20,부산,전남,2176,90,120,199,554,78,3217,1905,83,114,108,558,71,2839
2020-03-20,부산,전북,279,13,27,32,91,4,446,234,8,26,29,64,6,367
2020-03-20,부산,충남,142,16,16,64,157,2,397,196,11,26,80,219,6,538
2020-03-20,부산,충북,130,6,22,85,211,1,455,129,10,28,110,163,5,445
2020-03-20,서울,강원,990,14,136,9,19,37,1205,815,10,153,11,25,32,1046
2020-03-20,서울,경기,147632,6844,8744,4732,3547,9771,181270,154023,7296,8411,5108,4049,10090,188977
2020-03-20,서울,경남,2875,48,327,213,120,91,3674,2188,37,318,297,165,63,3068
2020-03-20,서울,경북,2770,78,208,231,128,77,3492,2617,96,242,331,158,102,3546
2020-03-20,서울,광주,1135,14,25,47,29,29,1279,708,13,15,61,15,24,836
2020-03-20,서울,대구,1257,45,76,123,38,38,1577,2270,61,87,225,106,62,2811
2020-03-20,서울,대전,2173,45,134,24,16,97,2489,1859,44,131,26,14,93,2167
2020-03-20,서울,부산,190,9,16,68,39,5,327,218,8,17,69,63,4,379
2020-03-20,서울,서울,198,3,10,1,4,14,230,198,3,10,1,4,14,230
2020-03-20,서울,세종,40,3,0,1,1,2,47,47,1,1,2,1,3,55
2020-03-20,서울,울산,36,0,3,5,2,2,48,33,1,1,10,7,4,56
2020-03-20,서울,전남,1336,6,17,31,24,40,1454,781,10,29,39,20,27,906
2020-03-20,서울,전북,2008,17,41,25,30,67,2188,1435,27,39,37,37,57,1632
2020-03-20,서울,충남,30712,537,1807,823,803,1234,35916,28935,599,1829,1224,1205,1165,34957
2020-03-20,서울,충북,15497,537,907,770,820,653,19184,15400,661,884,833,941,643,19362
2020-03-20,세종,강원,5,1,0,0,0,0,6,8,0,1,1,0,0,10
2020-03-20,세종,경기,58,2,3,5,4,4,76,56,2,2,0,4,0,64
2020-03-20,세종,경남,365,0,9,14,21,12,421,222,2,11,9,7,9,260
2020-03-20,세종,경북,281,8,7,28,10,11,345,302,7,15,22,11,10,367
2020-03-20,세종,광주,257,1,8,2,2,9,279,181,2,11,3,2,4,203
2020-03-20,세종,대구,141,0,2,6,3,3,155,216,1,5,8,11,8,249
2020-03-20,세종,대전,3368,102,80,45,77,251,3923,3356,114,73,39,62,261,3905
2020-03-20,세종,부산,26,0,2,0,1,0,29,21,0,2,5,5,0,33
2020-03-20,세종,서울,47,1,1,2,1,3,55,40,3,0,1,1,2,47
2020-03-20,세종,세종,271,25,1,2,0,21,320,271,25,1,2,0,21,320
2020-03-20,세종,울산,14,1,0,1,3,0,19,14,0,2,1,3,0,20
2020-03-20,세종,전남,262,1,6,7,16,6,298,150,1,5,13,9,5,183
2020-03-20,세종,전북,835,22,23,14,26,36,956,796,8,15,19,40,33,911
2020-03-20,세종,충남,6188,163,175,135,238,333,7232,5098,139,145,123,182,246,5933
2020-03-20,세종,충북,407,11,25,13,21,23,500,325,15,20,10,21,18,409
2020-03-20,울산,강원,4,0,0,0,2,0,6,1,0,0,0,0,1,2
2020-03-20,울산,경기,54,4,8,23,60,0,149,35,0,1,18,23,2,79
2020-03-20,울산,경남,9663,619,707,481,673,595,12738,9981,633,674,500,697,624,13109
2020-03-20,울산,경북,5010,158,318,339,1272,296,7393,5022,154,315,419,1042,290,7242
2020-03-20,울산,광주,62,0,6,6,11,4,89,63,0,6,3,4,1,77
2020-03-20,울산,대구,1070,45,78,78,193,55,1519,961,52,72,67,156,43,1351
2020-03-20,울산,대전,161,5,4,17,25,7,219,113,3,3,17,22,3,161
2020-03-20,울산,부산,17206,361,452,456,2440,1240,22155,15535,351,470,621,2616,1137,20730
2020-03-20,울산,서울,33,1,1,10,7,4,56,36,0,3,5,2,2,48
2020-03-20,울산,세종,14,0,2,1,3,0,20,14,1,0,1,3,0,19
2020-03-20,울산,울산,7976,312,486,288,576,699,10337,7976,312,486,288,576,699,10337
2020-03-20,울산,전남,233,10,29,19,23,7,321,244,16,25,8,38,4,335
2020-03-20,울산,전북,88,0,6,4,19,1,118,46,0,2,2,7,3,60
2020-03-20,울산,충남,142,5,13,56,124,5,345,163,4,7,34,111,10,329
2020-03-20,울산,충북,18,4,5,13,55,0,95,23,2,7,15,34,1,82
2020-03-20,전남,강원,23,0,1,4,6,0,34,58,1,3,6,12,0,80
2020-03-20,전남,경기,767,16,56,95,87,28,1049,1176,33,69,166,165,41,1650
2020-03-20,전남,경남,6900,311,455,426,1309,305,9706,6431,270,418,518,1377,279,9293
2020-03-20,전남,경북,842,38,70,87,320,17,1374,1158,44,67,98,463,30,1860
2020-03-20,전남,광주,35487,975,940,706,1960,1375,41443,35476,988,1086,821,1965,1419,41755
2020-03-20,전남,대구,490,15,31,23,47,14,620,473,11,35,30,47,16,612
2020-03-20,전남,대전,175,3,7,9,8,4,206,414,13,6,27,25,14,499
2020-03-20,전남,부산,1905,83,114,108,558,71,2839,2176,90,120,199,554,78,3217
2020-03-20,전남,서울,781,10,29,39,20,27,906,1336,6,17,31,24,40,1454
2020-03-20,전남,세종,150,1,5,13,9,5,183,262,1,6,7,16,6,298
2020-03-20,전남,울산,244,16,25,8,38,4,335,233,10,29,19,23,7,321
2020-03-20,전남,전남,49411,1405,1516,1630,5194,1878,61034,49411,1405,1516,1630,5194,1878,61034
2020-03-20,전남,전북,8909,306,620,761,2644,283,13523,5510,223,404,579,1396,177,8289
2020-03-20,전남,충남,2165,55,191,413,275,63,3162,6671,85,351,483,996,205,8791
2020-03-20,전남,충북,215,16,11,37,57,7,343,558,27,33,104,258,7,987
2020-03-20,전북,강원,143,6,9,17,27,8,210,130,2,9,15,12,6,174
2020-03-20,전북,경기,1598,57,123,201,252,41,2272,2054,51,136,131,183,76,2631
2020-03-20,전북,경남,1246,51,103,119,180,49,1748,1345,47,93,88,201,35,1809
2020-03-20,전북,경북,1661,96,177,159,490,50,2633,1777,89,168,190,253,70,2547
2020-03-20,전북,광주,8388,467,489,355,422,294,10415,7857,454,526,390,396,280,9903
2020-03-20,전북,대구,296,11,25,22,22,12,388,295,11,27,15,20,10,378
2020-03-20,전북,대전,3449,102,83,81,65,154,3934,3207,91,93,69,40,139,3639
2020-03-20,전북,부산,234,8,26,29,64,6,367,279,13,27,32,91,4,446
2020-03-20,전북,서울,1435,27,39,37,37,57,1632,2008,17,41,25,30,67,2188
2020-03-20,전북,세종,796,8,15,19,40,33,911,835,22,23,14,26,36,956
2020-03-20,전북,울산,46,0,2,2,7,3,60,88,0,6,4,19,1,118
2020-03-20,전북,전남,5510,223,404,579,1396,177,8289,8909,306,620,761,2644,283,13523
2020-03-20,전북,전북,17976,706,922,640,1285,623,22152,17976,706,922,640,1285,623,22152
2020-03-20,전북,충남,18161,564,1505,1375,2249,601,24455,17519,478,1357,943,1440,598,22335
2020-03-20,전북,충북,2248,140,201,345,490,81,3505,2186,129,197,264,339,72,3187
2020-03-20,충남,강원,545,11,15,39,76,27,713,336,5,16,23,46,18,444
2020-03-20,충남,경기,43271,1531,2679,2471,4439,2185,56576,43703,1600,2757,2621,4616,2262,57559
2020-03-20,충남,경남,2397,60,173,347,577,99,3653,1205,46,111,306,298,54,2020
2020-03-20,충남,경북,3466,167,368,489,869,149,5508,3055,154,362,598,688,124,4981
2020-03-20,충남,광주,5584,119,482,577,332,153,7247,4612,116,446,454,240,140,6008
2020-03-20,충남,대구,1027,43,97,175,180,40,1562,1225,74,121,222,254,34,1930
2020-03-20,충남,대전,15754,464,437,237,302,1150,18344,16536,474,454,263,287,1186,19200
2020-03-20,충남,부산,196,11,26,80,219,6,538,142,16,16,64,157,2,397
2020-03-20,충남,서울,28935,599,1829,1224,1205,1165,34957,30712,537,1807,823,803,1234,35916
2020-03-20,충남,세종,5098,139,145,123,182,246,5933,6188,163,175,135,238,333,7232
2020-03-20,충남,울산,163,4,7,34,111,10,329,142,5,13,56,124,5,345
2020-03-20,충남,전남,6671,85,351,483,996,205,8791,2165,55,191,413,275,63,3162
2020-03-20,충남,전북,17519,478,1357,943,1440,598,22335,18161,564,1505,1375,2249,601,24455
2020-03-20,충남,충남,107174,3621,7058,7125,10949,5052,140979,107174,3621,7058,7125,10949,5052,140979
2020-03-20,충남,충북,14352,685,822,1030,1502,813,19204,12815,665,805,886,1578,737,17486
2020-03-20,충북,강원,5316,211,228,202,399,315,6671,4701,228,271,282,425,279,6186
2020-03-20,충북,경기,30232,2158,2614,2898,3914,1456,43272,31409,2282,2804,3241,3728,1558,45022
2020-03-20,충북,경남,1793,59,193,497,644,77,3263,1189,53,112,291,316,41,2002
2020-03-20,충북,경북,4696,252,511,621,1063,169,7312,4950,233,456,712,1018,207,7576
2020-03-20,충북,광주,865,36,75,178,110,34,1298,571,29,47,104,82,22,855
2020-03-20,충북,대구,1008,76,106,245,126,32,1593,1443,106,166,266,387,58,2426
2020-03-20,충북,대전,10550,419,373,196,192,763,12493,11152,474,396,212,199,830,13263
2020-03-20,충북,부산,129,10,28,110,163,5,445,130,6,22,85,211,1,455
2020-03-20,충북,서울,15400,661,884,833,941,643,19362,15497,537,907,770,820,653,19184
2020-03-20,충북,세종,325,15,20,10,21,18,409,407,11,25,13,21,23,500
2020-03-20,충북,울산,23,2,7,15,34,1,82,18,4,5,13,55,0,95
2020-03-20,충북,전남,558,27,33,104,258,7,987,215,16,11,37,57,7,343
2020-03-20,충북,전북,2186,129,197,264,339,72,3187,2248,140,201,345,490,81,3505
2020-03-20,충북,충남,12815,665,805,886,1578,737,17486,14352,685,822,1030,1502,813,19204
2020-03-20,충북,충북,37832,2088,2305,2436,3433,2184,50278,37832,2088,2305,2436,3433,2184,50278
2020-03-21,강원,강원,90068,1590,1694,877,2268,4474,100971,90068,1590,1694,877,2268,4474,100971
2020-03-21,강원,경기,32959,332,598,358,418,1309,35974,45450,376,618,373,554,1701,49072
2020-03-21,강원,경남,137,2,6,6,7,3,161,105,1,5,7,10,3,131
2020-03-21,강원,경북,411,19,17,14,8,23,492,415,12,9,9,13,15,473
2020-03-21,강원,광주,68,2,12,11,2,4,99,69,2,4,6,2,3,86
2020-03-21,강원,대구,160,6,5,19,0,4,194,271,5,5,10,3,8,302
2020-03-21,강원,대전,180,2,10,0,1,7,200,214,1,7,10,3,11,246
2020-03-21,강원,부산,4,1,0,0,3,0,8,7,0,0,0,1,1,9
2020-03-21,강원,서울,1037,4,136,14,8,41,1240,1584,4,136,5,5,52,1786
2020-03-21,강원,세종,5,0,0,0,2,0,7,10,0,0,0,2,0,12
2020-03-21,강원,울산,0,0,1,0,0,0,1,0,0,0,0,1,0,1
2020-03-21,강원,전남,46,1,1,2,8,4,62,18,2,3,7,2,1,33
2020-03-21,강원,전북,127,1,9,3,1,9,150,193,4,8,10,6,9,230
2020-03-21,강원,충남,289,3,5,9,9,14,329,587,8,10,22,35,11,673
2020-03-21,강원,충북,4813,143,127,170,296,250,5799,5690,134,126,145,294,276,6665
2020-03-21,경기,강원,45450,376,618,373,554,1701,49072,32959,332,598,358,418,1309,35974
2020-03-21,경기,경기,378169,10504,11524,8789,12468,23196,444650,378169,10504,11524,8789,12468,23196,444650
2020-03-21,경기,경남,2867,54,206,478,333,124,4062,1750,21,141,282,225,69,2488
2020-03-21,경기,경북,3911,71,236,371,346,147,5082,3138,64,180,457,278,125,4242
2020-03-21,경기,광주,982,23,86,161,84,42,1378,656,10,40,99,63,22,890
2020-03-21,경기,대구,1235,40,88,238,123,47,1771,1860,39,85,212,175,73,2444
2020-03-21,경기,대전,2937,36,116,75,32,135,3331,2327,44,115,47,26,119,2678
2020-03-21,경기,부산,249,10,35,126,85,10,515,193,4,15,78,91,3,384
2020-03-21,경기,서울,132454,4065,4625,2849,2464,7657,154114,128759,3609,4782,2245,2166,7302,148863
2020-03-21,경기,세종,38,1,1,1,2,2,45,50,1,1,1,0,1,54
2020-03-21,경기,울산,22,0,2,6,10,3,43,41,0,4,7,23,2,77
2020-03-21,경기,전남,1294,14,52,92,104,41,1597,724,16,34,62,40,27,903
2020-03-21,경기,전북,2281,31,88,74,106,77,2657,1700,24,68,66,104,58,2020
2020-03-21,경기,충남,47839,713,1462,1095,2159,2208,55476,43104,705,1381,1142,2254,2061,50647
2020-03-21,경기,충북,32149,960,1239,1445,1813,1552,39158,28429,912,1149,1335,1920,1368,35113
2020-03-21,경남,강원,105,1,5,7,10,3,131,137,2,6,6,7,3,161
2020-03-21,경남,경기,1750,21,141,282,225,69,2488,2867,54,206,478,333,124,4062
2020-03-21,경남,경남,187288,5751,5254,4406,9456,12369,224524,187288,5751,5254,4406,9456,12369,224524
2020-03-21,경남,경북,10732,279,476,383,991,508,13369,13563,387,612,602,1242,613,17019
2020-03-21,경남,광주,1437,25,90,102,64,34,1752,1439,28,69,71,59,42,1708
2020-03-21,경남,대구,11945,340,490,444,680,492,14391,11728,254,323,243,314,450,13312
2020-03-21,경남,대전,992,5,69,31,29,52,1178,1405,14,68,78,40,59,1664
2020-03-21,경남,부산,87102,1488,1595,1026,2347,5569,99127,86477,1442,1633,926,2383,5548,98409
2020-03-21,경남,서울,1851,22,268,136,76,77,2430,2715,24,311,142,71,114,3377
2020-03-21,경남,세종,177,3,4,8,7,5,204,350,1,8,5,3,10,377
2020-03-21,경남,울산,9841,369,355,263,367,599,11794,10005,343,380,257,339,568,11892
2020-03-21,경남,전남,8392,143,213,271,870,351,10240,7757,156,248,233,883,339,9616
2020-03-21,경남,전북,1635,27,76,48,143,54,1983,1362,34,79,44,143,46,1708
2020-03-21,경남,충남,1074,19,46,100,117,44,1400,1934,19,82,190,245,66,2536
2020-03-21,경남,충북,1107,18,55,134,169,44,1527,1642,40,106,258,380,55,2481
2020-03-21,경북,강원,415,12,9,9,13,15,473,411,19,17,14,8,23,492
2020-03-21,경북,경기,3138,64,180,457,278,125,4242,3911,71,236,371,346,147,5082
2020-03-21,경북,경남,13563,387,612,602,1242,613,17019,10732,279,476,383,991,508,13369
2020-03-21,경북,경북,76741,2328,2201,1700,3818,3451,90239,76741,2328,2201,1700,3818,3451,90239
2020-03-21,경북,광주,697,22,62,84,73,20,958,593,19,45,70,45,6,778
2020-03-21,경북,대구,63169,1750,1363,983,3046,2839,73150,70538,1782,1496,1174,3283,3127,81400
2020-03-21,경북,대전,1876,28,53,47,47,104,2155,1981,25,46,82,33,93,2260
2020-03-21,경북,부산,5449,71,122,74,271,222,6209,6043,71,145,84,300,259,6902
2020-03-21,경북,서울,2300,36,150,193,94,74,2847,2927,37,160,124,85,110,3443
2020-03-21,경북,세종,296,1,7,8,16,15,343,322,3,6,4,5,10,350
2020-03-21,경북,울산,5646,77,169,228,623,333,7076,5864,73,176,165,754,304,7336
2020-03-21,경북,전남,1577,33,46,50,237,56,1999,1048,26,38,40,131,31,1314
2020-03-21,경북,전북,2008,49,102,101,152,53,2465,1809,56,93,69,238,51,2316
2020-03-21,경북,충남,2764,68,129,263,315,111,3650,3453,65,166,291,372,118,4465
2020-03-21,경북,충북,5031,115,226,334,590,211,6507,5249,125,259,350,720,233,6936
2020-03-21,광주,강원,69,2,4,6,2,3,86,68,2,12,11,2,4,99
2020-03-21,광주,경기,656,10,40,99,63,22,890,982,23,86,161,84,42,1378
2020-03-21,광주,경남,1439,28,69,71,59,42,1708,1437,25,90,102,64,34,1752
2020-03-21,광주,경북,593,19,45,70,45,6,778,697,22,62,84,73,20,958
2020-03-21,광주,광주,14927,329,387,242,220,538,16643,14927,329,387,242,220,538,16643
2020-03-21,광주,대구,363,9,33,64,8,8,485,439,16,44,40,8,15,562
2020-03-21,광주,대전,534,7,7,12,4,18,582,605,6,8,17,14,22,672
2020-03-21,광주,부산,395,5,34,16,35,8,493,454,5,32,27,46,16,580
2020-03-21,광주,서울,608,10,17,41,11,23,710,963,7,15,34,10,22,1051
2020-03-21,광주,세종,137,0,3,4,1,5,150,253,1,4,3,1,3,265
2020-03-21,광주,울산,49,0,4,2,5,0,60,52,0,3,2,3,2,62
2020-03-21,광주,전남,44825,701,738,485,1184,1546,49479,40939,677,717,422,1264,1349,45368
2020-03-21,광주,전북,9454,257,283,189,225,286,10694,9200,294,286,189,325,277,10571
2020-03-21,광주,충남,4262,48,319,206,159,124,5118,5335,63,351,324,218,162,6453
2020-03-21,광주,충북,539,16,41,48,30,17,691,662,13,37,88,60,21,881
2020-03-21,대구,강원,271,5,5,10,3,8,302,160,6,5,19,0,4,194
2020-03-21,대구,경기,1860,39,85,212,175,73,2444,1235,40,88,238,123,47,1771
2020-03-21,대구,경남,11728,254,323,243,314,450,13312,11945,340,490,444,680,492,14391
2020-03-21,대구,경북,70538,1782,1496,1174,3283,3127,81400,63169,1750,1363,983,3046,2839,73150
2020-03-21,대구,광주,439,16,44,40,8,15,562,363,9,33,64,8,8,485
2020-03-21,대구,대구,43836,1158,912,559,795,2561,49821,43836,1158,912,559,795,2561,49821
2020-03-21,대구,대전,725,13,16,36,25,32,847,445,10,14,43,11,14,537
2020-03-21,대구,부산,713,11,80,37,89,22,952,3250,28,118,42,100,151,3689
2020-03-21,대구,서울,1894,29,58,85,53,56,2175,1095,25,56,96,31,32,1335
2020-03-21,대구,세종,179,0,1,5,2,7,194,116,0,1,1,2,9,129
2020-03-21,대구,울산,1114,29,45,45,68,50,1351,1103,22,47,32,94,46,1344
2020-03-21,대구,전남,932,4,22,15,16,27,1016,694,14,24,10,21,20,783
2020-03-21,대구,전북,347,7,9,6,7,11,387,273,8,14,4,7,9,315
2020-03-21,대구,충남,1072,23,43,78,94,41,1351,756,14,46,73,118,25,1032
2020-03-21,대구,충북,1377,31,69,121,181,47,1826,951,44,61,136,108,33,1333
2020-03-21,대전,강원,214,1,7,10,3,11,246,180,2,10,0,1,7,200
2020-03-21,대전,경기,2327,44,115,47,26,119,2678,2937,36,116,75,32,135,3331
2020-03-21,대전,경남,1405,14,68,78,40,59,1664,992,5,69,31,29,52,1178
2020-03-21,대전,경북,1981,25,46,82,33,93,2260,1876,28,53,47,47,104,2155
2020-03-21,대전,광주,605,6,8,17,14,22,672,534,7,7,12,4,18,582
2020-03-21,대전,대구,445,10,14,43,11,14,537,725,13,16,36,25,32,847
2020-03-21,대전,대전,12423,236,262,130,196,854,14101,12423,236,262,130,196,854,14101
2020-03-21,대전,부산,84,0,2,9,3,2,100,85,1,7,8,24,2,127
2020-03-21,대전,서울,1849,20,145,16,4,82,2116,2302,22,134,24,7,120,2609
2020-03-21,대전,세종,2737,68,38,17,54,166,3080,2802,68,43,19,64,157,3153
2020-03-21,대전,울산,86,1,1,11,17,6,122,96,2,1,5,11,6,121
2020-03-21,대전,전남,720,3,4,19,24,22,792,219,3,3,5,6,5,241
2020-03-21,대전,전북,4522,50,59,45,32,209,4917,4364,57,58,33,53,200,4765
2020-03-21,대전,충남,15869,263,305,160,191,903,17691,14485,273,289,127,196,849,16219
2020-03-21,대전,충북,10295,276,268,115,132,623,11709,9518,247,266,118,147,596,10892
2020-03-21,부산,강원,7,0,0,0,1,1,9,4,1,0,0,3,0,8
2020-03-21,부산,경기,193,4,15,78,91,3,384,249,10,35,126,85,10,515
2020-03-21,부산,경남,86477,1442,1633,926,2383,5548,98409,87102,1488,1595,1026,2347,5569,99127
2020-03-21,부산,경북,6043,71,145,84,300,259,6902,5449,71,122,74,271,222,6209
2020-03-21,부산,광주,454,5,32,27,46,16,580,395,5,34,16,35,8,493
2020-03-21,부산,대구,3250,28,118,42,100,151,3689,713,11,80,37,89,22,952
2020-03-21,부산,대전,85,1,7,8,24,2,127,84,0,2,9,3,2,100
2020-03-21,부산,부산,52540,390,300,406,1144,3071,57851,52540,390,300,406,1144,3071,57851
2020-03-21,부산,서울,172,4,9,37,27,0,249,213,3,16,44,18,9,303
2020-03-21,부산,세종,20,3,1,2,4,1,31,27,1,0,0,0,0,28
2020-03-21,부산,울산,16772,197,219,279,1182,1027,19676,18280,194,196,171,1197,1154,21192
2020-03-21,부산,전남,2304,35,71,90,294,89,2883,2024,34,61,61,262,84,2526
2020-03-21,부산,전북,348,5,24,5,25,10,417,287,3,20,18,23,10,361
2020-03-21,부산,충남,121,3,11,22,61,3,221,140,2,14,44,96,8,304
2020-03-21,부산,충북,104,1,10,33,98,5,251,127,2,12,73,93,7,314
2020-03-21,서울,강원,1584,4,136,5,5,52,1786,1037,4,136,14,8,41,1240
2020-03-21,서울,경기,128759,3609,4782,2245,2166,7302,148863,132454,4065,4625,2849,2464,7657,154114
2020-03-21,서울,경남,2715,24,311,142,71,114,3377,1851,22,268,136,76,77,2430
2020-03-21,서울,경북,2927,37,160,124,85,110,3443,2300,36,150,193,94,74,2847
2020-03-21,서울,광주,963,7,15,34,10,22,1051,608,10,17,41,11,23,710
2020-03-21,서울,대구,1095,25,56,96,31,32,1335,1894,29,58,85,53,56,2175
2020-03-21,서울,대전,2302,22,134,24,7,120,2609,1849,20,145,16,4,82,2116
2020-03-21,서울,부산,213,3,16,44,18,9,303,172,4,9,37,27,0,249
2020-03-21,서울,서울,182,3,10,1,3,15,214,182,3,10,1,3,15,214
2020-03-21,서울,세종,28,0,0,3,0,1,32,40,0,0,1,0,1,42
2020-03-21,서울,울산,32,0,4,1,1,1,39,33,1,3,6,13,0,56
2020-03-21,서울,전남,1467,11,15,17,25,44,1579,799,8,10,23,16,18,874
2020-03-21,서울,전북,2245,10,32,12,12,81,2392,1442,14,39,17,14,52,1578
2020-03-21,서울,충남,36744,229,1487,406,438,1518,40822,32566,279,1469,575,635,1339,36863
2020-03-21,서울,충북,16994,217,619,428,417,684,19359,15394,237,620,509,470,634,17864
2020-03-21,세종,강원,10,0,0,0,2,0,12,5,0,0,0,2,0,7
2020-03-21,세종,경기,50,1,1,1,0,1,54,38,1,1,1,2,2,45
2020-03-21,세종,경남,350,1,8,5,3,10,377,177,3,4,8,7,5,204
2020-03-21,세종,경북,322,3,6,4,5,10,350,296,1,7,8,16,15,343
2020-03-21,세종,광주,253,1,4,3,1,3,265,137,0,3,4,1,5,150
2020-03-21,세종,대구,116,0,1,1,2,9,129,179,0,1,5,2,7,194
2020-03-21,세종,대전,2802,68,43,19,64,157,3153,2737,68,38,17,54,166,3080
2020-03-21,세종,부산,27,1,0,0,0,0,28,20,3,1,2,4,1,31
2020-03-21,세종,서울,40,0,0,1,0,1,42,28,0,0,3,0,1,32
2020-03-21,세종,세종,248,22,4,0,2,18,294,248,22,4,0,2,18,294
2020-03-21,세종,울산,7,0,0,0,1,1,9,15,0,0,1,3,1,20
2020-03-21,세종,전남,326,1,5,2,10,8,352,128,2,1,1,5,2,139
2020-03-21,세종,전북,1374,9,11,12,33,48,1487,1146,6,11,12,41,48,1264
2020-03-21,세종,충남,7497,108,88,93,173,312,8271,5611,87,87,104,144,220,6253
2020-03-21,세종,충북,377,5,5,20,8,20,435,352,11,12,7,11,23,416
2020-03-21,울산,강원,0,0,0,0,1,0,1,0,0,1,0,0,0,1
2020-03-21,울산,경기,41,0,4,7,23,2,77,22,0,2,6,10,3,43
2020-03-21,울산,경남,10005,343,380,257,339,568,11892,9841,369,355,263,367,599,11794
2020-03-21,울산,경북,5864,73,176,165,754,304,7336,5646,77,169,228,623,333,7076
2020-03-21,울산,광주,52,0,3,2,3,2,62,49,0,4,2,5,0,60
2020-03-21,울산,대구,1103,22,47,32,94,46,1344,1114,29,45,45,68,50,1351
2020-03-21,울산,대전,96,2,1,5,11,6,121,86,1,1,11,17,6,122
2020-03-21,울산,부산,18280,194,196,171,1197,1154,21192,16772,197,219,279,1182,1027,19676
2020-03-21,울산,서울,33,1,3,6,13,0,56,32,0,4,1,1,1,39
2020-03-21,울산,세종,15,0,0,1,3,1,20,7,0,0,0,1,1,9
2020-03-21,울산,울산,5908,144,224,110,304,456,7146,5908,144,224,110,304,456,7146
2020-03-21,울산,전남,253,9,13,2,15,5,297,235,11,16,6,12,8,288
2020-03-21,울산,전북,69,1,5,2,11,1,89,45,0,5,1,1,1,53
2020-03-21,울산,충남,105,2,8,12,46,4,177,102,2,6,16,60,3,189
2020-03-21,울산,충북,16,0,1,6,33,0,56,14,1,1,9,27,0,52
2020-03-21,전남,강원,18,2,3,7,2,1,33,46,1,1,2,8,4,62
2020-03-21,전남,경기,724,16,34,62,40,27,903,1294,14,52,92,104,41,1597
2020-03-21,전남,경남,7757,156,248,233,883,339,9616,8392,143,213,271,870,351,10240
2020-03-21,전남,경북,1048,26,38,40,131,31,1314,1577,33,46,50,237,56,1999
2020-03-21,전남,광주,40939,677,717,422,1264,1349,45368,44825,701,738,485,1184,1546,49479
2020-03-21,전남,대구,694,14,24,10,21,20,783,932,4,22,15,16,27,1016
2020-03-21,전남,대전,219,3,3,5,6,5,241,720,3,4,19,24,22,792
2020-03-21,전남,부산,2024,34,61,61,262,84,2526,2304,35,71,90,294,89,2883
2020-03-21,전남,서울,799,8,10,23,16,18,874,1467,11,15,17,25,44,1579
2020-03-21,전남,세종,128,2,1,1,5,2,139,326,1,5,2,10,8,352
2020-03-21,전남,울산,235,11,16,6,12,8,288,253,9,13,2,15,5,297
2020-03-21,전남,전남,56415,895,1043,1061,3792,1891,65097,56415,895,1043,1061,3792,1891,65097
2020-03-21,전남,전북,10750,203,449,370,1311,301,13384,7800,159,295,361,822,198,9635
2020-03-21,전남,충남,2133,27,126,163,123,64,2636,7821,53,300,291,560,240,9265
2020-03-21,전남,충북,186,4,8,28,30,4,260,685,14,19,72,149,21,960
2020-03-21,전북,강원,193,4,8,10,6,9,230,127,1,9,3,1,9,150
2020-03-21,전북,경기,1700,24,68,66,104,58,2020,2281,31,88,74,106,77,2657
2020-03-21,전북,경남,1362,34,79,44,143,46,1708,1635,27,76,48,143,54,1983
2020-03-21,전북,경북,1809,56,93,69,238,51,2316,2008,49,102,101,152,53,2465
2020-03-21,전북,광주,9200,294,286,189,325,277,10571,9454,257,283,189,225,286,10694
2020-03-21,전북,대구,273,8,14,4,7,9,315,347,7,9,6,7,11,387
2020-03-21,전북,대전,4364,57,58,33,53,200,4765,4522,50,59,45,32,209,4917
2020-03-21,전북,부산,287,3,20,18,23,10,361,348,5,24,5,25,10,417
2020-03-21,전북,서울,1442,14,39,17,14,52,1578,2245,10,32,12,12,81,2392
2020-03-21,전북,세종,1146,6,11,12,41,48,1264,1374,9,11,12,33,48,1487
2020-03-21,전북,울산,45,0,5,1,1,1,53,69,1,5,2,11,1,89
2020-03-21,전북,전남,7800,159,295,361,822,198,9635,10750,203,449,370,1311,301,13384
2020-03-21,전북,전북,19353,430,605,422,873,661,22344,19353,430,605,422,873,661,22344
2020-03-21,전북,충남,20681,263,1028,611,1086,704,24373,20806,244,970,502,813,721,24056
2020-03-21,전북,충북,2392,59,103,120,234,94,3002,2470,75,92,122,209,103,3071
2020-03-21,충남,강원,587,8,10,22,35,11,673,289,3,5,9,9,14,329
2020-03-21,충남,경기,43104,705,1381,1142,2254,2061,50647,47839,713,1462,1095,2159,2208,55476
2020-03-21,충남,경남,1934,19,82,190,245,66,2536,1074,19,46,100,117,44,1400
2020-03-21,충남,경북,3453,65,166,291,372,118,4465,2764,68,129,263,315,111,3650
2020-03-21,충남,광주,5335,63,351,324,218,162,6453,4262,48,319,206,159,124,5118
2020-03-21,충남,대구,756,14,46,73,118,25,1032,1072,23,43,78,94,41,1351
2020-03-21,충남,대전,14485,273,289,127,196,849,16219,15869,263,305,160,191,903,17691
2020-03-21,충남,부산,140,2,14,44,96,8,304,121,3,11,22,61,3,221
2020-03-21,충남,서울,32566,279,1469,575,635,1339,36863,36744,229,1487,406,438,1518,40822
2020-03-21,충남,세종,5611,87,87,104,144,220,6253,7497,108,88,93,173,312,8271
2020-03-21,충남,울산,102,2,6,16,60,3,189,105,2,8,12,46,4,177
2020-03-21,충남,전남,7821,53,300,291,560,240,9265,2133,27,126,163,123,64,2636
2020-03-21,충남,전북,20806,244,970,502,813,721,24056,20681,263,1028,611,1086,704,24373
2020-03-21,충남,충남,110010,1787,4263,3193,5479,4612,129344,110010,1787,4263,3193,5479,4612,129344
2020-03-21,충남,충북,11988,331,388,498,872,593,14670,11177,317,406,403,906,579,13788
2020-03-21,충북,강원,5690,134,126,145,294,276,6665,4813,143,127,170,296,250,5799
2020-03-21,충북,경기,28429,912,1149,1335,1920,1368,35113,32149,960,1239,1445,1813,1552,39158
2020-03-21,충북,경남,1642,40,106,258,380,55,2481,1107,18,55,134,169,44,1527
2020-03-21,충북,경북,5249,125,259,350,720,233,6936,5031,115,226,334,590,211,6507
2020-03-21,충북,광주,662,13,37,88,60,21,881,539,16,41,48,30,17,691
2020-03-21,충북,대구,951,44,61,136,108,33,1333,1377,31,69,121,181,47,1826
2020-03-21,충북,대전,9518,247,266,118,147,596,10892,10295,276,268,115,132,623,11709
2020-03-21,충북,부산,127,2,12,73,93,7,314,104,1,10,33,98,5,251
2020-03-21,충북,서울,15394,237,620,509,470,634,17864,16994,217,619,428,417,684,19359
2020-03-21,충북,세종,352,11,12,7,11,23,416,377,5,5,20,8,20,435
2020-03-21,충북,울산,14,1,1,9,27,0,52,16,0,1,6,33,0,56
2020-03-21,충북,전남,685,14,19,72,149,21,960,186,4,8,28,30,4,260
2020-03-21,충북,전북,2470,75,92,122,209,103,3071,2392,59,103,120,234,94,3002
2020-03-21,충북,충남,11177,317,406,403,906,579,13788,11988,331,388,498,872,593,14670
2020-03-21,충북,충북,33734,1102,1045,1029,2056,1765,40731,33734,1102,1045,1029,2056,1765,40731
2020-03-22,강원,강원,77365,737,1155,320,459,3951,83987,77365,737,1155,320,459,3951,83987
2020-03-22,강원,경기,45164,224,383,201,140,1715,47827,29285,162,384,137,157,1277,31402
2020-03-22,강원,경남,193,1,8,2,7,5,216,98,0,2,5,3,7,115
2020-03-22,강원,경북,507,13,7,5,3,21,556,346,8,8,9,5,18,394
2020-03-22,강원,광주,86,0,8,4,0,4,102,82,1,7,7,1,3,101
2020-03-22,강원,대구,191,1,2,3,0,7,204,181,4,3,7,0,9,204
2020-03-22,강원,대전,230,3,9,0,1,14,257,168,0,10,2,0,17,197
2020-03-22,강원,부산,6,0,0,0,0,0,6,2,0,0,0,0,0,2
2020-03-22,강원,서울,2069,3,157,18,4,82,2333,985,2,125,1,1,40,1154
2020-03-22,강원,세종,3,0,0,1,0,0,4,6,0,0,0,0,1,7
2020-03-22,강원,울산,1,0,0,0,0,0,1,2,0,0,0,0,0,2
2020-03-22,강원,전남,50,1,1,0,4,2,58,22,0,1,2,1,4,30
2020-03-22,강원,전북,165,0,1,0,1,5,172,201,2,4,6,5,9,227
2020-03-22,강원,충남,507,5,5,15,4,19,555,398,4,7,7,4,16,436
2020-03-22,강원,충북,5375,71,72,67,53,250,5888,4610,56,77,26,50,241,5060
2020-03-22,경기,강원,29285,162,384,137,157,1277,31402,45164,224,383,201,140,1715,47827
2020-03-22,경기,경기,312132,4573,5280,3061,2688,17798,345532,312132,4573,5280,3061,2688,17798,345532
2020-03-22,경기,경남,2419,30,135,124,71,105,2884,2874,20,107,123,65,131,3320
2020-03-22,경기,경북,3413,33,99,151,55,123,3874,4284,41,91,207,79,157,4859
2020-03-22,경기,광주,643,2,42,34,15,19,755,999,2,28,34,22,30,1115
2020-03-22,경기,대구,1313,12,32,76,31,32,1496,2017,11,43,71,51,87,2280
2020-03-22,경기,대전,2002,5,80,11,6,113,2217,2940,24,78,13,4,158,3217
2020-03-22,경기,부산,222,1,8,29,34,8,302,472,1,7,13,28,26,547
2020-03-22,경기,서울,104644,1476,3146,1167,466,5762,116661,114996,1654,3160,1101,484,6367,127762
2020-03-22,경기,세종,33,0,0,0,2,3,38,51,0,0,0,2,1,54
2020-03-22,경기,울산,32,0,0,0,1,0,33,30,0,0,3,9,3,45
2020-03-22,경기,전남,759,5,40,25,33,29,891,1269,6,40,47,19,43,1424
2020-03-22,경기,전북,1338,15,54,20,24,54,1505,2730,13,52,36,50,98,2979
2020-03-22,경기,충남,38631,294,878,455,658,1828,42744,44738,327,803,414,635,1974,48891
2020-03-22,경기,충북,25152,450,606,481,509,1285,28483,31142,474,582,460,455,1503,34616
2020-03-22,경남,강원,98,0,2,5,3,7,115,193,1,8,2,7,5,216
2020-03-22,경남,경기,2874,20,107,123,65,131,3320,2419,30,135,124,71,105,2884
2020-03-22,경남,경남,161892,1998,2230,888,1636,9771,178415,161892,1998,2230,888,1636,9771,178415
2020-03-22,경남,경북,10719,121,229,138,224,547,11978,13003,184,292,232,241,651,14603
2020-03-22,경남,광주,1319,18,52,22,11,46,1468,1520,9,57,20,15,53,1674
2020-03-22,경남,대구,13547,133,187,262,327,567,15023,9484,93,132,94,57,395,10255
2020-03-22,경남,대전,1172,8,61,33,10,44,1328,1254,6,61,13,5,58,1397
2020-03-22,경남,부산,75016,551,964,239,478,4279,81527,69426,561,986,228,543,4208,75952
2020-03-22,경남,서울,2430,14,261,124,55,73,2957,2501,15,297,38,15,92,2958
2020-03-22,경남,세종,312,0,5,2,0,7,326,249,0,5,0,1,14,269
2020-03-22,경남,울산,9919,115,162,43,70,608,10917,9419,102,170,43,77,577,10388
2020-03-22,경남,전남,7215,74,121,93,173,293,7969,8429,82,130,90,181,323,9235
2020-03-22,경남,전북,1522,12,39,24,31,53,1681,1641,9,51,25,25,50,1801
2020-03-22,경남,충남,1566,17,22,41,27,65,1738,1533,15,34,66,60,66,1774
2020-03-22,경남,충북,1603,14,45,56,49,68,1835,1530,13,51,99,59,78,1830
2020-03-22,경북,강원,346,8,8,9,5,18,394,507,13,7,5,3,21,556
2020-03-22,경북,경기,4284,41,91,207,79,157,4859,3413,33,99,151,55,123,3874
2020-03-22,경북,경남,13003,184,292,232,241,651,14603,10719,121,229,138,224,547,11978
2020-03-22,경북,경북,73949,928,800,534,565,3316,80092,73949,928,800,534,565,3316,80092
2020-03-22,경북,광주,572,16,37,49,13,23,710,899,18,28,31,12,32,1020
2020-03-22,경북,대구,61467,564,451,300,487,2569,65838,60520,590,551,275,516,2534,64986
2020-03-22,경북,대전,1779,7,27,23,19,115,1970,1965,9,28,16,3,113,2134
2020-03-22,경북,부산,5692,21,77,26,99,240,6155,6296,25,91,32,88,254,6786
2020-03-22,경북,서울,3018,17,133,149,34,101,3452,2574,16,124,60,16,105,2895
2020-03-22,경북,세종,291,0,2,5,1,15,314,275,0,5,5,1,20,306
2020-03-22,경북,울산,6002,40,52,67,189,289,6639,5364,32,48,43,189,277,5953
2020-03-22,경북,전남,1355,16,37,16,88,35,1547,1384,8,23,24,55,34,1528
2020-03-22,경북,전북,1658,28,58,27,52,43,1866,1918,28,38,25,81,59,2149
2020-03-22,경북,충남,3370,23,41,61,95,129,3719,3016,21,53,70,97,130,3387
2020-03-22,경북,충북,5336,64,108,152,137,251,6048,4956,63,106,116,109,230,5580
2020-03-22,광주,강원,82,1,7,7,1,3,101,86,0,8,4,0,4,102
2020-03-22,광주,경기,999,2,28,34,22,30,1115,643,2,42,34,15,19,755
2020-03-22,광주,경남,1520,9,57,20,15,53,1674,1319,18,52,22,11,46,1468
2020-03-22,광주,경북,899,18,28,31,12,32,1020,572,16,37,49,13,23,710
2020-03-22,광주,광주,13576,143,378,92,62,470,14721,13576,143,378,92,62,470,14721
2020-03-22,광주,대구,496,6,11,41,7,20,581,389,6,30,20,7,8,460
2020-03-22,광주,대전,529,3,2,4,6,22,566,505,3,2,0,3,20,533
2020-03-22,광주,부산,448,5,20,8,3,16,500,453,2,30,4,11,17,517
2020-03-22,광주,서울,999,7,11,12,8,17,1054,670,6,8,8,3,20,715
2020-03-22,광주,세종,239,0,2,0,1,4,246,161,0,4,0,1,6,172
2020-03-22,광주,울산,63,0,5,0,0,3,71,43,0,6,1,0,0,50
2020-03-22,광주,전남,38658,240,599,171,277,1248,41193,40280,259,518,246,282,1305,42890
2020-03-22,광주,전북,8432,88,148,46,43,249,9006,8802,83,143,56,40,290,9414
2020-03-22,광주,충남,6052,45,278,118,101,199,6793,4127,37,285,114,50,122,4735
2020-03-22,광주,충북,663,9,21,23,10,25,751,543,3,21,29,14,14,624
2020-03-22,대구,강원,181,4,3,7,0,9,204,191,1,2,3,0,7,204
2020-03-22,대구,경기,2017,11,43,71,51,87,2280,1313,12,32,76,31,32,1496
2020-03-22,대구,경남,9484,93,132,94,57,395,10255,13547,133,187,262,327,567,15023
2020-03-22,대구,경북,60520,590,551,275,516,2534,64986,61467,564,451,300,487,2569,65838
2020-03-22,대구,광주,389,6,30,20,7,8,460,496,6,11,41,7,20,581
2020-03-22,대구,대구,31899,361,302,144,204,1752,34662,31899,361,302,144,204,1752,34662
2020-03-22,대구,대전,688,3,4,14,6,25,740,512,0,6,8,1,25,552
2020-03-22,대구,부산,523,3,17,15,41,32,631,3824,14,38,26,39,161,4102
2020-03-22,대구,서울,1608,6,44,65,25,46,1794,1379,8,38,26,0,43,1494
2020-03-22,대구,세종,245,1,1,1,0,10,258,142,0,2,1,1,5,151
2020-03-22,대구,울산,995,5,12,9,43,57,1121,1053,7,16,4,38,48,1166
2020-03-22,대구,전남,774,9,14,3,13,16,829,1010,7,4,12,14,23,1070
2020-03-22,대구,전북,314,0,5,2,2,9,332,405,1,6,5,1,12,430
2020-03-22,대구,충남,1202,10,12,30,20,51,1325,725,7,16,23,16,30,817
2020-03-22,대구,충북,1365,15,35,51,46,49,1561,1006,9,33,40,23,47,1158
2020-03-22,대전,강원,168,0,10,2,0,17,197,230,3,9,0,1,14,257
2020-03-22,대전,경기,2940,24,78,13,4,158,3217,2002,5,80,11,6,113,2217
2020-03-22,대전,경남,1254,6,61,13,5,58,1397,1172,8,61,33,10,44,1328
2020-03-22,대전,경북,1965,9,28,16,3,113,2134,1779,7,27,23,19,115,1970
2020-03-22,대전,광주,505,3,2,0,3,20,533,529,3,2,4,6,22,566
2020-03-22,대전,대구,512,0,6,8,1,25,552,688,3,4,14,6,25,740
2020-03-22,대전,대전,10362,98,109,37,33,694,11333,10362,98,109,37,33,694,11333
2020-03-22,대전,부산,105,0,1,0,0,4,110,120,1,1,2,3,6,133
2020-03-22,대전,서울,2247,9,112,8,3,112,2491,1760,10,108,6,1,99,1984
2020-03-22,대전,세종,2237,33,16,8,6,169,2469,1885,25,18,9,13,130,2080
2020-03-22,대전,울산,135,0,1,3,9,6,154,93,0,1,1,5,5,105
2020-03-22,대전,전남,540,0,9,4,3,19,575,222,0,5,1,1,13,242
2020-03-22,대전,전북,3554,26,34,4,7,162,3787,4663,20,42,20,17,190,4952
2020-03-22,대전,충남,13080,85,165,59,38,717,14144,12615,82,167,56,44,681,13645
2020-03-22,대전,충북,9058,106,177,29,42,545,9957,8081,83,167,26,32,512,8901
2020-03-22,부산,강원,2,0,0,0,0,0,2,6,0,0,0,0,0,6
2020-03-22,부산,경기,472,1,7,13,28,26,547,222,1,8,29,34,8,302
2020-03-22,부산,경남,69426,561,986,228,543,4208,75952,75016,551,964,239,478,4279,81527
2020-03-22,부산,경북,6296,25,91,32,88,254,6786,5692,21,77,26,99,240,6155
2020-03-22,부산,광주,453,2,30,4,11,17,517,448,5,20,8,3,16,500
2020-03-22,부산,대구,3824,14,38,26,39,161,4102,523,3,17,15,41,32,631
2020-03-22,부산,대전,120,1,1,2,3,6,133,105,0,1,0,0,4,110
2020-03-22,부산,부산,47654,131,87,77,255,2630,50834,47654,131,87,77,255,2630,50834
2020-03-22,부산,서울,290,3,6,20,12,12,343,239,3,4,10,9,8,273
2020-03-22,부산,세종,50,0,0,1,2,0,53,23,0,0,0,0,1,24
2020-03-22,부산,울산,16809,53,85,71,280,1039,18337,15984,69,54,58,311,973,17449
2020-03-22,부산,전남,2378,13,64,39,102,97,2693,2247,18,40,59,102,67,2533
2020-03-22,부산,전북,334,1,21,6,12,16,390,335,0,20,13,13,6,387
2020-03-22,부산,충남,251,2,4,6,13,11,287,140,2,3,10,19,3,177
2020-03-22,부산,충북,184,0,5,5,18,7,219,112,3,3,16,10,7,151
2020-03-22,서울,강원,985,2,125,1,1,40,1154,2069,3,157,18,4,82,2333
2020-03-22,서울,경기,114996,1654,3160,1101,484,6367,127762,104644,1476,3146,1167,466,5762,116661
2020-03-22,서울,경남,2501,15,297,38,15,92,2958,2430,14,261,124,55,73,2957
2020-03-22,서울,경북,2574,16,124,60,16,105,2895,3018,17,133,149,34,101,3452
2020-03-22,서울,광주,670,6,8,8,3,20,715,999,7,11,12,8,17,1054
2020-03-22,서울,대구,1379,8,38,26,0,43,1494,1608,6,44,65,25,46,1794
2020-03-22,서울,대전,1760,10,108,6,1,99,1984,2247,9,112,8,3,112,2491
2020-03-22,서울,부산,239,3,4,10,9,8,273,290,3,6,20,12,12,343
2020-03-22,서울,서울,182,2,4,0,2,8,198,182,2,4,0,2,8,198
2020-03-22,서울,세종,25,0,1,0,0,2,28,21,1,0,0,0,0,22
2020-03-22,서울,울산,26,0,4,0,1,1,32,22,0,3,1,3,0,29
2020-03-22,서울,전남,846,7,17,5,4,24,903,1540,7,16,42,17,31,1653
2020-03-22,서울,전북,1284,6,20,3,7,40,1360,2490,6,34,24,13,97,2664
2020-03-22,서울,충남,32655,142,1365,232,153,1338,35885,39723,177,1307,531,263,1493,43494
2020-03-22,서울,충북,14838,97,512,214,113,606,16380,16050,116,493,225,110,671,17665
2020-03-22,세종,강원,6,0,0,0,0,1,7,3,0,0,1,0,0,4
2020-03-22,세종,경기,51,0,0,0,2,1,54,33,0,0,0,2,3,38
2020-03-22,세종,경남,249,0,5,0,1,14,269,312,0,5,2,0,7,326
2020-03-22,세종,경북,275,0,5,5,1,20,306,291,0,2,5,1,15,314
2020-03-22,세종,광주,161,0,4,0,1,6,172,239,0,2,0,1,4,246
2020-03-22,세종,대구,142,0,2,1,1,5,151,245,1,1,1,0,10,258
2020-03-22,세종,대전,1885,25,18,9,13,130,2080,2237,33,16,8,6,169,2469
2020-03-22,세종,부산,23,0,0,0,0,1,24,50,0,0,1,2,0,53
2020-03-22,세종,서울,21,1,0,0,0,0,22,25,0,1,0,0,2,28
2020-03-22,세종,세종,268,2,0,0,0,13,283,268,2,0,0,0,13,283
2020-03-22,세종,울산,10,0,0,0,2,0,12,14,0,0,0,2,0,16
2020-03-22,세종,전남,195,2,3,0,2,2,204,228,0,1,0,1,3,233
2020-03-22,세종,전북,842,3,6,2,8,30,891,1328,1,5,6,14,48,1402
2020-03-22,세종,충남,5941,49,70,23,36,240,6359,5886,49,60,49,37,215,6296
2020-03-22,세종,충북,370,5,0,4,6,21,406,362,6,3,1,4,18,394
2020-03-22,울산,강원,2,0,0,0,0,0,2,1,0,0,0,0,0,1
2020-03-22,울산,경기,30,0,0,3,9,3,45,32,0,0,0,1,0,33
2020-03-22,울산,경남,9419,102,170,43,77,577,10388,9919,115,162,43,70,608,10917
2020-03-22,울산,경북,5364,32,48,43,189,277,5953,6002,40,52,67,189,289,6639
2020-03-22,울산,광주,43,0,6,1,0,0,50,63,0,5,0,0,3,71
2020-03-22,울산,대구,1053,7,16,4,38,48,1166,995,5,12,9,43,57,1121
2020-03-22,울산,대전,93,0,1,1,5,5,105,135,0,1,3,9,6,154
2020-03-22,울산,부산,15984,69,54,58,311,973,17449,16809,53,85,71,280,1039,18337
2020-03-22,울산,서울,22,0,3,1,3,0,29,26,0,4,0,1,1,32
2020-03-22,울산,세종,14,0,0,0,2,0,16,10,0,0,0,2,0,12
2020-03-22,울산,울산,5221,47,70,23,64,357,5782,5221,47,70,23,64,357,5782
2020-03-22,울산,전남,286,0,1,1,4,14,306,307,2,2,3,1,15,330
2020-03-22,울산,전북,43,0,4,0,6,2,55,71,0,4,0,2,2,79
2020-03-22,울산,충남,140,1,7,6,30,7,191,125,2,3,6,30,5,171
2020-03-22,울산,충북,11,1,1,4,6,1,24,24,0,0,2,8,3,37
2020-03-22,전남,강원,22,0,1,2,1,4,30,50,1,1,0,4,2,58
2020-03-22,전남,경기,1269,6,40,47,19,43,1424,759,5,40,25,33,29,891
2020-03-22,전남,경남,8429,82,130,90,181,323,9235,7215,74,121,93,173,293,7969
2020-03-22,전남,경북,1384,8,23,24,55,34,1528,1355,16,37,16,88,35,1547
2020-03-22,전남,광주,40280,259,518,246,282,1305,42890,38658,240,599,171,277,1248,41193
2020-03-22,전남,대구,1010,7,4,12,14,23,1070,774,9,14,3,13,16,829
2020-03-22,전남,대전,222,0,5,1,1,13,242,540,0,9,4,3,19,575
2020-03-22,전남,부산,2247,18,40,59,102,67,2533,2378,13,64,39,102,97,2693
2020-03-22,전남,서울,1540,7,16,42,17,31,1653,846,7,17,5,4,24,903
2020-03-22,전남,세종,228,0,1,0,1,3,233,195,2,3,0,2,2,204
2020-03-22,전남,울산,307,2,2,3,1,15,330,286,0,1,1,4,14,306
2020-03-22,전남,전남,53328,452,708,497,985,1642,57612,53328,452,708,497,985,1642,57612
2020-03-22,전남,전북,13067,116,269,323,657,396,14828,7130,79,154,110,216,237,7926
2020-03-22,전남,충남,3690,22,130,324,109,106,4381,5089,39,276,102,193,154,5853
2020-03-22,전남,충북,263,1,6,27,16,12,325,498,4,23,24,39,16,604
2020-03-22,전북,강원,201,2,4,6,5,9,227,165,0,1,0,1,5,172
2020-03-22,전북,경기,2730,13,52,36,50,98,2979,1338,15,54,20,24,54,1505
2020-03-22,전북,경남,1641,9,51,25,25,50,1801,1522,12,39,24,31,53,1681
2020-03-22,전북,경북,1918,28,38,25,81,59,2149,1658,28,58,27,52,43,1866
2020-03-22,전북,광주,8802,83,143,56,40,290,9414,8432,88,148,46,43,249,9006
2020-03-22,전북,대구,405,1,6,5,1,12,430,314,0,5,2,2,9,332
2020-03-22,전북,대전,4663,20,42,20,17,190,4952,3554,26,34,4,7,162,3787
2020-03-22,전북,부산,335,0,20,13,13,6,387,334,1,21,6,12,16,390
2020-03-22,전북,서울,2490,6,34,24,13,97,2664,1284,6,20,3,7,40,1360
2020-03-22,전북,세종,1328,1,5,6,14,48,1402,842,3,6,2,8,30,891
2020-03-22,전북,울산,71,0,4,0,2,2,79,43,0,4,0,6,2,55
2020-03-22,전북,전남,7130,79,154,110,216,237,7926,13067,116,269,323,657,396,14828
2020-03-22,전북,전북,17391,196,333,123,210,577,18830,17391,196,333,123,210,577,18830
2020-03-22,전북,충남,27851,189,771,410,596,998,30815,15239,125,688,161,241,594,17048
2020-03-22,전북,충북,3006,41,42,111,71,107,3378,1916,39,42,63,51,78,2189
2020-03-22,충남,강원,398,4,7,7,4,16,436,507,5,5,15,4,19,555
2020-03-22,충남,경기,44738,327,803,414,635,1974,48891,38631,294,878,455,658,1828,42744
2020-03-22,충남,경남,1533,15,34,66,60,66,1774,1566,17,22,41,27,65,1738
2020-03-22,충남,경북,3016,21,53,70,97,130,3387,3370,23,41,61,95,129,3719
2020-03-22,충남,광주,4127,37,285,114,50,122,4735,6052,45,278,118,101,199,6793
2020-03-22,충남,대구,725,7,16,23,16,30,817,1202,10,12,30,20,51,1325
2020-03-22,충남,대전,12615,82,167,56,44,681,13645,13080,85,165,59,38,717,14144
2020-03-22,충남,부산,140,2,3,10,19,3,177,251,2,4,6,13,11,287
2020-03-22,충남,서울,39723,177,1307,531,263,1493,43494,32655,142,1365,232,153,1338,35885
2020-03-22,충남,세종,5886,49,60,49,37,215,6296,5941,49,70,23,36,240,6359
2020-03-22,충남,울산,125,2,3,6,30,5,171,140,1,7,6,30,7,191
2020-03-22,충남,전남,5089,39,276,102,193,154,5853,3690,22,130,324,109,106,4381
2020-03-22,충남,전북,15239,125,688,161,241,594,17048,27851,189,771,410,596,998,30815
2020-03-22,충남,충남,107246,934,3014,1507,1818,4406,118925,107246,934,3014,1507,1818,4406,118925
2020-03-22,충남,충북,10471,164,217,230,215,524,11821,9953,142,227,183,247,520,11272
2020-03-22,충북,강원,4610,56,77,26,50,241,5060,5375,71,72,67,53,250,5888
2020-03-22,충북,경기,31142,474,582,460,455,1503,34616,25152,450,606,481,509,1285,28483
2020-03-22,충북,경남,1530,13,51,99,59,78,1830,1603,14,45,56,49,68,1835
2020-03-22,충북,경북,4956,63,106,116,109,230,5580,5336,64,108,152,137,251,6048
2020-03-22,충북,광주,543,3,21,29,14,14,624,663,9,21,23,10,25,751
2020-03-22,충북,대구,1006,9,33,40,23,47,1158,1365,15,35,51,46,49,1561
2020-03-22,충북,대전,8081,83,167,26,32,512,8901,9058,106,177,29,42,545,9957
2020-03-22,충북,부산,112,3,3,16,10,7,151,184,0,5,5,18,7,219
2020-03-22,충북,서울,16050,116,493,225,110,671,17665,14838,97,512,214,113,606,16380
2020-03-22,충북,세종,362,6,3,1,4,18,394,370,5,0,4,6,21,406
2020-03-22,충북,울산,24,0,0,2,8,3,37,11,1,1,4,6,1,24
2020-03-22,충북,전남,498,4,23,24,39,16,604,263,1,6,27,16,12,325
2020-03-22,충북,전북,1916,39,42,63,51,78,2189,3006,41,42,111,71,107,3378
2020-03-22,충북,충남,9953,142,227,183,247,520,11272,10471,164,217,230,215,524,11821
2020-03-22,충북,충북,29760,457,462,367,504,1490,33040,29760,457,462,367,504,1490,33040
2020-03-23,강원,강원,61609,2339,2256,1482,2704,4163,74553,61609,2339,2256,1482,2704,4163,74553
2020-03-23,강원,경기,21248,563,812,653,728,1001,25005,20498,597,845,700,868,1027,24535
2020-03-23,강원,경남,127,2,10,14,24,3,180,79,5,3,15,11,3,116
2020-03-23,강원,경북,315,20,27,24,24,21,431,272,14,22,27,37,15,387
2020-03-23,강원,광주,46,1,12,8,9,3,79,80,0,7,6,4,1,98
2020-03-23,강원,대구,108,3,8,10,7,3,139,188,3,10,22,14,9,246
2020-03-23,강원,대전,123,3,10,4,1,6,147,167,3,11,3,3,8,195
2020-03-23,강원,부산,2,1,1,0,2,0,6,6,0,0,1,2,1,10
2020-03-23,강원,서울,709,7,128,12,25,29,910,929,14,142,15,16,32,1148
2020-03-23,강원,세종,5,0,0,0,2,0,7,6,1,0,1,1,0,9
2020-03-23,강원,울산,1,0,0,0,2,0,3,0,0,0,0,0,0,0
2020-03-23,강원,전남,43,0,1,4,18,1,67,17,1,0,6,6,0,30
2020-03-23,강원,전북,97,5,8,7,11,2,130,136,3,9,15,23,6,192
2020-03-23,강원,충남,275,8,15,18,41,15,372,353,9,15,26,55,8,466
2020-03-23,강원,충북,4400,215,254,302,417,268,5856,4397,207,224,189,433,233,5683
2020-03-23,경기,강원,20498,597,845,700,868,1027,24535,21248,563,812,653,728,1001,25005
2020-03-23,경기,경기,427791,23279,23710,19380,23928,31283,549371,427791,23279,23710,19380,23928,31283,549371
2020-03-23,경기,경남,2399,76,255,426,362,84,3602,1823,52,180,400,330,86,2871
2020-03-23,경기,경북,3452,173,397,579,504,114,5219,3059,171,385,800,500,133,5048
2020-03-23,경기,광주,661,41,105,252,132,14,1205,720,23,101,231,120,28,1223
2020-03-23,경기,대구,1301,59,132,253,140,45,1930,1940,80,156,329,362,68,2935
2020-03-23,경기,대전,1808,97,151,82,50,107,2295,2259,124,150,90,80,128,2831
2020-03-23,경기,부산,174,17,21,66,111,8,397,209,16,22,81,180,17,525
2020-03-23,경기,서울,142294,6920,8109,4610,3593,9527,175053,150877,6717,8478,4872,3277,9972,184193
2020-03-23,경기,세종,36,4,1,2,0,1,44,53,1,5,5,2,2,68
2020-03-23,경기,울산,31,0,1,4,9,1,46,32,0,5,11,39,3,90
2020-03-23,경기,전남,729,21,67,136,117,17,1087,633,13,54,82,72,16,870
2020-03-23,경기,전북,1196,48,138,104,197,47,1730,1395,41,125,202,250,53,2066
2020-03-23,경기,충남,39372,1605,2657,2475,4637,2062,52808,36665,1464,2527,2312,4513,1995,49476
2020-03-23,경기,충북,28392,2149,2753,3053,3557,1415,41319,26405,2032,2607,2660,3907,1352,38963
2020-03-23,경남,강원,79,5,3,15,11,3,116,127,2,10,14,24,3,180
2020-03-23,경남,경기,1823,52,180,400,330,86,2871,2399,76,255,426,362,84,3602
2020-03-23,경남,경남,186910,9867,9408,7061,13829,14075,241150,186910,9867,9408,7061,13829,14075,241150
2020-03-23,경남,경북,8700,585,881,908,2055,384,13513,10041,846,1042,1082,2634,434,16079
2020-03-23,경남,광주,949,54,112,157,143,34,1449,1097,52,127,140,104,36,1556
2020-03-23,경남,대구,10194,727,734,909,1718,421,14703,8150,464,544,400,573,347,10478
2020-03-23,경남,대전,564,17,76,67,27,32,783,912,16,74,64,40,27,1133
2020-03-23,경남,부산,81903,2576,2384,1830,4578,5913,99184,84098,2690,2699,1959,4871,5959,102276
2020-03-23,경남,서울,1673,39,285,232,120,57,2406,2469,40,278,106,47,93,3033
2020-03-23,경남,세종,152,4,7,6,17,3,189,233,1,12,8,15,10,279
2020-03-23,경남,울산,9465,673,647,493,640,601,12519,8756,569,694,423,633,555,11630
2020-03-23,경남,전남,6181,281,395,485,1425,262,9029,5605,268,367,362,1396,227,8225
2020-03-23,경남,전북,1038,35,91,104,222,37,1527,988,39,112,99,166,40,1444
2020-03-23,경남,충남,1093,44,123,222,232,36,1750,1366,59,154,234,372,53,2238
2020-03-23,경남,충북,1080,43,126,250,304,33,1836,1186,70,166,348,528,39,2337
2020-03-23,경북,강원,272,14,22,27,37,15,387,315,20,27,24,24,21,431
2020-03-23,경북,경기,3059,171,385,800,500,133,5048,3452,173,397,579,504,114,5219
2020-03-23,경북,경남,10041,846,1042,1082,2634,434,16079,8700,585,881,908,2055,384,13513
2020-03-23,경북,경북,65960,3842,3620,2848,5479,3593,85342,65960,3842,3620,2848,5479,3593,85342
2020-03-23,경북,광주,599,56,107,182,102,20,1066,700,42,97,139,82,19,1079
2020-03-23,경북,대구,62263,2831,2158,1478,3319,3256,75305,67911,3033,2558,1912,3878,3488,82780
2020-03-23,경북,대전,1363,48,73,93,79,67,1723,1596,47,73,78,76,63,1933
2020-03-23,경북,부산,3476,102,196,170,604,168,4716,4331,108,196,182,716,193,5726
2020-03-23,경북,서울,2045,81,202,363,148,66,2905,2630,63,209,180,65,94,3241
2020-03-23,경북,세종,213,9,21,27,18,8,296,269,12,14,23,7,12,337
2020-03-23,경북,울산,4595,160,305,382,999,252,6693,4355,167,285,320,1220,278,6625
2020-03-23,경북,전남,824,43,71,95,455,31,1519,741,34,70,69,290,27,1231
2020-03-23,경북,전북,1626,96,166,197,248,66,2399,1532,104,145,166,463,65,2475
2020-03-23,경북,충남,2774,129,315,528,599,117,4462,2730,114,323,414,749,138,4468
2020-03-23,경북,충북,4188,223,437,702,998,173,6721,4238,215,471,604,1044,168,6740
2020-03-23,광주,강원,80,0,7,6,4,1,98,46,1,12,8,9,3,79
2020-03-23,광주,경기,720,23,101,231,120,28,1223,661,41,105,252,132,14,1205
2020-03-23,광주,경남,1097,52,127,140,104,36,1556,949,54,112,157,143,34,1449
2020-03-23,광주,경북,700,42,97,139,82,19,1079,599,56,107,182,102,20,1066
2020-03-23,광주,광주,13373,483,551,335,568,531,15841,13373,483,551,335,568,531,15841
2020-03-23,광주,대구,404,23,58,82,23,10,600,440,26,59,52,18,12,607
2020-03-23,광주,대전,431,14,13,18,12,18,506,485,15,12,18,14,10,554
2020-03-23,광주,부산,348,10,37,41,61,9,506,334,18,40,59,91,6,548
2020-03-23,광주,서울,579,15,28,67,13,25,727,681,24,18,17,15,16,771
2020-03-23,광주,세종,151,2,9,8,3,3,176,156,3,5,4,1,5,174
2020-03-23,광주,울산,59,1,7,5,5,0,77,38,0,8,7,6,2,61
2020-03-23,광주,전남,34464,973,1067,743,2065,1310,40622,31115,929,930,636,1991,1270,36871
2020-03-23,광주,전북,7520,413,465,339,400,268,9405,7181,431,442,315,398,265,9032
2020-03-23,광주,충남,4159,101,375,427,303,79,5444,3868,112,401,448,293,121,5243
2020-03-23,광주,충북,621,33,65,116,65,17,917,522,32,67,146,69,11,847
2020-03-23,대구,강원,188,3,10,22,14,9,246,108,3,8,10,7,3,139
2020-03-23,대구,경기,1940,80,156,329,362,68,2935,1301,59,132,253,140,45,1930
2020-03-23,대구,경남,8150,464,544,400,573,347,10478,10194,727,734,909,1718,421,14703
2020-03-23,대구,경북,67911,3033,2558,1912,3878,3488,82780,62263,2831,2158,1478,3319,3256,75305
2020-03-23,대구,광주,440,26,59,52,18,12,607,404,23,58,82,23,10,600
2020-03-23,대구,대구,54449,2164,1567,869,1143,3584,63776,54449,2164,1567,869,1143,3584,63776
2020-03-23,대구,대전,693,33,24,56,29,19,854,456,17,19,32,21,18,563
2020-03-23,대구,부산,498,58,100,61,154,28,899,2541,100,144,88,208,107,3188
2020-03-23,대구,서울,1819,57,76,155,99,58,2264,1314,34,49,78,25,34,1534
2020-03-23,대구,세종,196,2,6,6,6,10,226,117,2,2,3,2,2,128
2020-03-23,대구,울산,981,57,68,72,153,42,1373,922,48,67,59,154,46,1296
2020-03-23,대구,전남,432,12,39,32,40,11,566,362,21,41,29,38,14,505
2020-03-23,대구,전북,253,10,23,16,20,8,330,226,10,20,16,13,9,294
2020-03-23,대구,충남,1169,60,130,175,259,38,1831,709,43,95,122,136,18,1123
2020-03-23,대구,충북,1342,88,137,264,376,44,2251,784,83,111,140,123,27,1268
2020-03-23,대전,강원,167,3,11,3,3,8,195,123,3,10,4,1,6,147
2020-03-23,대전,경기,2259,124,150,90,80,128,2831,1808,97,151,82,50,107,2295
2020-03-23,대전,경남,912,16,74,64,40,27,1133,564,17,76,67,27,32,783
2020-03-23,대전,경북,1596,47,73,78,76,63,1933,1363,48,73,93,79,67,1723
2020-03-23,대전,광주,485,15,12,18,14,10,554,431,14,13,18,12,18,506
2020-03-23,대전,대구,456,17,19,32,21,18,563,693,33,24,56,29,19,854
2020-03-23,대전,대전,13562,439,414,275,230,1015,15935,13562,439,414,275,230,1015,15935
2020-03-23,대전,부산,83,2,5,12,15,3,120,67,3,5,7,14,2,98
2020-03-23,대전,서울,1813,40,110,26,15,90,2094,1747,33,110,23,8,79,2000
2020-03-23,대전,세종,3259,103,75,33,52,258,3780,3295,98,76,44,73,255,3841
2020-03-23,대전,울산,110,4,1,8,26,3,152,67,2,2,7,21,1,100
2020-03-23,대전,전남,362,9,4,13,21,18,427,111,5,7,8,7,5,143
2020-03-23,대전,전북,3112,82,77,53,42,122,3488,3026,100,70,66,68,129,3459
2020-03-23,대전,충남,16475,481,488,251,267,1197,19159,13764,442,421,255,271,1091,16244
2020-03-23,대전,충북,11209,458,401,213,229,834,13344,9529,406,347,174,155,723,11334
2020-03-23,부산,강원,6,0,0,1,2,1,10,2,1,1,0,2,0,6
2020-03-23,부산,경기,209,16,22,81,180,17,525,174,17,21,66,111,8,397
2020-03-23,부산,경남,84098,2690,2699,1959,4871,5959,102276,81903,2576,2384,1830,4578,5913,99184
2020-03-23,부산,경북,4331,108,196,182,716,193,5726,3476,102,196,170,604,168,4716
2020-03-23,부산,광주,334,18,40,59,91,6,548,348,10,37,41,61,9,506
2020-03-23,부산,대구,2541,100,144,88,208,107,3188,498,58,100,61,154,28,899
2020-03-23,부산,대전,67,3,5,7,14,2,98,83,2,5,12,15,3,120
2020-03-23,부산,부산,40757,675,640,622,2008,3092,47794,40757,675,640,622,2008,3092,47794
2020-03-23,부산,서울,183,9,10,60,37,4,303,203,10,8,26,19,13,279
2020-03-23,부산,세종,14,0,2,3,3,0,22,18,1,0,0,2,1,22
2020-03-23,부산,울산,16097,376,446,634,2540,1138,21231,14487,408,390,417,2418,1074,19194
2020-03-23,부산,전남,1944,90,125,189,557,81,2986,1604,68,106,128,539,67,2512
2020-03-23,부산,전북,254,7,23,25,78,8,395,243,10,21,27,58,5,364
2020-03-23,부산,충남,173,11,17,67,124,3,395,137,8,23,42,154,6,370
2020-03-23,부산,충북,114,10,19,76,159,3,381,81,3,22,78,167,2,353
2020-03-23,서울,강원,929,14,142,15,16,32,1148,709,7,128,12,25,29,910
2020-03-23,서울,경기,150877,6717,8478,4872,3277,9972,184193,142294,6920,8109,4610,3593,9527,175053
2020-03-23,서울,경남,2469,40,278,106,47,93,3033,1673,39,285,232,120,57,2406
2020-03-23,서울,경북,2630,63,209,180,65,94,3241,2045,81,202,363,148,66,2905
2020-03-23,서울,광주,681,24,18,17,15,16,771,579,15,28,67,13,25,727
2020-03-23,서울,대구,1314,34,49,78,25,34,1534,1819,57,76,155,99,58,2264
2020-03-23,서울,대전,1747,33,110,23,8,79,2000,1813,40,110,26,15,90,2094
2020-03-23,서울,부산,203,10,8,26,19,13,279,183,9,10,60,37,4,303
2020-03-23,서울,서울,169,6,14,2,2,9,202,169,6,14,2,2,9,202
2020-03-23,서울,세종,33,1,0,0,0,0,34,31,0,0,2,1,2,36
2020-03-23,서울,울산,30,0,1,0,1,0,32,25,1,3,2,8,2,41
2020-03-23,서울,전남,830,10,21,26,16,29,932,736,10,13,62,26,17,864
2020-03-23,서울,전북,1225,17,44,30,26,34,1376,1177,29,33,39,48,41,1367
2020-03-23,서울,충남,28258,494,1793,731,754,1190,33220,25220,588,1696,1224,1167,1007,30902
2020-03-23,서울,충북,15429,516,878,683,647,670,18823,12744,629,882,737,819,572,16383
2020-03-23,세종,강원,6,1,0,1,1,0,9,5,0,0,0,2,0,7
2020-03-23,세종,경기,53,1,5,5,2,2,68,36,4,1,2,0,1,44
2020-03-23,세종,경남,233,1,12,8,15,10,279,152,4,7,6,17,3,189
2020-03-23,세종,경북,269,12,14,23,7,12,337,213,9,21,27,18,8,296
2020-03-23,세종,광주,156,3,5,4,1,5,174,151,2,9,8,3,3,176
2020-03-23,세종,대구,117,2,2,3,2,2,128,196,2,6,6,6,10,226
2020-03-23,세종,대전,3295,98,76,44,73,255,3841,3259,103,75,33,52,258,3780
2020-03-23,세종,부산,18,1,0,0,2,1,22,14,0,2,3,3,0,22
2020-03-23,세종,서울,31,0,0,2,1,2,36,33,1,0,0,0,0,34
2020-03-23,세종,세종,239,23,5,2,0,10,279,239,23,5,2,0,10,279
2020-03-23,세종,울산,10,0,0,2,5,3,20,11,0,0,0,5,0,16
2020-03-23,세종,전남,174,3,2,11,14,8,212,93,0,2,6,3,4,108
2020-03-23,세종,전북,694,23,23,15,30,25,810,657,15,15,17,44,17,765
2020-03-23,세종,충남,6135,148,164,103,215,316,7081,4292,138,141,110,176,218,5075
2020-03-23,세종,충북,368,15,15,20,19,34,471,295,11,11,12,22,25,376
2020-03-23,울산,강원,0,0,0,0,0,0,0,1,0,0,0,2,0,3
2020-03-23,울산,경기,32,0,5,11,39,3,90,31,0,1,4,9,1,46
2020-03-23,울산,경남,8756,569,694,423,633,555,11630,9465,673,647,493,640,601,12519
2020-03-23,울산,경북,4355,167,285,320,1220,278,6625,4595,160,305,382,999,252,6693
2020-03-23,울산,광주,38,0,8,7,6,2,61,59,1,7,5,5,0,77
2020-03-23,울산,대구,922,48,67,59,154,46,1296,981,57,68,72,153,42,1373
2020-03-23,울산,대전,67,2,2,7,21,1,100,110,4,1,8,26,3,152
2020-03-23,울산,부산,14487,408,390,417,2418,1074,19194,16097,376,446,634,2540,1138,21231
2020-03-23,울산,서울,25,1,3,2,8,2,41,30,0,1,0,1,0,32
2020-03-23,울산,세종,11,0,0,0,5,0,16,10,0,0,2,5,3,20
2020-03-23,울산,울산,7661,297,567,293,583,677,10078,7661,297,567,293,583,677,10078
2020-03-23,울산,전남,203,12,17,14,24,3,273,196,12,21,9,37,9,284
2020-03-23,울산,전북,37,1,7,3,12,1,61,42,0,3,3,1,2,51
2020-03-23,울산,충남,139,4,13,35,117,5,313,145,2,3,29,72,2,253
2020-03-23,울산,충북,23,0,4,17,39,1,84,18,0,4,12,33,1,68
2020-03-23,전남,강원,17,1,0,6,6,0,30,43,0,1,4,18,1,67
2020-03-23,전남,경기,633,13,54,82,72,16,870,729,21,67,136,117,17,1087
2020-03-23,전남,경남,5605,268,367,362,1396,227,8225,6181,281,395,485,1425,262,9029
2020-03-23,전남,경북,741,34,70,69,290,27,1231,824,43,71,95,455,31,1519
2020-03-23,전남,광주,31115,929,930,636,1991,1270,36871,34464,973,1067,743,2065,1310,40622
2020-03-23,전남,대구,362,21,41,29,38,14,505,432,12,39,32,40,11,566
2020-03-23,전남,대전,111,5,7,8,7,5,143,362,9,4,13,21,18,427
2020-03-23,전남,부산,1604,68,106,128,539,67,2512,1944,90,125,189,557,81,2986
2020-03-23,전남,서울,736,10,13,62,26,17,864,830,10,21,26,16,29,932
2020-03-23,전남,세종,93,0,2,6,3,4,108,174,3,2,11,14,8,212
2020-03-23,전남,울산,196,12,21,9,37,9,284,203,12,17,14,24,3,273
2020-03-23,전남,전남,44211,1367,1502,1834,5086,1709,55709,44211,1367,1502,1834,5086,1709,55709
2020-03-23,전남,전북,7072,311,630,907,2726,220,11866,4726,226,425,602,1314,142,7435
2020-03-23,전남,충남,1862,36,173,385,261,62,2779,4353,80,357,455,972,130,6347
2020-03-23,전남,충북,144,13,19,42,53,3,274,367,17,50,93,221,17,765
2020-03-23,전북,강원,136,3,9,15,23,6,192,97,5,8,7,11,2,130
2020-03-23,전북,경기,1395,41,125,202,250,53,2066,1196,48,138,104,197,47,1730
2020-03-23,전북,경남,988,39,112,99,166,40,1444,1038,35,91,104,222,37,1527
2020-03-23,전북,경북,1532,104,145,166,463,65,2475,1626,96,166,197,248,66,2399
2020-03-23,전북,광주,7181,431,442,315,398,265,9032,7520,413,465,339,400,268,9405
2020-03-23,전북,대구,226,10,20,16,13,9,294,253,10,23,16,20,8,330
2020-03-23,전북,대전,3026,100,70,66,68,129,3459,3112,82,77,53,42,122,3488
2020-03-23,전북,부산,243,10,21,27,58,5,364,254,7,23,25,78,8,395
2020-03-23,전북,서울,1177,29,33,39,48,41,1367,1225,17,44,30,26,34,1376
2020-03-23,전북,세종,657,15,15,17,44,17,765,694,23,23,15,30,25,810
2020-03-23,전북,울산,42,0,3,3,1,2,51,37,1,7,3,12,1,61
2020-03-23,전북,전남,4726,226,425,602,1314,142,7435,7072,311,630,907,2726,220,11866
2020-03-23,전북,전북,16540,688,886,854,1370,638,20976,16540,688,886,854,1370,638,20976
2020-03-23,전북,충남,15788,549,1469,1454,2254,558,22072,12985,477,1305,881,1258,469,17375
2020-03-23,전북,충북,1955,129,191,342,464,67,3148,1583,117,244,253,244,63,2504
2020-03-23,충남,강원,353,9,15,26,55,8,466,275,8,15,18,41,15,372
2020-03-23,충남,경기,36665,1464,2527,2312,4513,1995,49476,39372,1605,2657,2475,4637,2062,52808
2020-03-23,충남,경남,1366,59,154,234,372,53,2238,1093,44,123,222,232,36,1750
2020-03-23,충남,경북,2730,114,323,414,749,138,4468,2774,129,315,528,599,117,4462
2020-03-23,충남,광주,3868,112,401,448,293,121,5243,4159,101,375,427,303,79,5444
2020-03-23,충남,대구,709,43,95,122,136,18,1123,1169,60,130,175,259,38,1831
2020-03-23,충남,대전,13764,442,421,255,271,1091,16244,16475,481,488,251,267,1197,19159
2020-03-23,충남,부산,137,8,23,42,154,6,370,173,11,17,67,124,3,395
2020-03-23,충남,서울,25220,588,1696,1224,1167,1007,30902,28258,494,1793,731,754,1190,33220
2020-03-23,충남,세종,4292,138,141,110,176,218,5075,6135,148,164,103,215,316,7081
2020-03-23,충남,울산,145,2,3,29,72,2,253,139,4,13,35,117,5,313
2020-03-23,충남,전남,4353,80,357,455,972,130,6347,1862,36,173,385,261,62,2779
2020-03-23,충남,전북,12985,477,1305,881,1258,469,17375,15788,549,1469,1454,2254,558,22072
2020-03-23,충남,충남,95278,3675,6737,6812,10135,4731,127368,95278,3675,6737,6812,10135,4731,127368
2020-03-23,충남,충북,13374,664,842,1024,1425,767,18096,12357,598,774,836,1468,676,16709
2020-03-23,충북,강원,4397,207,224,189,433,233,5683,4400,215,254,302,417,268,5856
2020-03-23,충북,경기,26405,2032,2607,2660,3907,1352,38963,28392,2149,2753,3053,3557,1415,41319
2020-03-23,충북,경남,1186,70,166,348,528,39,2337,1080,43,126,250,304,33,1836
2020-03-23,충북,경북,4238,215,471,604,1044,168,6740,4188,223,437,702,998,173,6721
2020-03-23,충북,광주,522,32,67,146,69,11,847,621,33,65,116,65,17,917
2020-03-23,충북,대구,784,83,111,140,123,27,1268,1342,88,137,264,376,44,2251
2020-03-23,충북,대전,9529,406,347,174,155,723,11334,11209,458,401,213,229,834,13344
2020-03-23,충북,부산,81,3,22,78,167,2,353,114,10,19,76,159,3,381
2020-03-23,충북,서울,12744,629,882,737,819,572,16383,15429,516,878,683,647,670,18823
2020-03-23,충북,세종,295,11,11,12,22,25,376,368,15,15,20,19,34,471
2020-03-23,충북,울산,18,0,4,12,33,1,68,23,0,4,17,39,1,84
2020-03-23,충북,전남,367,17,50,93,221,17,765,144,13,19,42,53,3,274
2020-03-23,충북,전북,1583,117,244,253,244,63,2504,1955,129,191,342,464,67,3148
2020-03-23,충북,충남,12357,598,774,836,1468,676,16709,13374,664,842,1024,1425,767,18096
2020-03-23,충북,충북,34474,1949,2242,2157,3380,2075,46277,34474,1949,2242,2157,3380,2075,46277
2020-03-24,강원,강원,60709,2549,2416,1741,3289,4104,74808,60709,2549,2416,1741,3289,4104,74808
2020-03-24,강원,경기,18471,613,892,702,835,881,22394,19715,674,858,704,999,922,23872
2020-03-24,강원,경남,114,1,6,6,11,4,142,77,2,10,15,19,1,124
2020-03-24,강원,경북,303,25,19,29,35,12,423,271,23,22,43,29,10,398
2020-03-24,강원,광주,63,1,9,10,10,4,97,49,3,7,10,4,1,74
2020-03-24,강원,대구,104,3,11,9,9,5,141,157,5,14,29,18,3,226
2020-03-24,강원,대전,111,4,12,5,2,3,137,133,9,11,8,4,6,171
2020-03-24,강원,부산,2,0,0,0,1,0,3,1,1,1,2,3,0,8
2020-03-24,강원,서울,643,12,121,12,31,28,847,747,20,99,15,14,28,923
2020-03-24,강원,세종,3,0,2,0,4,0,9,6,1,1,1,3,0,12
2020-03-24,강원,울산,0,0,0,0,1,0,1,1,0,0,0,2,0,3
2020-03-24,강원,전남,36,0,2,5,11,1,55,21,2,1,4,5,0,33
2020-03-24,강원,전북,86,5,7,9,17,6,130,116,10,9,24,41,0,200
2020-03-24,강원,충남,227,9,13,30,52,10,341,313,15,16,44,70,14,472
2020-03-24,강원,충북,4210,245,286,295,465,250,5751,4323,239,243,249,433,238,5725
2020-03-24,경기,강원,19715,674,858,704,999,922,23872,18471,613,892,702,835,881,22394
2020-03-24,경기,경기,426528,23966,24518,20567,25719,31319,552617,426528,23966,24518,20567,25719,31319,552617
2020-03-24,경기,경남,2344,111,302,853,673,76,4359,1581,55,224,604,483,57,3004
2020-03-24,경기,경북,2969,235,455,818,640,85,5202,2653,216,407,968,595,71,4910
2020-03-24,경기,광주,676,27,123,344,191,23,1384,572,16,85,271,147,16,1107
2020-03-24,경기,대구,1165,121,174,385,245,31,2121,1801,137,187,504,524,64,3217
2020-03-24,경기,대전,1664,105,144,119,62,90,2184,1724,108,135,100,48,84,2199
2020-03-24,경기,부산,162,25,46,214,147,7,601,194,18,36,184,291,4,727
2020-03-24,경기,서울,145600,7336,8536,5405,4069,9495,180441,146343,6980,8883,5092,3802,9695,180795
2020-03-24,경기,세종,33,1,5,2,2,0,43,39,4,4,2,7,2,58
2020-03-24,경기,울산,25,2,2,11,14,0,54,40,5,16,47,62,3,173
2020-03-24,경기,전남,661,26,88,176,179,19,1149,582,17,54,112,123,21,909
2020-03-24,경기,전북,1067,63,143,144,187,28,1632,1110,70,113,233,268,45,1839
2020-03-24,경기,충남,35432,1666,2764,2792,4983,1908,49545,34862,1627,2645,2581,4652,1794,48161
2020-03-24,경기,충북,25582,2273,2937,3496,3815,1214,39317,24588,2215,2744,2957,4171,1170,37845
2020-03-24,경남,강원,77,2,10,15,19,1,124,114,1,6,6,11,4,142
2020-03-24,경남,경기,1581,55,224,604,483,57,3004,2344,111,302,853,673,76,4359
2020-03-24,경남,경남,184590,10416,9765,8355,13997,13777,240900,184590,10416,9765,8355,13997,13777,240900
2020-03-24,경남,경북,7669,645,951,982,2035,369,12651,9540,886,1135,1313,2878,421,16173
2020-03-24,경남,광주,819,55,119,178,149,23,1343,865,50,140,137,111,24,1327
2020-03-24,경남,대구,9616,719,797,1101,1907,376,14516,7476,504,566,427,471,292,9736
2020-03-24,경남,대전,554,22,86,86,39,17,804,724,32,89,143,61,31,1080
2020-03-24,경남,부산,81735,2696,2597,2042,5010,5798,99878,81352,2782,2807,2098,5269,5836,100144
2020-03-24,경남,서울,1533,44,298,296,185,48,2404,2228,59,304,243,111,60,3005
2020-03-24,경남,세종,119,4,5,9,7,3,147,164,3,11,12,15,6,211
2020-03-24,경남,울산,8599,630,665,504,660,568,11626,8254,590,744,492,620,535,11235
2020-03-24,경남,전남,5391,300,450,553,1486,218,8398,5389,323,433,465,1387,234,8231
2020-03-24,경남,전북,933,42,112,111,211,35,1444,911,41,113,120,206,30,1421
2020-03-24,경남,충남,859,52,140,279,256,30,1616,1210,64,167,385,531,43,2400
2020-03-24,경남,충북,832,63,130,289,317,23,1654,1084,74,224,525,661,37,2605
2020-03-24,경북,강원,271,23,22,43,29,10,398,303,25,19,29,35,12,423
2020-03-24,경북,경기,2653,216,407,968,595,71,4910,2969,235,455,818,640,85,5202
2020-03-24,경북,경남,9540,886,1135,1313,2878,421,16173,7669,645,951,982,2035,369,12651
2020-03-24,경북,경북,65579,4236,3907,3088,5871,3560,86241,65579,4236,3907,3088,5871,3560,86241
2020-03-24,경북,광주,575,59,105,195,162,13,1109,519,52,105,161,101,16,954
2020-03-24,경북,대구,63525,2988,2322,1762,3405,3406,77408,66871,3135,2643,2195,3946,3440,82230
2020-03-24,경북,대전,1314,56,84,124,93,57,1728,1311,61,76,138,77,61,1724
2020-03-24,경북,부산,3280,126,213,192,715,155,4681,3604,132,190,219,830,167,5142
2020-03-24,경북,서울,1957,103,220,466,170,56,2972,2147,73,193,259,126,58,2856
2020-03-24,경북,세종,178,6,21,23,16,9,253,193,9,14,21,12,8,257
2020-03-24,경북,울산,4383,168,295,427,1008,241,6522,4260,172,295,355,1248,248,6578
2020-03-24,경북,전남,843,51,81,133,497,15,1620,763,43,74,90,407,16,1393
2020-03-24,경북,전북,1596,93,204,219,310,53,2475,1489,117,195,188,427,42,2458
2020-03-24,경북,충남,2325,189,378,597,686,91,4266,2472,162,409,513,824,99,4479
2020-03-24,경북,충북,3882,279,552,730,1097,150,6690,3862,277,555,751,1159,143,6747
2020-03-24,광주,강원,49,3,7,10,4,1,74,63,1,9,10,10,4,97
2020-03-24,광주,경기,572,16,85,271,147,16,1107,676,27,123,344,191,23,1384
2020-03-24,광주,경남,865,50,140,137,111,24,1327,819,55,119,178,149,23,1343
2020-03-24,광주,경북,519,52,105,161,101,16,954,575,59,105,195,162,13,1109
2020-03-24,광주,광주,13508,539,584,395,446,601,16073,13508,539,584,395,446,601,16073
2020-03-24,광주,대구,347,27,62,96,35,8,575,378,26,75,76,31,5,591
2020-03-24,광주,대전,336,25,13,18,17,11,420,410,14,15,29,15,8,491
2020-03-24,광주,부산,304,11,33,55,85,7,495,289,15,59,84,115,10,572
2020-03-24,광주,서울,465,28,15,54,28,16,606,636,31,18,53,19,21,778
2020-03-24,광주,세종,93,1,5,1,4,2,106,123,4,7,11,2,2,149
2020-03-24,광주,울산,37,2,11,1,3,3,57,31,2,6,3,10,1,53
2020-03-24,광주,전남,32235,1009,1129,816,1984,1264,38437,30891,1007,1032,689,1950,1231,36800
2020-03-24,광주,전북,7083,444,545,395,487,251,9205,7107,473,488,380,511,265,9224
2020-03-24,광주,충남,3424,122,398,474,304,91,4813,3527,146,422,630,387,104,5216
2020-03-24,광주,충북,430,25,61,107,66,19,708,535,39,82,181,119,12,968
2020-03-24,대구,강원,157,5,14,29,18,3,226,104,3,11,9,9,5,141
2020-03-24,대구,경기,1801,137,187,504,524,64,3217,1165,121,174,385,245,31,2121
2020-03-24,대구,경남,7476,504,566,427,471,292,9736,9616,719,797,1101,1907,376,14516
2020-03-24,대구,경북,66871,3135,2643,2195,3946,3440,82230,63525,2988,2322,1762,3405,3406,77408
2020-03-24,대구,광주,378,26,75,76,31,5,591,347,27,62,96,35,8,575
2020-03-24,대구,대구,53994,2095,1650,939,1153,3502,63333,53994,2095,1650,939,1153,3502,63333
2020-03-24,대구,대전,573,32,36,99,40,15,795,382,22,25,58,17,11,515
2020-03-24,대구,부산,404,55,104,71,154,17,805,1980,105,169,94,261,78,2687
2020-03-24,대구,서울,1649,78,95,271,126,46,2265,969,54,57,137,43,26,1286
2020-03-24,대구,세종,143,10,6,9,4,3,175,88,5,5,6,5,3,112
2020-03-24,대구,울산,806,56,67,77,137,40,1183,791,51,77,62,146,40,1167
2020-03-24,대구,전남,401,19,37,36,45,14,552,409,16,33,37,54,13,562
2020-03-24,대구,전북,241,13,34,17,20,6,331,209,10,29,29,18,8,303
2020-03-24,대구,충남,989,77,128,239,256,25,1714,655,64,106,179,205,18,1227
2020-03-24,대구,충북,1154,96,159,292,468,36,2205,729,76,118,253,150,20,1346
2020-03-24,대전,강원,133,9,11,8,4,6,171,111,4,12,5,2,3,137
2020-03-24,대전,경기,1724,108,135,100,48,84,2199,1664,105,144,119,62,90,2184
2020-03-24,대전,경남,724,32,89,143,61,31,1080,554,22,86,86,39,17,804
2020-03-24,대전,경북,1311,61,76,138,77,61,1724,1314,56,84,124,93,57,1728
2020-03-24,대전,광주,410,14,15,29,15,8,491,336,25,13,18,17,11,420
2020-03-24,대전,대구,382,22,25,58,17,11,515,573,32,36,99,40,15,795
2020-03-24,대전,대전,13452,401,414,467,234,1014,15982,13452,401,414,467,234,1014,15982
2020-03-24,대전,부산,47,5,6,20,19,4,101,56,4,9,24,26,1,120
2020-03-24,대전,서울,1475,54,112,44,12,59,1756,1552,39,108,49,16,75,1839
2020-03-24,대전,세종,3181,86,79,43,55,245,3689,3201,97,74,33,61,245,3711
2020-03-24,대전,울산,71,5,5,21,30,1,133,76,4,2,12,25,3,122
2020-03-24,대전,전남,250,8,3,32,22,6,321,160,4,7,18,7,2,198
2020-03-24,대전,전북,2795,73,90,94,54,130,3236,2797,97,83,87,52,123,3239
2020-03-24,대전,충남,15574,508,502,284,296,1191,18355,14106,464,474,259,294,1123,16720
2020-03-24,대전,충북,10584,486,385,199,164,759,12577,9500,403,397,167,147,697,11311
2020-03-24,부산,강원,1,1,1,2,3,0,8,2,0,0,0,1,0,3
2020-03-24,부산,경기,194,18,36,184,291,4,727,162,25,46,214,147,7,601
2020-03-24,부산,경남,81352,2782,2807,2098,5269,5836,100144,81735,2696,2597,2042,5010,5798,99878
2020-03-24,부산,경북,3604,132,190,219,830,167,5142,3280,126,213,192,715,155,4681
2020-03-24,부산,광주,289,15,59,84,115,10,572,304,11,33,55,85,7,495
2020-03-24,부산,대구,1980,105,169,94,261,78,2687,404,55,104,71,154,17,805
2020-03-24,부산,대전,56,4,9,24,26,1,120,47,5,6,20,19,4,101
2020-03-24,부산,부산,40039,715,601,574,2324,2965,47218,40039,715,601,574,2324,2965,47218
2020-03-24,부산,서울,172,17,17,96,80,4,386,162,8,15,60,40,2,287
2020-03-24,부산,세종,12,1,1,4,1,0,19,10,1,0,3,3,0,17
2020-03-24,부산,울산,14839,371,505,683,2586,1058,20042,14781,381,467,426,2473,1087,19615
2020-03-24,부산,전남,1698,91,145,223,616,58,2831,1470,82,104,131,596,51,2434
2020-03-24,부산,전북,228,17,23,46,119,5,438,177,17,24,41,77,8,344
2020-03-24,부산,충남,135,9,26,82,205,1,458,102,16,31,86,222,4,461
2020-03-24,부산,충북,96,8,33,102,239,3,481,88,20,29,140,199,0,476
2020-03-24,서울,강원,747,20,99,15,14,28,923,643,12,121,12,31,28,847
2020-03-24,서울,경기,146343,6980,8883,5092,3802,9695,180795,145600,7336,8536,5405,4069,9495,180441
2020-03-24,서울,경남,2228,59,304,243,111,60,3005,1533,44,298,296,185,48,2404
2020-03-24,서울,경북,2147,73,193,259,126,58,2856,1957,103,220,466,170,56,2972
2020-03-24,서울,광주,636,31,18,53,19,21,778,465,28,15,54,28,16,606
2020-03-24,서울,대구,969,54,57,137,43,26,1286,1649,78,95,271,126,46,2265
2020-03-24,서울,대전,1552,39,108,49,16,75,1839,1475,54,112,44,12,59,1756
2020-03-24,서울,부산,162,8,15,60,40,2,287,172,17,17,96,80,4,386
2020-03-24,서울,서울,189,11,10,3,3,6,222,189,11,10,3,3,6,222
2020-03-24,서울,세종,22,0,3,0,1,2,28,25,0,2,0,0,2,29
2020-03-24,서울,울산,23,1,1,1,3,1,30,16,0,5,18,14,0,53
2020-03-24,서울,전남,773,8,15,46,30,14,886,641,9,20,62,44,17,793
2020-03-24,서울,전북,1068,32,47,23,26,39,1235,950,25,52,52,36,39,1154
2020-03-24,서울,충남,24344,571,1776,907,796,987,29381,23048,649,1746,1392,1373,951,29159
2020-03-24,서울,충북,13172,530,885,836,844,518,16785,12454,671,890,856,952,507,16330
2020-03-24,세종,강원,6,1,1,1,3,0,12,3,0,2,0,4,0,9
2020-03-24,세종,경기,39,4,4,2,7,2,58,33,1,5,2,2,0,43
2020-03-24,세종,경남,164,3,11,12,15,6,211,119,4,5,9,7,3,147
2020-03-24,세종,경북,193,9,14,21,12,8,257,178,6,21,23,16,9,253
2020-03-24,세종,광주,123,4,7,11,2,2,149,93,1,5,1,4,2,106
2020-03-24,세종,대구,88,5,5,6,5,3,112,143,10,6,9,4,3,175
2020-03-24,세종,대전,3201,97,74,33,61,245,3711,3181,86,79,43,55,245,3689
2020-03-24,세종,부산,10,1,0,3,3,0,17,12,1,1,4,1,0,19
2020-03-24,세종,서울,25,0,2,0,0,2,29,22,0,3,0,1,2,28
2020-03-24,세종,세종,222,21,3,2,1,17,266,222,21,3,2,1,17,266
2020-03-24,세종,울산,6,1,0,2,3,0,12,7,0,0,1,10,1,19
2020-03-24,세종,전남,144,2,2,15,29,2,194,99,1,2,2,10,5,119
2020-03-24,세종,전북,538,14,25,21,62,23,683,546,14,18,16,60,20,674
2020-03-24,세종,충남,5529,160,163,141,243,296,6532,4112,142,147,135,204,197,4937
2020-03-24,세종,충북,361,11,18,21,11,23,445,318,19,23,15,19,23,417
2020-03-24,울산,강원,1,0,0,0,2,0,3,0,0,0,0,1,0,1
2020-03-24,울산,경기,40,5,16,47,62,3,173,25,2,2,11,14,0,54
2020-03-24,울산,경남,8254,590,744,492,620,535,11235,8599,630,665,504,660,568,11626
2020-03-24,울산,경북,4260,172,295,355,1248,248,6578,4383,168,295,427,1008,241,6522
2020-03-24,울산,광주,31,2,6,3,10,1,53,37,2,11,1,3,3,57
2020-03-24,울산,대구,791,51,77,62,146,40,1167,806,56,67,77,137,40,1183
2020-03-24,울산,대전,76,4,2,12,25,3,122,71,5,5,21,30,1,133
2020-03-24,울산,부산,14781,381,467,426,2473,1087,19615,14839,371,505,683,2586,1058,20042
2020-03-24,울산,서울,16,0,5,18,14,0,53,23,1,1,1,3,1,30
2020-03-24,울산,세종,7,0,0,1,10,1,19,6,1,0,2,3,0,12
2020-03-24,울산,울산,7651,317,539,323,662,672,10164,7651,317,539,323,662,672,10164
2020-03-24,울산,전남,170,10,17,13,28,6,244,151,17,21,7,56,2,254
2020-03-24,울산,전북,31,1,7,1,19,0,59,29,0,5,2,7,2,45
2020-03-24,울산,충남,103,6,13,60,133,4,319,94,7,8,41,132,2,284
2020-03-24,울산,충북,13,1,7,26,34,1,82,9,2,4,19,33,2,69
2020-03-24,전남,강원,21,2,1,4,5,0,33,36,0,2,5,11,1,55
2020-03-24,전남,경기,582,17,54,112,123,21,909,661,26,88,176,179,19,1149
2020-03-24,전남,경남,5389,323,433,465,1387,234,8231,5391,300,450,553,1486,218,8398
2020-03-24,전남,경북,763,43,74,90,407,16,1393,843,51,81,133,497,15,1620
2020-03-24,전남,광주,30891,1007,1032,689,1950,1231,36800,32235,1009,1129,816,1984,1264,38437
2020-03-24,전남,대구,409,16,33,37,54,13,562,401,19,37,36,45,14,552
2020-03-24,전남,대전,160,4,7,18,7,2,198,250,8,3,32,22,6,321
2020-03-24,전남,부산,1470,82,104,131,596,51,2434,1698,91,145,223,616,58,2831
2020-03-24,전남,서울,641,9,20,62,44,17,793,773,8,15,46,30,14,886
2020-03-24,전남,세종,99,1,2,2,10,5,119,144,2,2,15,29,2,194
2020-03-24,전남,울산,151,17,21,7,56,2,254,170,10,17,13,28,6,244
2020-03-24,전남,전남,42224,1493,1520,2345,5643,1613,54838,42224,1493,1520,2345,5643,1613,54838
2020-03-24,전남,전북,6024,339,623,771,2437,156,10350,4484,296,452,670,1371,122,7395
2020-03-24,전남,충남,2168,78,240,581,601,58,3726,4054,101,382,607,1134,101,6379
2020-03-24,전남,충북,179,18,20,54,73,9,353,294,25,56,115,267,6,763
2020-03-24,전북,강원,116,10,9,24,41,0,200,86,5,7,9,17,6,130
2020-03-24,전북,경기,1110,70,113,233,268,45,1839,1067,63,143,144,187,28,1632
2020-03-24,전북,경남,911,41,113,120,206,30,1421,933,42,112,111,211,35,1444
2020-03-24,전북,경북,1489,117,195,188,427,42,2458,1596,93,204,219,310,53,2475
2020-03-24,전북,광주,7107,473,488,380,511,265,9224,7083,444,545,395,487,251,9205
2020-03-24,전북,대구,209,10,29,29,18,8,303,241,13,34,17,20,6,331
2020-03-24,전북,대전,2797,97,83,87,52,123,3239,2795,73,90,94,54,130,3236
2020-03-24,전북,부산,177,17,24,41,77,8,344,228,17,23,46,119,5,438
2020-03-24,전북,서울,950,25,52,52,36,39,1154,1068,32,47,23,26,39,1235
2020-03-24,전북,세종,546,14,18,16,60,20,674,538,14,25,21,62,23,683
2020-03-24,전북,울산,29,0,5,2,7,2,45,31,1,7,1,19,0,59
2020-03-24,전북,전남,4484,296,452,670,1371,122,7395,6024,339,623,771,2437,156,10350
2020-03-24,전북,전북,16429,793,965,883,1359,627,21056,16429,793,965,883,1359,627,21056
2020-03-24,전북,충남,13139,595,1508,1417,2212,484,19355,11891,562,1326,1075,1391,452,16697
2020-03-24,전북,충북,1689,137,196,368,466,56,2912,1571,153,222,291,298,55,2590
2020-03-24,충남,강원,313,15,16,44,70,14,472,227,9,13,30,52,10,341
2020-03-24,충남,경기,34862,1627,2645,2581,4652,1794,48161,35432,1666,2764,2792,4983,1908,49545
2020-03-24,충남,경남,1210,64,167,385,531,43,2400,859,52,140,279,256,30,1616
2020-03-24,충남,경북,2472,162,409,513,824,99,4479,2325,189,378,597,686,91,4266
2020-03-24,충남,광주,3527,146,422,630,387,104,5216,3424,122,398,474,304,91,4813
2020-03-24,충남,대구,655,64,106,179,205,18,1227,989,77,128,239,256,25,1714
2020-03-24,충남,대전,14106,464,474,259,294,1123,16720,15574,508,502,284,296,1191,18355
2020-03-24,충남,부산,102,16,31,86,222,4,461,135,9,26,82,205,1,458
2020-03-24,충남,서울,23048,649,1746,1392,1373,951,29159,24344,571,1776,907,796,987,29381
2020-03-24,충남,세종,4112,142,147,135,204,197,4937,5529,160,163,141,243,296,6532
2020-03-24,충남,울산,94,7,8,41,132,2,284,103,6,13,60,133,4,319
2020-03-24,충남,전남,4054,101,382,607,1134,101,6379,2168,78,240,581,601,58,3726
2020-03-24,충남,전북,11891,562,1326,1075,1391,452,16697,13139,595,1508,1417,2212,484,19355
2020-03-24,충남,충남,88316,3752,7295,7494,11239,4222,122318,88316,3752,7295,7494,11239,4222,122318
2020-03-24,충남,충북,12859,702,894,964,1593,742,17754,11785,655,809,860,1525,691,16325
2020-03-24,충북,강원,4323,239,243,249,433,238,5725,4210,245,286,295,465,250,5751
2020-03-24,충북,경기,24588,2215,2744,2957,4171,1170,37845,25582,2273,2937,3496,3815,1214,39317
2020-03-24,충북,경남,1084,74,224,525,661,37,2605,832,63,130,289,317,23,1654
2020-03-24,충북,경북,3862,277,555,751,1159,143,6747,3882,279,552,730,1097,150,6690
2020-03-24,충북,광주,535,39,82,181,119,12,968,430,25,61,107,66,19,708
2020-03-24,충북,대구,729,76,118,253,150,20,1346,1154,96,159,292,468,36,2205
2020-03-24,충북,대전,9500,403,397,167,147,697,11311,10584,486,385,199,164,759,12577
2020-03-24,충북,부산,88,20,29,140,199,0,476,96,8,33,102,239,3,481
2020-03-24,충북,서울,12454,671,890,856,952,507,16330,13172,530,885,836,844,518,16785
2020-03-24,충북,세종,318,19,23,15,19,23,417,361,11,18,21,11,23,445
2020-03-24,충북,울산,9,2,4,19,33,2,69,13,1,7,26,34,1,82
2020-03-24,충북,전남,294,25,56,115,267,6,763,179,18,20,54,73,9,353
2020-03-24,충북,전북,1571,153,222,291,298,55,2590,1689,137,196,368,466,56,2912
2020-03-24,충북,충남,11785,655,809,860,1525,691,16325,12859,702,894,964,1593,742,17754
2020-03-24,충북,충북,34733,2089,2432,2316,3609,1944,47123,34733,2089,2432,2316,3609,1944,47123
2020-03-25,강원,강원,60870,2371,2412,1706,3124,3934,74417,60870,2371,2412,1706,3124,3934,74417
2020-03-25,강원,경기,19322,636,886,702,787,808,23141,20235,655,849,785,1016,909,24449
2020-03-25,강원,경남,92,2,11,13,20,3,141,71,2,7,20,14,2,116
2020-03-25,강원,경북,321,31,26,23,30,11,442,301,30,14,34,37,11,427
2020-03-25,강원,광주,54,4,8,10,9,0,85,57,4,9,12,3,1,86
2020-03-25,강원,대구,133,4,12,10,11,3,173,157,9,16,22,14,7,225
2020-03-25,강원,대전,122,4,6,8,5,4,149,121,7,12,9,1,2,152
2020-03-25,강원,부산,2,0,2,1,2,0,7,0,1,0,1,1,0,3
2020-03-25,강원,서울,818,22,107,11,33,28,1019,979,17,115,17,19,36,1183
2020-03-25,강원,세종,6,0,0,1,0,0,7,7,0,0,1,0,0,8
2020-03-25,강원,울산,2,0,0,0,1,0,3,1,0,0,0,3,0,4
2020-03-25,강원,전남,28,3,3,7,8,1,50,36,2,6,7,18,3,72
2020-03-25,강원,전북,81,6,3,5,25,2,122,90,8,11,26,12,4,151
2020-03-25,강원,충남,222,8,18,25,46,7,326,319,3,16,37,81,7,463
2020-03-25,강원,충북,4248,242,284,301,528,226,5829,4251,214,241,229,461,229,5625
2020-03-25,경기,강원,20235,655,849,785,1016,909,24449,19322,636,886,702,787,808,23141
2020-03-25,경기,경기,429414,23686,24356,20972,25704,31406,555538,429414,23686,24356,20972,25704,31406,555538
2020-03-25,경기,경남,2169,112,268,782,619,68,4018,1697,75,211,554,478,45,3060
2020-03-25,경기,경북,3002,191,426,728,624,101,5072,2871,215,397,923,580,111,5097
2020-03-25,경기,광주,681,26,128,348,181,22,1386,592,28,106,262,124,15,1127
2020-03-25,경기,대구,1175,94,158,408,223,45,2103,1783,119,182,445,450,53,3032
2020-03-25,경기,대전,1773,109,139,109,50,70,2250,1775,112,143,101,34,77,2242
2020-03-25,경기,부산,141,24,46,188,155,4,558,199,16,33,170,253,5,676
2020-03-25,경기,서울,147845,7331,8528,5378,4085,9744,182911,148640,6975,8761,4977,3771,9928,183052
2020-03-25,경기,세종,35,3,2,2,1,0,43,40,4,6,2,2,0,54
2020-03-25,경기,울산,32,0,6,24,18,1,81,36,5,7,22,57,0,127
2020-03-25,경기,전남,618,30,70,162,164,25,1069,684,19,67,116,123,28,1037
2020-03-25,경기,전북,1077,52,128,115,187,31,1590,1120,52,120,195,198,31,1716
2020-03-25,경기,충남,35787,1576,2696,2699,4967,1847,49572,35519,1527,2616,2546,4733,1795,48736
2020-03-25,경기,충북,25623,2311,2804,3392,3671,1203,39004,25726,2260,2686,2933,4038,1194,38837
2020-03-25,경남,강원,71,2,7,20,14,2,116,92,2,11,13,20,3,141
2020-03-25,경남,경기,1697,75,211,554,478,45,3060,2169,112,268,782,619,68,4018
2020-03-25,경남,경남,189446,10409,9669,8245,14481,14195,246445,189446,10409,9669,8245,14481,14195,246445
2020-03-25,경남,경북,8090,591,944,914,2084,375,12998,10064,864,1145,1235,2874,467,16649
2020-03-25,경남,광주,900,59,113,205,157,25,1459,865,52,140,173,109,28,1367
2020-03-25,경남,대구,10101,722,777,1002,1837,380,14819,7642,464,552,431,492,310,9891
2020-03-25,경남,대전,600,23,75,87,45,30,860,750,36,87,114,61,45,1093
2020-03-25,경남,부산,84760,2727,2619,2286,4937,5934,103263,82794,2788,2826,2259,5193,5890,101750
2020-03-25,경남,서울,1730,36,250,312,168,56,2552,2293,58,298,192,109,60,3010
2020-03-25,경남,세종,122,0,6,12,6,6,152,170,1,12,13,13,10,219
2020-03-25,경남,울산,9103,668,706,510,651,616,12254,8629,605,752,490,660,573,11709
2020-03-25,경남,전남,5427,282,385,522,1458,228,8302,5852,314,452,443,1406,253,8720
2020-03-25,경남,전북,962,50,119,97,206,19,1453,953,41,107,119,222,26,1468
2020-03-25,경남,충남,946,52,118,288,261,42,1707,1308,67,139,371,545,41,2471
2020-03-25,경남,충북,873,58,146,273,282,32,1664,1098,64,198,491,572,31,2454
2020-03-25,경북,강원,301,30,14,34,37,11,427,321,31,26,23,30,11,442
2020-03-25,경북,경기,2871,215,397,923,580,111,5097,3002,191,426,728,624,101,5072
2020-03-25,경북,경남,10064,864,1145,1235,2874,467,16649,8090,591,944,914,2084,375,12998
2020-03-25,경북,경북,67710,4134,3997,3457,5616,3605,88519,67710,4134,3997,3457,5616,3605,88519
2020-03-25,경북,광주,597,57,110,198,152,19,1133,580,55,103,170,103,11,1022
2020-03-25,경북,대구,66250,3008,2394,1909,3452,3466,80479,68585,3230,2657,2329,3995,3564,84360
2020-03-25,경북,대전,1384,59,86,105,96,42,1772,1355,49,83,120,88,56,1751
2020-03-25,경북,부산,3635,136,205,227,694,162,5059,3827,114,216,238,890,176,5461
2020-03-25,경북,서울,2074,89,199,442,155,71,3030,2236,83,203,228,122,78,2950
2020-03-25,경북,세종,187,10,15,19,15,10,256,176,9,12,15,9,12,233
2020-03-25,경북,울산,4734,186,332,430,1125,284,7091,4620,165,319,346,1308,268,7026
2020-03-25,경북,전남,844,37,69,111,482,26,1569,840,47,81,108,633,24,1733
2020-03-25,경북,전북,1669,95,173,200,248,53,2438,1426,99,195,162,249,37,2168
2020-03-25,경북,충남,2367,160,387,623,652,99,4288,2483,134,378,502,777,94,4368
2020-03-25,경북,충북,4047,237,519,709,1095,177,6784,3913,263,529,688,1109,144,6646
2020-03-25,광주,강원,57,4,9,12,3,1,86,54,4,8,10,9,0,85
2020-03-25,광주,경기,592,28,106,262,124,15,1127,681,26,128,348,181,22,1386
2020-03-25,광주,경남,865,52,140,173,109,28,1367,900,59,113,205,157,25,1459
2020-03-25,광주,경북,580,55,103,170,103,11,1022,597,57,110,198,152,19,1133
2020-03-25,광주,광주,13981,503,617,522,475,582,16680,13981,503,617,522,475,582,16680
2020-03-25,광주,대구,385,27,63,77,31,10,593,358,23,68,80,25,13,567
2020-03-25,광주,대전,398,18,15,22,20,18,491,392,22,17,25,22,13,491
2020-03-25,광주,부산,272,15,30,46,65,5,433,342,17,37,75,113,8,592
2020-03-25,광주,서울,541,20,17,74,22,15,689,603,20,17,36,21,13,710
2020-03-25,광주,세종,114,1,11,4,7,1,138,123,2,18,4,2,6,155
2020-03-25,광주,울산,24,0,8,3,6,1,42,34,0,6,9,6,0,55
2020-03-25,광주,전남,32716,1042,1118,847,2163,1319,39205,32339,1054,983,736,2095,1306,38513
2020-03-25,광주,전북,7100,473,519,407,424,266,9189,7183,488,464,376,443,287,9241
2020-03-25,광주,충남,3483,116,379,478,359,112,4927,3429,143,393,612,409,111,5097
2020-03-25,광주,충북,430,28,66,123,58,14,719,512,36,85,204,114,13,964
2020-03-25,대구,강원,157,9,16,22,14,7,225,133,4,12,10,11,3,173
2020-03-25,대구,경기,1783,119,182,445,450,53,3032,1175,94,158,408,223,45,2103
2020-03-25,대구,경남,7642,464,552,431,492,310,9891,10101,722,777,1002,1837,380,14819
2020-03-25,대구,경북,68585,3230,2657,2329,3995,3564,84360,66250,3008,2394,1909,3452,3466,80479
2020-03-25,대구,광주,358,23,68,80,25,13,567,385,27,63,77,31,10,593
2020-03-25,대구,대구,55727,2140,1610,989,1138,3602,65206,55727,2140,1610,989,1138,3602,65206
2020-03-25,대구,대전,606,38,34,76,34,23,811,374,29,19,59,16,11,508
2020-03-25,대구,부산,456,57,101,68,145,12,839,2139,99,160,105,259,80,2842
2020-03-25,대구,서울,1754,57,86,247,102,51,2297,1027,56,60,141,35,29,1348
2020-03-25,대구,세종,135,5,5,10,11,5,171,80,1,3,6,4,4,98
2020-03-25,대구,울산,820,51,64,70,143,27,1175,846,55,65,64,157,30,1217
2020-03-25,대구,전남,419,23,34,33,42,8,559,454,22,27,32,54,11,600
2020-03-25,대구,전북,241,8,28,18,18,12,325,220,9,26,20,23,9,307
2020-03-25,대구,충남,992,80,125,228,275,32,1732,706,66,108,169,166,29,1244
2020-03-25,대구,충북,1158,113,154,294,426,32,2177,850,86,120,215,157,26,1454
2020-03-25,대전,강원,121,7,12,9,1,2,152,122,4,6,8,5,4,149
2020-03-25,대전,경기,1775,112,143,101,34,77,2242,1773,109,139,109,50,70,2250
2020-03-25,대전,경남,750,36,87,114,61,45,1093,600,23,75,87,45,30,860
2020-03-25,대전,경북,1355,49,83,120,88,56,1751,1384,59,86,105,96,42,1772
2020-03-25,대전,광주,392,22,17,25,22,13,491,398,18,15,22,20,18,491
2020-03-25,대전,대구,374,29,19,59,16,11,508,606,38,34,76,34,23,811
2020-03-25,대전,대전,13597,453,389,295,302,997,16033,13597,453,389,295,302,997,16033
2020-03-25,대전,부산,57,5,2,19,15,1,99,55,2,8,16,22,3,106
2020-03-25,대전,서울,1532,47,125,42,11,65,1822,1581,48,112,36,11,63,1851
2020-03-25,대전,세종,3234,101,69,40,60,242,3746,3263,96,56,45,72,245,3777
2020-03-25,대전,울산,63,4,3,14,33,0,117,74,1,3,13,21,0,112
2020-03-25,대전,전남,263,12,4,30,24,7,340,303,10,9,35,25,5,387
2020-03-25,대전,전북,2788,92,88,79,92,116,3255,2877,114,97,69,83,120,3360
2020-03-25,대전,충남,15610,494,497,273,329,1201,18404,14247,459,461,237,248,1066,16718
2020-03-25,대전,충북,10768,464,426,212,173,781,12824,9959,426,362,184,155,722,11808
2020-03-25,부산,강원,0,1,0,1,1,0,3,2,0,2,1,2,0,7
2020-03-25,부산,경기,199,16,33,170,253,5,676,141,24,46,188,155,4,558
2020-03-25,부산,경남,82794,2788,2826,2259,5193,5890,101750,84760,2727,2619,2286,4937,5934,103263
2020-03-25,부산,경북,3827,114,216,238,890,176,5461,3635,136,205,227,694,162,5059
2020-03-25,부산,광주,342,17,37,75,113,8,592,272,15,30,46,65,5,433
2020-03-25,부산,대구,2139,99,160,105,259,80,2842,456,57,101,68,145,12,839
2020-03-25,부산,대전,55,2,8,16,22,3,106,57,5,2,19,15,1,99
2020-03-25,부산,부산,41710,745,629,1120,2416,3096,49716,41710,745,629,1120,2416,3096,49716
2020-03-25,부산,서울,164,19,19,94,62,6,364,160,13,15,69,39,9,305
2020-03-25,부산,세종,15,0,1,6,3,1,26,11,1,0,3,2,2,19
2020-03-25,부산,울산,14982,388,470,621,2655,1070,20186,14917,389,420,410,2504,1045,19685
2020-03-25,부산,전남,1644,85,104,232,601,67,2733,1526,75,89,122,637,59,2508
2020-03-25,부산,전북,218,12,36,44,93,5,408,196,5,21,42,63,8,335
2020-03-25,부산,충남,117,14,32,80,183,4,430,96,15,25,85,230,2,453
2020-03-25,부산,충북,91,8,25,96,243,4,467,91,10,27,131,203,2,464
2020-03-25,서울,강원,979,17,115,17,19,36,1183,818,22,107,11,33,28,1019
2020-03-25,서울,경기,148640,6975,8761,4977,3771,9928,183052,147845,7331,8528,5378,4085,9744,182911
2020-03-25,서울,경남,2293,58,298,192,109,60,3010,1730,36,250,312,168,56,2552
2020-03-25,서울,경북,2236,83,203,228,122,78,2950,2074,89,199,442,155,71,3030
2020-03-25,서울,광주,603,20,17,36,21,13,710,541,20,17,74,22,15,689
2020-03-25,서울,대구,1027,56,60,141,35,29,1348,1754,57,86,247,102,51,2297
2020-03-25,서울,대전,1581,48,112,36,11,63,1851,1532,47,125,42,11,65,1822
2020-03-25,서울,부산,160,13,15,69,39,9,305,164,19,19,94,62,6,364
2020-03-25,서울,서울,181,8,6,4,1,10,210,181,8,6,4,1,10,210
2020-03-25,서울,세종,21,0,0,0,0,2,23,27,0,0,2,0,1,30
2020-03-25,서울,울산,15,0,0,1,5,0,21,22,1,5,6,12,2,48
2020-03-25,서울,전남,695,10,18,38,21,22,804,754,9,25,78,33,19,918
2020-03-25,서울,전북,1053,18,46,29,25,29,1200,1017,31,52,49,40,27,1216
2020-03-25,서울,충남,23886,544,1675,858,776,957,28696,25120,675,1667,1369,1346,991,31168
2020-03-25,서울,충북,13446,577,932,822,812,514,17103,13095,662,872,874,990,503,16996
2020-03-25,세종,강원,7,0,0,1,0,0,8,6,0,0,1,0,0,7
2020-03-25,세종,경기,40,4,6,2,2,0,54,35,3,2,2,1,0,43
2020-03-25,세종,경남,170,1,12,13,13,10,219,122,0,6,12,6,6,152
2020-03-25,세종,경북,176,9,12,15,9,12,233,187,10,15,19,15,10,256
2020-03-25,세종,광주,123,2,18,4,2,6,155,114,1,11,4,7,1,138
2020-03-25,세종,대구,80,1,3,6,4,4,98,135,5,5,10,11,5,171
2020-03-25,세종,대전,3263,96,56,45,72,245,3777,3234,101,69,40,60,242,3746
2020-03-25,세종,부산,11,1,0,3,2,2,19,15,0,1,6,3,1,26
2020-03-25,세종,서울,27,0,0,2,0,1,30,21,0,0,0,0,2,23
2020-03-25,세종,세종,212,20,4,1,0,18,255,212,20,4,1,0,18,255
2020-03-25,세종,울산,7,0,1,0,7,0,15,9,0,0,3,12,1,25
2020-03-25,세종,전남,107,2,5,10,14,5,143,109,1,0,12,10,4,136
2020-03-25,세종,전북,554,20,32,17,57,22,702,564,10,19,13,71,24,701
2020-03-25,세종,충남,5466,164,176,133,239,310,6488,4264,145,144,139,182,212,5086
2020-03-25,세종,충북,372,18,17,12,11,26,456,331,18,19,13,25,29,435
2020-03-25,울산,강원,1,0,0,0,3,0,4,2,0,0,0,1,0,3
2020-03-25,울산,경기,36,5,7,22,57,0,127,32,0,6,24,18,1,81
2020-03-25,울산,경남,8629,605,752,490,660,573,11709,9103,668,706,510,651,616,12254
2020-03-25,울산,경북,4620,165,319,346,1308,268,7026,4734,186,332,430,1125,284,7091
2020-03-25,울산,광주,34,0,6,9,6,0,55,24,0,8,3,6,1,42
2020-03-25,울산,대구,846,55,65,64,157,30,1217,820,51,64,70,143,27,1175
2020-03-25,울산,대전,74,1,3,13,21,0,112,63,4,3,14,33,0,117
2020-03-25,울산,부산,14917,389,420,410,2504,1045,19685,14982,388,470,621,2655,1070,20186
2020-03-25,울산,서울,22,1,5,6,12,2,48,15,0,0,1,5,0,21
2020-03-25,울산,세종,9,0,0,3,12,1,25,7,0,1,0,7,0,15
2020-03-25,울산,울산,8190,314,517,292,779,679,10771,8190,314,517,292,779,679,10771
2020-03-25,울산,전남,158,9,23,16,26,4,236,165,13,22,11,53,7,271
2020-03-25,울산,전북,45,0,6,1,19,2,73,32,1,4,2,7,1,47
2020-03-25,울산,충남,105,6,22,58,144,4,339,73,5,16,44,98,3,239
2020-03-25,울산,충북,19,3,3,21,54,0,100,17,1,3,17,26,0,64
2020-03-25,전남,강원,36,2,6,7,18,3,72,28,3,3,7,8,1,50
2020-03-25,전남,경기,684,19,67,116,123,28,1037,618,30,70,162,164,25,1069
2020-03-25,전남,경남,5852,314,452,443,1406,253,8720,5427,282,385,522,1458,228,8302
2020-03-25,전남,경북,840,47,81,108,633,24,1733,844,37,69,111,482,26,1569
2020-03-25,전남,광주,32339,1054,983,736,2095,1306,38513,32716,1042,1118,847,2163,1319,39205
2020-03-25,전남,대구,454,22,27,32,54,11,600,419,23,34,33,42,8,559
2020-03-25,전남,대전,303,10,9,35,25,5,387,263,12,4,30,24,7,340
2020-03-25,전남,부산,1526,75,89,122,637,59,2508,1644,85,104,232,601,67,2733
2020-03-25,전남,서울,754,9,25,78,33,19,918,695,10,18,38,21,22,804
2020-03-25,전남,세종,109,1,0,12,10,4,136,107,2,5,10,14,5,143
2020-03-25,전남,울산,165,13,22,11,53,7,271,158,9,23,16,26,4,236
2020-03-25,전남,전남,42604,1488,1474,1862,5588,1772,54788,42604,1488,1474,1862,5588,1772,54788
2020-03-25,전남,전북,4719,298,513,563,1517,135,7745,4479,261,444,622,1386,132,7324
2020-03-25,전남,충남,4215,124,356,722,1309,90,6816,3730,108,360,572,1143,98,6011
2020-03-25,전남,충북,359,29,24,84,249,12,757,316,21,41,110,272,8,768
2020-03-25,전북,강원,90,8,11,26,12,4,151,81,6,3,5,25,2,122
2020-03-25,전북,경기,1120,52,120,195,198,31,1716,1077,52,128,115,187,31,1590
2020-03-25,전북,경남,953,41,107,119,222,26,1468,962,50,119,97,206,19,1453
2020-03-25,전북,경북,1426,99,195,162,249,37,2168,1669,95,173,200,248,53,2438
2020-03-25,전북,광주,7183,488,464,376,443,287,9241,7100,473,519,407,424,266,9189
2020-03-25,전북,대구,220,9,26,20,23,9,307,241,8,28,18,18,12,325
2020-03-25,전북,대전,2877,114,97,69,83,120,3360,2788,92,88,79,92,116,3255
2020-03-25,전북,부산,196,5,21,42,63,8,335,218,12,36,44,93,5,408
2020-03-25,전북,서울,1017,31,52,49,40,27,1216,1053,18,46,29,25,29,1200
2020-03-25,전북,세종,564,10,19,13,71,24,701,554,20,32,17,57,22,702
2020-03-25,전북,울산,32,1,4,2,7,1,47,45,0,6,1,19,2,73
2020-03-25,전북,전남,4479,261,444,622,1386,132,7324,4719,298,513,563,1517,135,7745
2020-03-25,전북,전북,16183,702,929,707,1007,632,20160,16183,702,929,707,1007,632,20160
2020-03-25,전북,충남,12047,568,1303,1223,1637,401,17179,11754,510,1302,1052,1559,395,16572
2020-03-25,전북,충북,1539,116,209,269,269,65,2467,1568,131,208,264,281,69,2521
2020-03-25,충남,강원,319,3,16,37,81,7,463,222,8,18,25,46,7,326
2020-03-25,충남,경기,35519,1527,2616,2546,4733,1795,48736,35787,1576,2696,2699,4967,1847,49572
2020-03-25,충남,경남,1308,67,139,371,545,41,2471,946,52,118,288,261,42,1707
2020-03-25,충남,경북,2483,134,378,502,777,94,4368,2367,160,387,623,652,99,4288
2020-03-25,충남,광주,3429,143,393,612,409,111,5097,3483,116,379,478,359,112,4927
2020-03-25,충남,대구,706,66,108,169,166,29,1244,992,80,125,228,275,32,1732
2020-03-25,충남,대전,14247,459,461,237,248,1066,16718,15610,494,497,273,329,1201,18404
2020-03-25,충남,부산,96,15,25,85,230,2,453,117,14,32,80,183,4,430
2020-03-25,충남,서울,25120,675,1667,1369,1346,991,31168,23886,544,1675,858,776,957,28696
2020-03-25,충남,세종,4264,145,144,139,182,212,5086,5466,164,176,133,239,310,6488
2020-03-25,충남,울산,73,5,16,44,98,3,239,105,6,22,58,144,4,339
2020-03-25,충남,전남,3730,108,360,572,1143,98,6011,4215,124,356,722,1309,90,6816
2020-03-25,충남,전북,11754,510,1302,1052,1559,395,16572,12047,568,1303,1223,1637,401,17179
2020-03-25,충남,충남,90812,3807,6935,7795,11497,4232,125078,90812,3807,6935,7795,11497,4232,125078
2020-03-25,충남,충북,13226,653,855,1019,1617,788,18158,12121,637,808,883,1587,688,16724
2020-03-25,충북,강원,4251,214,241,229,461,229,5625,4248,242,284,301,528,226,5829
2020-03-25,충북,경기,25726,2260,2686,2933,4038,1194,38837,25623,2311,2804,3392,3671,1203,39004
2020-03-25,충북,경남,1098,64,198,491,572,31,2454,873,58,146,273,282,32,1664
2020-03-25,충북,경북,3913,263,529,688,1109,144,6646,4047,237,519,709,1095,177,6784
2020-03-25,충북,광주,512,36,85,204,114,13,964,430,28,66,123,58,14,719
2020-03-25,충북,대구,850,86,120,215,157,26,1454,1158,113,154,294,426,32,2177
2020-03-25,충북,대전,9959,426,362,184,155,722,11808,10768,464,426,212,173,781,12824
2020-03-25,충북,부산,91,10,27,131,203,2,464,91,8,25,96,243,4,467
2020-03-25,충북,서울,13095,662,872,874,990,503,16996,13446,577,932,822,812,514,17103
2020-03-25,충북,세종,331,18,19,13,25,29,435,372,18,17,12,11,26,456
2020-03-25,충북,울산,17,1,3,17,26,0,64,19,3,3,21,54,0,100
2020-03-25,충북,전남,316,21,41,110,272,8,768,359,29,24,84,249,12,757
2020-03-25,충북,전북,1568,131,208,264,281,69,2521,1539,116,209,269,269,65,2467
2020-03-25,충북,충남,12121,637,808,883,1587,688,16724,13226,653,855,1019,1617,788,18158
2020-03-25,충북,충북,35444,2109,2326,2387,3627,2088,47981,35444,2109,2326,2387,3627,2088,47981
2020-03-26,강원,강원,58234,2452,2449,1489,3212,4083,71919,58234,2452,2449,1489,3212,4083,71919
2020-03-26,강원,경기,18551,615,880,691,792,902,22431,18326,633,868,715,989,867,22398
2020-03-26,강원,경남,104,3,11,8,17,7,150,82,4,3,22,20,0,131
2020-03-26,강원,경북,284,20,27,28,21,13,393,297,18,20,32,40,8,415
2020-03-26,강원,광주,71,2,9,8,7,1,98,44,2,6,11,5,0,68
2020-03-26,강원,대구,129,2,11,21,13,7,183,161,12,7,22,14,5,221
2020-03-26,강원,대전,120,4,7,2,1,5,139,118,2,5,3,3,5,136
2020-03-26,강원,부산,3,0,0,1,2,1,7,2,0,0,0,1,0,3
2020-03-26,강원,서울,773,16,119,3,25,32,968,891,19,116,23,14,30,1093
2020-03-26,강원,세종,3,0,0,2,1,0,6,5,0,0,1,1,1,8
2020-03-26,강원,울산,0,0,0,0,1,0,1,0,0,0,2,0,0,2
2020-03-26,강원,전남,33,2,2,4,13,0,54,46,1,1,9,12,1,70
2020-03-26,강원,전북,90,3,12,9,15,0,129,77,6,17,13,18,2,133
2020-03-26,강원,충남,252,13,25,32,51,8,381,318,10,26,37,88,12,491
2020-03-26,강원,충북,4004,261,266,284,501,265,5581,4153,227,230,221,415,262,5508
2020-03-26,경기,강원,18326,633,868,715,989,867,22398,18551,615,880,691,792,902,22431
2020-03-26,경기,경기,421002,23164,24226,19208,24325,30517,542442,421002,23164,24226,19208,24325,30517,542442
2020-03-26,경기,경남,2365,107,284,755,564,70,4145,1768,62,217,560,439,53,3099
2020-03-26,경기,경북,2869,186,425,786,566,86,4918,3043,207,376,915,564,99,5204
2020-03-26,경기,광주,698,29,123,327,158,18,1353,608,26,100,253,120,13,1120
2020-03-26,경기,대구,1257,95,146,385,204,30,2117,1945,116,170,464,471,59,3225
2020-03-26,경기,대전,1825,88,131,122,63,93,2322,1742,114,143,97,59,90,2245
2020-03-26,경기,부산,189,21,47,182,148,6,593,213,16,37,162,273,9,710
2020-03-26,경기,서울,144862,7212,8528,5174,3953,9286,179015,144487,6893,8696,4789,3573,9390,177828
2020-03-26,경기,세종,51,1,3,5,4,2,66,52,3,6,3,5,2,71
2020-03-26,경기,울산,32,2,1,19,15,1,70,36,5,7,37,66,4,155
2020-03-26,경기,전남,575,17,90,156,120,27,985,681,20,55,134,140,24,1054
2020-03-26,경기,전북,1082,47,138,108,203,36,1614,1177,48,118,216,197,46,1802
2020-03-26,경기,충남,34378,1554,2670,2463,4605,1734,47404,35395,1498,2583,2382,4448,1762,48068
2020-03-26,경기,충북,26325,2407,2870,3381,3676,1261,39920,25173,2146,2560,2812,3810,1173,37674
2020-03-26,경남,강원,82,4,3,22,20,0,131,104,3,11,8,17,7,150
2020-03-26,경남,경기,1768,62,217,560,439,53,3099,2365,107,284,755,564,70,4145
2020-03-26,경남,경남,170837,9073,8858,6216,12435,13052,220471,170837,9073,8858,6216,12435,13052,220471
2020-03-26,경남,경북,7464,579,878,878,2093,314,12206,9481,788,1023,1153,2804,420,15669
2020-03-26,경남,광주,868,47,128,168,127,33,1371,819,42,133,156,100,24,1274
2020-03-26,경남,대구,9386,673,735,1023,1770,345,13932,6695,479,551,424,497,295,8941
2020-03-26,경남,대전,602,13,86,78,62,20,861,747,26,84,113,76,29,1075
2020-03-26,경남,부산,78066,2443,2402,1673,4264,5641,94489,76713,2536,2548,1693,4679,5596,93765
2020-03-26,경남,서울,1762,44,278,291,166,51,2592,2135,47,290,203,114,62,2851
2020-03-26,경남,세종,155,1,8,13,9,5,191,192,2,8,9,13,4,228
2020-03-26,경남,울산,8199,597,636,465,617,534,11048,7923,521,692,460,597,528,10721
2020-03-26,경남,전남,4683,241,355,410,1400,245,7334,5083,248,411,371,1355,232,7700
2020-03-26,경남,전북,893,34,83,103,199,33,1345,849,36,91,102,178,36,1292
2020-03-26,경남,충남,947,53,111,285,245,30,1671,1348,52,128,334,488,39,2389
2020-03-26,경남,충북,876,55,119,286,306,30,1672,1077,71,181,438,605,32,2404
2020-03-26,경북,강원,297,18,20,32,40,8,415,284,20,27,28,21,13,393
2020-03-26,경북,경기,3043,207,376,915,564,99,5204,2869,186,425,786,566,86,4918
2020-03-26,경북,경남,9481,788,1023,1153,2804,420,15669,7464,579,878,878,2093,314,12206
2020-03-26,경북,경북,61657,3776,3591,2822,5114,3207,80167,61657,3776,3591,2822,5114,3207,80167
2020-03-26,경북,광주,618,44,97,190,123,7,1079,545,42,92,156,81,12,928
2020-03-26,경북,대구,60334,2746,2193,1531,3230,3197,73231,62191,2831,2423,1764,3632,3291,76132
2020-03-26,경북,대전,1323,53,71,104,98,58,1707,1257,55,74,123,66,60,1635
2020-03-26,경북,부산,3316,122,184,187,676,160,4645,3403,115,203,250,783,189,4943
2020-03-26,경북,서울,2261,98,225,410,153,79,3226,2200,72,203,244,129,65,2913
2020-03-26,경북,세종,219,3,15,24,15,11,287,211,9,16,15,10,14,275
2020-03-26,경북,울산,3962,134,292,428,1037,237,6090,3996,133,284,339,1297,228,6277
2020-03-26,경북,전남,747,46,70,107,403,23,1396,757,48,75,97,527,34,1538
2020-03-26,경북,전북,1419,69,159,189,266,49,2151,1295,78,149,157,234,31,1944
2020-03-26,경북,충남,2406,154,341,557,592,96,4146,2528,137,344,539,729,90,4367
2020-03-26,경북,충북,4051,249,490,720,1065,151,6726,3799,249,503,657,1113,153,6474
2020-03-26,광주,강원,44,2,6,11,5,0,68,71,2,9,8,7,1,98
2020-03-26,광주,경기,608,26,100,253,120,13,1120,698,29,123,327,158,18,1353
2020-03-26,광주,경남,819,42,133,156,100,24,1274,868,47,128,168,127,33,1371
2020-03-26,광주,경북,545,42,92,156,81,12,928,618,44,97,190,123,7,1079
2020-03-26,광주,광주,11784,419,567,360,176,507,13813,11784,419,567,360,176,507,13813
2020-03-26,광주,대구,381,24,57,96,26,6,590,340,25,58,79,27,6,535
2020-03-26,광주,대전,377,22,12,19,19,11,460,385,16,8,26,12,9,456
2020-03-26,광주,부산,290,8,35,48,81,15,477,360,18,51,67,113,11,620
2020-03-26,광주,서울,583,16,17,61,20,16,713,685,20,13,56,12,18,804
2020-03-26,광주,세종,109,0,9,4,1,2,125,127,0,8,6,3,5,149
2020-03-26,광주,울산,37,2,7,1,8,1,56,41,1,7,6,9,0,64
2020-03-26,광주,전남,27936,810,962,567,1499,1137,32911,27505,805,841,513,1464,1102,32230
2020-03-26,광주,전북,6702,393,482,353,397,221,8548,6776,438,439,316,408,215,8592
2020-03-26,광주,충남,3593,108,378,470,258,98,4905,3605,132,410,567,344,92,5150
2020-03-26,광주,충북,478,32,44,115,61,15,745,549,27,63,145,105,16,905
2020-03-26,대구,강원,161,12,7,22,14,5,221,129,2,11,21,13,7,183
2020-03-26,대구,경기,1945,116,170,464,471,59,3225,1257,95,146,385,204,30,2117
2020-03-26,대구,경남,6695,479,551,424,497,295,8941,9386,673,735,1023,1770,345,13932
2020-03-26,대구,경북,62191,2831,2423,1764,3632,3291,76132,60334,2746,2193,1531,3230,3197,73231
2020-03-26,대구,광주,340,25,58,79,27,6,535,381,24,57,96,26,6,590
2020-03-26,대구,대구,52099,1969,1575,851,1111,3436,61041,52099,1969,1575,851,1111,3436,61041
2020-03-26,대구,대전,614,33,24,71,52,32,826,379,21,21,51,24,12,508
2020-03-26,대구,부산,424,49,98,77,149,11,808,1959,105,158,106,251,105,2684
2020-03-26,대구,서울,1837,67,90,241,91,51,2377,1084,49,71,125,46,36,1411
2020-03-26,대구,세종,143,1,3,6,7,4,164,94,2,1,6,3,2,108
2020-03-26,대구,울산,777,41,70,76,167,36,1167,819,53,64,63,170,42,1211
2020-03-26,대구,전남,285,12,37,27,47,12,420,337,15,36,19,39,8,454
2020-03-26,대구,전북,183,13,28,13,27,7,271,188,9,21,21,22,8,269
2020-03-26,대구,충남,976,77,113,217,265,31,1679,718,47,109,160,160,24,1218
2020-03-26,대구,충북,1105,86,164,279,407,39,2080,811,74,99,216,132,25,1357
2020-03-26,대전,강원,118,2,5,3,3,5,136,120,4,7,2,1,5,139
2020-03-26,대전,경기,1742,114,143,97,59,90,2245,1825,88,131,122,63,93,2322
2020-03-26,대전,경남,747,26,84,113,76,29,1075,602,13,86,78,62,20,861
2020-03-26,대전,경북,1257,55,74,123,66,60,1635,1323,53,71,104,98,58,1707
2020-03-26,대전,광주,385,16,8,26,12,9,456,377,22,12,19,19,11,460
2020-03-26,대전,대구,379,21,21,51,24,12,508,614,33,24,71,52,32,826
2020-03-26,대전,대전,13031,384,389,234,210,956,15204,13031,384,389,234,210,956,15204
2020-03-26,대전,부산,48,2,3,16,19,2,90,67,3,11,20,13,5,119
2020-03-26,대전,서울,1602,34,105,37,10,77,1865,1605,29,106,32,16,75,1863
2020-03-26,대전,세종,3149,89,65,35,46,257,3641,3116,101,68,26,68,243,3622
2020-03-26,대전,울산,80,3,4,12,34,2,135,95,4,4,10,31,1,145
2020-03-26,대전,전남,215,8,7,27,24,6,287,285,10,14,16,17,9,351
2020-03-26,대전,전북,2593,72,70,72,65,116,2988,2575,96,74,60,63,114,2982
2020-03-26,대전,충남,14960,443,477,267,329,1144,17620,13756,437,423,265,265,1057,16203
2020-03-26,대전,충북,10422,473,393,201,191,778,12458,9487,373,359,172,174,698,11263
2020-03-26,부산,강원,2,0,0,0,1,0,3,3,0,0,1,2,1,7
2020-03-26,부산,경기,213,16,37,162,273,9,710,189,21,47,182,148,6,593
2020-03-26,부산,경남,76713,2536,2548,1693,4679,5596,93765,78066,2443,2402,1673,4264,5641,94489
2020-03-26,부산,경북,3403,115,203,250,783,189,4943,3316,122,184,187,676,160,4645
2020-03-26,부산,광주,360,18,51,67,113,11,620,290,8,35,48,81,15,477
2020-03-26,부산,대구,1959,105,158,106,251,105,2684,424,49,98,77,149,11,808
2020-03-26,부산,대전,67,3,11,20,13,5,119,48,2,3,16,19,2,90
2020-03-26,부산,부산,37887,596,515,743,1976,2787,44504,37887,596,515,743,1976,2787,44504
2020-03-26,부산,서울,209,13,21,105,68,6,422,147,12,13,76,52,4,304
2020-03-26,부산,세종,12,0,0,4,1,1,18,16,0,2,0,1,0,19
2020-03-26,부산,울산,14109,343,429,634,2509,1012,19036,14284,389,385,374,2369,1075,18876
2020-03-26,부산,전남,1453,75,99,175,530,71,2403,1507,64,80,126,567,73,2417
2020-03-26,부산,전북,245,13,21,28,72,5,384,230,9,22,35,61,4,361
2020-03-26,부산,충남,124,18,18,74,161,2,397,101,14,26,81,218,2,442
2020-03-26,부산,충북,101,12,16,80,216,5,430,88,16,25,109,205,8,451
2020-03-26,서울,강원,891,19,116,23,14,30,1093,773,16,119,3,25,32,968
2020-03-26,서울,경기,144487,6893,8696,4789,3573,9390,177828,144862,7212,8528,5174,3953,9286,179015
2020-03-26,서울,경남,2135,47,290,203,114,62,2851,1762,44,278,291,166,51,2592
2020-03-26,서울,경북,2200,72,203,244,129,65,2913,2261,98,225,410,153,79,3226
2020-03-26,서울,광주,685,20,13,56,12,18,804,583,16,17,61,20,16,713
2020-03-26,서울,대구,1084,49,71,125,46,36,1411,1837,67,90,241,91,51,2377
2020-03-26,서울,대전,1605,29,106,32,16,75,1863,1602,34,105,37,10,77,1865
2020-03-26,서울,부산,147,12,13,76,52,4,304,209,13,21,105,68,6,422
2020-03-26,서울,서울,175,6,9,5,3,6,204,175,6,9,5,3,6,204
2020-03-26,서울,세종,30,0,0,1,0,0,31,36,0,1,1,0,2,40
2020-03-26,서울,울산,25,2,2,1,3,2,35,26,3,0,17,13,3,62
2020-03-26,서울,전남,701,7,26,38,23,16,811,768,12,18,59,44,22,923
2020-03-26,서울,전북,1069,21,36,33,26,37,1222,1115,28,47,47,28,31,1296
2020-03-26,서울,충남,23393,523,1715,773,776,967,28147,25236,634,1658,1215,1215,941,30899
2020-03-26,서울,충북,13557,638,998,944,868,541,17546,12976,645,898,863,989,491,16862
2020-03-26,세종,강원,5,0,0,1,1,1,8,3,0,0,2,1,0,6
2020-03-26,세종,경기,52,3,6,3,5,2,71,51,1,3,5,4,2,66
2020-03-26,세종,경남,192,2,8,9,13,4,228,155,1,8,13,9,5,191
2020-03-26,세종,경북,211,9,16,15,10,14,275,219,3,15,24,15,11,287
2020-03-26,세종,광주,127,0,8,6,3,5,149,109,0,9,4,1,2,125
2020-03-26,세종,대구,94,2,1,6,3,2,108,143,1,3,6,7,4,164
2020-03-26,세종,대전,3116,101,68,26,68,243,3622,3149,89,65,35,46,257,3641
2020-03-26,세종,부산,16,0,2,0,1,0,19,12,0,0,4,1,1,18
2020-03-26,세종,서울,36,0,1,1,0,2,40,30,0,0,1,0,0,31
2020-03-26,세종,세종,210,22,4,3,1,15,255,210,22,4,3,1,15,255
2020-03-26,세종,울산,7,0,0,0,3,0,10,14,0,0,2,4,0,20
2020-03-26,세종,전남,119,0,3,5,23,4,154,137,1,3,7,20,3,171
2020-03-26,세종,전북,544,20,15,12,26,18,635,535,13,14,13,46,19,640
2020-03-26,세종,충남,5155,146,149,131,232,290,6103,3918,136,133,99,203,218,4707
2020-03-26,세종,충북,349,13,14,16,17,22,431,321,25,20,13,22,25,426
2020-03-26,울산,강원,0,0,0,2,0,0,2,0,0,0,0,1,0,1
2020-03-26,울산,경기,36,5,7,37,66,4,155,32,2,1,19,15,1,70
2020-03-26,울산,경남,7923,521,692,460,597,528,10721,8199,597,636,465,617,534,11048
2020-03-26,울산,경북,3996,133,284,339,1297,228,6277,3962,134,292,428,1037,237,6090
2020-03-26,울산,광주,41,1,7,6,9,0,64,37,2,7,1,8,1,56
2020-03-26,울산,대구,819,53,64,63,170,42,1211,777,41,70,76,167,36,1167
2020-03-26,울산,대전,95,4,4,10,31,1,145,80,3,4,12,34,2,135
2020-03-26,울산,부산,14284,389,385,374,2369,1075,18876,14109,343,429,634,2509,1012,19036
2020-03-26,울산,서울,26,3,0,17,13,3,62,25,2,2,1,3,2,35
2020-03-26,울산,세종,14,0,0,2,4,0,20,7,0,0,0,3,0,10
2020-03-26,울산,울산,7482,261,471,302,688,645,9849,7482,261,471,302,688,645,9849
2020-03-26,울산,전남,137,7,28,16,28,7,223,181,14,22,10,46,4,277
2020-03-26,울산,전북,42,0,5,2,15,0,64,36,0,6,1,4,1,48
2020-03-26,울산,충남,129,5,23,58,92,5,312,103,3,11,40,112,4,273
2020-03-26,울산,충북,14,2,3,24,40,0,83,18,0,1,19,28,2,68
2020-03-26,전남,강원,46,1,1,9,12,1,70,33,2,2,4,13,0,54
2020-03-26,전남,경기,681,20,55,134,140,24,1054,575,17,90,156,120,27,985
2020-03-26,전남,경남,5083,248,411,371,1355,232,7700,4683,241,355,410,1400,245,7334
2020-03-26,전남,경북,757,48,75,97,527,34,1538,747,46,70,107,403,23,1396
2020-03-26,전남,광주,27505,805,841,513,1464,1102,32230,27936,810,962,567,1499,1137,32911
2020-03-26,전남,대구,337,15,36,19,39,8,454,285,12,37,27,47,12,420
2020-03-26,전남,대전,285,10,14,16,17,9,351,215,8,7,27,24,6,287
2020-03-26,전남,부산,1507,64,80,126,567,73,2417,1453,75,99,175,530,71,2403
2020-03-26,전남,서울,768,12,18,59,44,22,923,701,7,26,38,23,16,811
2020-03-26,전남,세종,137,1,3,7,20,3,171,119,0,3,5,23,4,154
2020-03-26,전남,울산,181,14,22,10,46,4,277,137,7,28,16,28,7,223
2020-03-26,전남,전남,36631,1068,1238,1126,4075,1471,45609,36631,1068,1238,1126,4075,1471,45609
2020-03-26,전남,전북,4128,238,435,465,1292,125,6683,3812,203,397,497,1220,102,6231
2020-03-26,전남,충남,3927,91,317,648,1126,96,6205,3651,79,353,491,981,107,5662
2020-03-26,전남,충북,345,24,33,78,229,5,714,291,19,44,94,232,8,688
2020-03-26,전북,강원,77,6,17,13,18,2,133,90,3,12,9,15,0,129
2020-03-26,전북,경기,1177,48,118,216,197,46,1802,1082,47,138,108,203,36,1614
2020-03-26,전북,경남,849,36,91,102,178,36,1292,893,34,83,103,199,33,1345
2020-03-26,전북,경북,1295,78,149,157,234,31,1944,1419,69,159,189,266,49,2151
2020-03-26,전북,광주,6776,438,439,316,408,215,8592,6702,393,482,353,397,221,8548
2020-03-26,전북,대구,188,9,21,21,22,8,269,183,13,28,13,27,7,271
2020-03-26,전북,대전,2575,96,74,60,63,114,2982,2593,72,70,72,65,116,2988
2020-03-26,전북,부산,230,9,22,35,61,4,361,245,13,21,28,72,5,384
2020-03-26,전북,서울,1115,28,47,47,28,31,1296,1069,21,36,33,26,37,1222
2020-03-26,전북,세종,535,13,14,13,46,19,640,544,20,15,12,26,18,635
2020-03-26,전북,울산,36,0,6,1,4,1,48,42,0,5,2,15,0,64
2020-03-26,전북,전남,3812,203,397,497,1220,102,6231,4128,238,435,465,1292,125,6683
2020-03-26,전북,전북,14429,559,833,569,749,561,17700,14429,559,833,569,749,561,17700
2020-03-26,전북,충남,11892,485,1242,1102,1420,388,16529,11578,466,1245,920,1422,384,16015
2020-03-26,전북,충북,1504,115,176,283,282,55,2415,1508,115,200,220,250,40,2333
2020-03-26,충남,강원,318,10,26,37,88,12,491,252,13,25,32,51,8,381
2020-03-26,충남,경기,35395,1498,2583,2382,4448,1762,48068,34378,1554,2670,2463,4605,1734,47404
2020-03-26,충남,경남,1348,52,128,334,488,39,2389,947,53,111,285,245,30,1671
2020-03-26,충남,경북,2528,137,344,539,729,90,4367,2406,154,341,557,592,96,4146
2020-03-26,충남,광주,3605,132,410,567,344,92,5150,3593,108,378,470,258,98,4905
2020-03-26,충남,대구,718,47,109,160,160,24,1218,976,77,113,217,265,31,1679
2020-03-26,충남,대전,13756,437,423,265,265,1057,16203,14960,443,477,267,329,1144,17620
2020-03-26,충남,부산,101,14,26,81,218,2,442,124,18,18,74,161,2,397
2020-03-26,충남,서울,25236,634,1658,1215,1215,941,30899,23393,523,1715,773,776,967,28147
2020-03-26,충남,세종,3918,136,133,99,203,218,4707,5155,146,149,131,232,290,6103
2020-03-26,충남,울산,103,3,11,40,112,4,273,129,5,23,58,92,5,312
2020-03-26,충남,전남,3651,79,353,491,981,107,5662,3927,91,317,648,1126,96,6205
2020-03-26,충남,전북,11578,466,1245,920,1422,384,16015,11892,485,1242,1102,1420,388,16529
2020-03-26,충남,충남,89062,3475,6756,6807,10531,4072,120703,89062,3475,6756,6807,10531,4072,120703
2020-03-26,충남,충북,12601,652,816,990,1523,693,17275,11585,596,785,834,1521,658,15979
2020-03-26,충북,강원,4153,227,230,221,415,262,5508,4004,261,266,284,501,265,5581
2020-03-26,충북,경기,25173,2146,2560,2812,3810,1173,37674,26325,2407,2870,3381,3676,1261,39920
2020-03-26,충북,경남,1077,71,181,438,605,32,2404,876,55,119,286,306,30,1672
2020-03-26,충북,경북,3799,249,503,657,1113,153,6474,4051,249,490,720,1065,151,6726
2020-03-26,충북,광주,549,27,63,145,105,16,905,478,32,44,115,61,15,745
2020-03-26,충북,대구,811,74,99,216,132,25,1357,1105,86,164,279,407,39,2080
2020-03-26,충북,대전,9487,373,359,172,174,698,11263,10422,473,393,201,191,778,12458
2020-03-26,충북,부산,88,16,25,109,205,8,451,101,12,16,80,216,5,430
2020-03-26,충북,서울,12976,645,898,863,989,491,16862,13557,638,998,944,868,541,17546
2020-03-26,충북,세종,321,25,20,13,22,25,426,349,13,14,16,17,22,431
2020-03-26,충북,울산,18,0,1,19,28,2,68,14,2,3,24,40,0,83
2020-03-26,충북,전남,291,19,44,94,232,8,688,345,24,33,78,229,5,714
2020-03-26,충북,전북,1508,115,200,220,250,40,2333,1504,115,176,283,282,55,2415
2020-03-26,충북,충남,11585,596,785,834,1521,658,15979,12601,652,816,990,1523,693,17275
2020-03-26,충북,충북,34830,2057,2342,2243,3337,1950,46759,34830,2057,2342,2243,3337,1950,46759
2020-03-27,강원,강원,65986,2094,2155,1106,2526,4300,78167,65986,2094,2155,1106,2526,4300,78167
2020-03-27,강원,경기,19927,539,840,608,694,970,23578,27979,578,850,658,800,1237,32102
2020-03-27,강원,경남,163,4,4,14,12,8,205,96,2,4,21,13,3,139
2020-03-27,강원,경북,393,17,20,14,21,15,480,411,16,11,25,26,22,511
2020-03-27,강원,광주,107,1,7,5,9,2,131,70,2,4,16,2,3,97
2020-03-27,강원,대구,154,3,8,6,9,2,182,217,7,9,18,9,6,266
2020-03-27,강원,대전,148,3,8,6,3,7,175,171,4,10,7,5,5,202
2020-03-27,강원,부산,6,0,0,0,4,0,10,2,0,0,0,1,0,3
2020-03-27,강원,서울,713,9,148,8,15,25,918,947,13,134,7,9,26,1136
2020-03-27,강원,세종,7,0,0,0,0,0,7,6,0,0,1,0,1,8
2020-03-27,강원,울산,1,0,0,1,1,0,3,1,0,0,0,3,0,4
2020-03-27,강원,전남,52,1,1,2,17,0,73,49,4,5,9,14,4,85
2020-03-27,강원,전북,113,2,7,11,16,4,153,134,2,10,17,16,1,180
2020-03-27,강원,충남,309,4,12,20,44,11,400,508,8,17,31,66,34,664
2020-03-27,강원,충북,4527,189,227,238,386,248,5815,4967,181,190,193,354,265,6150
2020-03-27,경기,강원,27979,578,850,658,800,1237,32102,19927,539,840,608,694,970,23578
2020-03-27,경기,경기,443493,22650,23355,19196,21637,32038,562369,443493,22650,23355,19196,21637,32038,562369
2020-03-27,경기,경남,3677,83,273,732,559,144,5468,2355,64,221,493,406,83,3622
2020-03-27,경기,경북,4269,156,445,726,504,184,6284,4292,178,386,853,510,136,6355
2020-03-27,경기,광주,1307,29,126,318,150,32,1962,779,29,94,239,96,18,1255
2020-03-27,경기,대구,1780,110,173,358,184,48,2653,2516,96,150,444,429,105,3740
2020-03-27,경기,대전,2785,85,151,100,48,141,3310,2152,89,136,104,40,102,2623
2020-03-27,경기,부산,298,14,46,183,172,10,723,295,22,26,158,214,9,724
2020-03-27,경기,서울,150983,6889,8356,4947,3119,10016,184310,144471,6600,8604,4624,2924,9601,176824
2020-03-27,경기,세종,52,2,2,2,2,2,62,56,4,4,3,3,6,76
2020-03-27,경기,울산,37,3,5,12,13,0,70,43,2,5,25,58,0,133
2020-03-27,경기,전남,1189,19,72,140,148,32,1600,858,16,54,123,102,25,1178
2020-03-27,경기,전북,2113,39,126,126,207,73,2684,1431,51,101,156,170,54,1963
2020-03-27,경기,충남,44142,1596,2557,2474,4131,2231,57131,42521,1465,2492,2333,3912,2135,54858
2020-03-27,경기,충북,30906,2139,2684,3216,3372,1543,43860,29579,2079,2567,2780,3553,1481,42039
2020-03-27,경남,강원,96,2,4,21,13,3,139,163,4,4,14,12,8,205
2020-03-27,경남,경기,2355,64,221,493,406,83,3622,3677,83,273,732,559,144,5468
2020-03-27,경남,경남,183850,8974,8703,5898,10443,14101,231969,183850,8974,8703,5898,10443,14101,231969
2020-03-27,경남,경북,8586,489,825,851,1768,385,12904,12038,745,1026,1124,2532,550,18015
2020-03-27,경남,광주,1306,42,96,184,112,44,1784,1080,42,132,163,82,36,1535
2020-03-27,경남,대구,10596,633,717,963,1487,463,14859,8195,441,536,399,428,366,10365
2020-03-27,경남,대전,851,11,76,77,42,42,1099,1084,18,76,109,65,43,1395
2020-03-27,경남,부산,83365,2435,2320,1452,3616,5920,99108,81510,2485,2452,1467,4052,5808,97774
2020-03-27,경남,서울,2107,41,305,251,139,60,2903,3089,47,309,188,95,93,3821
2020-03-27,경남,세종,208,4,8,8,7,6,241,320,2,6,11,7,10,356
2020-03-27,경남,울산,9304,586,598,481,543,589,12101,8910,546,697,453,521,554,11681
2020-03-27,경남,전남,5958,222,340,416,1198,260,8394,6137,232,399,335,1123,265,8491
2020-03-27,경남,전북,1180,33,114,91,163,30,1611,1183,35,103,116,142,43,1622
2020-03-27,경남,충남,1183,46,103,273,222,41,1868,2402,45,138,322,417,95,3419
2020-03-27,경남,충북,1118,39,110,271,252,35,1825,1815,74,182,441,528,58,3098
2020-03-27,경북,강원,411,16,11,25,26,22,511,393,17,20,14,21,15,480
2020-03-27,경북,경기,4292,178,386,853,510,136,6355,4269,156,445,726,504,184,6284
2020-03-27,경북,경남,12038,745,1026,1124,2532,550,18015,8586,489,825,851,1768,385,12904
2020-03-27,경북,경북,64965,3353,3364,2511,4135,3481,81809,64965,3353,3364,2511,4135,3481,81809
2020-03-27,경북,광주,933,45,101,180,119,25,1403,602,41,98,130,72,29,972
2020-03-27,경북,대구,63416,2570,2116,1326,2265,3414,75107,65024,2775,2376,1703,2764,3523,78165
2020-03-27,경북,대전,1839,43,90,102,74,78,2226,1576,37,85,113,57,85,1953
2020-03-27,경북,부산,4350,92,171,158,556,199,5526,3965,88,191,197,717,194,5352
2020-03-27,경북,서울,2734,80,210,339,129,88,3580,2909,67,201,208,106,104,3595
2020-03-27,경북,세종,299,8,20,19,11,16,373,269,5,10,23,9,11,327
2020-03-27,경북,울산,4458,159,272,419,945,246,6499,4303,133,257,321,1071,250,6335
2020-03-27,경북,전남,1125,30,65,102,406,35,1763,970,21,76,69,533,27,1696
2020-03-27,경북,전북,1692,72,147,159,280,49,2399,1444,83,117,144,227,53,2068
2020-03-27,경북,충남,2975,122,328,561,594,114,4694,3608,117,330,482,780,151,5468
2020-03-27,경북,충북,4981,173,379,632,905,181,7251,4707,183,435,613,935,142,7015
2020-03-27,광주,강원,70,2,4,16,2,3,97,107,1,7,5,9,2,131
2020-03-27,광주,경기,779,29,94,239,96,18,1255,1307,29,126,318,150,32,1962
2020-03-27,광주,경남,1080,42,132,163,82,36,1535,1306,42,96,184,112,44,1784
2020-03-27,광주,경북,602,41,98,130,72,29,972,933,45,101,180,119,25,1403
2020-03-27,광주,광주,12986,437,560,327,225,572,15107,12986,437,560,327,225,572,15107
2020-03-27,광주,대구,531,20,67,81,29,13,741,527,19,76,60,19,13,714
2020-03-27,광주,대전,449,19,12,19,9,17,525,536,19,16,25,11,17,624
2020-03-27,광주,부산,422,11,29,36,48,11,557,476,13,47,68,86,10,700
2020-03-27,광주,서울,756,14,22,72,16,18,898,1263,18,16,41,14,27,1379
2020-03-27,광주,세종,153,1,9,3,2,2,170,302,2,8,3,1,8,324
2020-03-27,광주,울산,61,1,7,1,5,0,75,70,1,5,5,8,1,90
2020-03-27,광주,전남,32466,863,936,670,1515,1314,37764,32488,855,852,574,1523,1277,37569
2020-03-27,광주,전북,7619,437,496,338,346,286,9522,8146,445,444,308,339,305,9987
2020-03-27,광주,충남,4293,95,397,406,222,124,5537,5449,107,423,576,322,157,7034
2020-03-27,광주,충북,586,18,57,87,68,15,831,877,24,65,164,88,43,1261
2020-03-27,대구,강원,217,7,9,18,9,6,266,154,3,8,6,9,2,182
2020-03-27,대구,경기,2516,96,150,444,429,105,3740,1780,110,173,358,184,48,2653
2020-03-27,대구,경남,8195,441,536,399,428,366,10365,10596,633,717,963,1487,463,14859
2020-03-27,대구,경북,65024,2775,2376,1703,2764,3523,78165,63416,2570,2116,1326,2265,3414,75107
2020-03-27,대구,광주,527,19,76,60,19,13,714,531,20,67,81,29,13,741
2020-03-27,대구,대구,53653,1799,1467,733,920,3619,62191,53653,1799,1467,733,920,3619,62191
2020-03-27,대구,대전,841,26,28,58,42,31,1026,521,20,24,40,22,23,650
2020-03-27,대구,부산,545,36,105,59,142,29,916,2247,84,167,82,199,117,2896
2020-03-27,대구,서울,2462,61,86,182,89,72,2952,1410,34,53,118,48,45,1708
2020-03-27,대구,세종,253,1,3,4,4,4,269,157,0,4,3,3,4,171
2020-03-27,대구,울산,985,53,64,72,133,51,1358,1070,51,64,67,150,50,1452
2020-03-27,대구,전남,486,10,31,24,35,11,597,383,19,41,29,38,15,525
2020-03-27,대구,전북,272,9,28,10,11,12,342,294,6,25,14,17,11,367
2020-03-27,대구,충남,1157,63,123,194,210,37,1784,1016,48,97,159,161,32,1513
2020-03-27,대구,충북,1373,89,138,234,350,62,2246,1122,76,101,191,134,40,1664
2020-03-27,대전,강원,171,4,10,7,5,5,202,148,3,8,6,3,7,175
2020-03-27,대전,경기,2152,89,136,104,40,102,2623,2785,85,151,100,48,141,3310
2020-03-27,대전,경남,1084,18,76,109,65,43,1395,851,11,76,77,42,42,1099
2020-03-27,대전,경북,1576,37,85,113,57,85,1953,1839,43,90,102,74,78,2226
2020-03-27,대전,광주,536,19,16,25,11,17,624,449,19,12,19,9,17,525
2020-03-27,대전,대구,521,20,24,40,22,23,650,841,26,28,58,42,31,1026
2020-03-27,대전,대전,13272,352,345,174,133,979,15255,13272,352,345,174,133,979,15255
2020-03-27,대전,부산,103,2,6,12,15,7,145,100,5,4,16,19,1,145
2020-03-27,대전,서울,1835,38,117,25,9,84,2108,2081,47,120,30,14,87,2379
2020-03-27,대전,세종,3080,108,55,22,22,235,3522,3168,92,62,32,34,252,3640
2020-03-27,대전,울산,128,3,7,13,17,4,172,144,4,3,9,23,8,191
2020-03-27,대전,전남,310,5,1,21,23,10,370,362,7,4,19,10,7,409
2020-03-27,대전,전북,2998,59,90,70,47,132,3396,3067,82,84,64,61,127,3485
2020-03-27,대전,충남,15357,440,478,224,281,1151,17931,14694,390,423,218,204,1091,17020
2020-03-27,대전,충북,10564,429,380,191,166,785,12515,9957,365,382,160,138,735,11737
2020-03-27,부산,강원,2,0,0,0,1,0,3,6,0,0,0,4,0,10
2020-03-27,부산,경기,295,22,26,158,214,9,724,298,14,46,183,172,10,723
2020-03-27,부산,경남,81510,2485,2452,1467,4052,5808,97774,83365,2435,2320,1452,3616,5920,99108
2020-03-27,부산,경북,3965,88,191,197,717,194,5352,4350,92,171,158,556,199,5526
2020-03-27,부산,광주,476,13,47,68,86,10,700,422,11,29,36,48,11,557
2020-03-27,부산,대구,2247,84,167,82,199,117,2896,545,36,105,59,142,29,916
2020-03-27,부산,대전,100,5,4,16,19,1,145,103,2,6,12,15,7,145
2020-03-27,부산,부산,39239,563,554,454,1623,2930,45363,39239,563,554,454,1623,2930,45363
2020-03-27,부산,서울,238,11,10,85,56,5,405,232,9,17,70,28,10,366
2020-03-27,부산,세종,22,0,2,3,6,3,36,22,0,1,1,2,2,28
2020-03-27,부산,울산,14710,315,418,589,2201,1083,19316,16298,338,392,419,2106,1245,20798
2020-03-27,부산,전남,2029,80,95,176,519,78,2977,1733,64,91,95,545,89,2617
2020-03-27,부산,전북,376,10,30,33,77,13,539,278,9,20,42,58,15,422
2020-03-27,부산,충남,141,8,19,60,153,9,390,198,17,26,65,187,4,497
2020-03-27,부산,충북,117,4,19,94,204,3,441,114,9,29,115,167,5,439
2020-03-27,서울,강원,947,13,134,7,9,26,1136,713,9,148,8,15,25,918
2020-03-27,서울,경기,144471,6600,8604,4624,2924,9601,176824,150983,6889,8356,4947,3119,10016,184310
2020-03-27,서울,경남,3089,47,309,188,95,93,3821,2107,41,305,251,139,60,2903
2020-03-27,서울,경북,2909,67,201,208,106,104,3595,2734,80,210,339,129,88,3580
2020-03-27,서울,광주,1263,18,16,41,14,27,1379,756,14,22,72,16,18,898
2020-03-27,서울,대구,1410,34,53,118,48,45,1708,2462,61,86,182,89,72,2952
2020-03-27,서울,대전,2081,47,120,30,14,87,2379,1835,38,117,25,9,84,2108
2020-03-27,서울,부산,232,9,17,70,28,10,366,238,11,10,85,56,5,405
2020-03-27,서울,서울,184,6,12,3,2,11,218,184,6,12,3,2,11,218
2020-03-27,서울,세종,41,0,1,0,2,2,46,38,2,0,1,1,1,43
2020-03-27,서울,울산,24,1,2,2,4,3,36,26,0,4,4,11,1,46
2020-03-27,서울,전남,1331,10,18,28,20,41,1448,844,11,28,43,36,34,996
2020-03-27,서울,전북,2093,13,36,25,29,68,2264,1287,17,38,23,21,44,1430
2020-03-27,서울,충남,31016,478,1712,752,687,1220,35865,28995,563,1748,1084,1059,1252,34701
2020-03-27,서울,충북,15102,531,859,800,736,649,18677,15152,587,855,780,894,601,18869
2020-03-27,세종,강원,6,0,0,1,0,1,8,7,0,0,0,0,0,7
2020-03-27,세종,경기,56,4,4,3,3,6,76,52,2,2,2,2,2,62
2020-03-27,세종,경남,320,2,6,11,7,10,356,208,4,8,8,7,6,241
2020-03-27,세종,경북,269,5,10,23,9,11,327,299,8,20,19,11,16,373
2020-03-27,세종,광주,302,2,8,3,1,8,324,153,1,9,3,2,2,170
2020-03-27,세종,대구,157,0,4,3,3,4,171,253,1,3,4,4,4,269
2020-03-27,세종,대전,3168,92,62,32,34,252,3640,3080,108,55,22,22,235,3522
2020-03-27,세종,부산,22,0,1,1,2,2,28,22,0,2,3,6,3,36
2020-03-27,세종,서울,38,2,0,1,1,1,43,41,0,1,0,2,2,46
2020-03-27,세종,세종,240,23,3,2,0,22,290,240,23,3,2,0,22,290
2020-03-27,세종,울산,10,1,0,1,2,0,14,9,1,0,0,4,0,14
2020-03-27,세종,전남,223,1,3,3,12,6,248,202,1,2,3,20,2,230
2020-03-27,세종,전북,728,26,26,17,34,25,856,677,11,26,17,42,19,792
2020-03-27,세종,충남,5782,147,134,123,188,293,6667,4876,141,125,110,173,230,5655
2020-03-27,세종,충북,349,13,26,20,13,39,460,329,20,21,7,11,30,418
2020-03-27,울산,강원,1,0,0,0,3,0,4,1,0,0,1,1,0,3
2020-03-27,울산,경기,43,2,5,25,58,0,133,37,3,5,12,13,0,70
2020-03-27,울산,경남,8910,546,697,453,521,554,11681,9304,586,598,481,543,589,12101
2020-03-27,울산,경북,4303,133,257,321,1071,250,6335,4458,159,272,419,945,246,6499
2020-03-27,울산,광주,70,1,5,5,8,1,90,61,1,7,1,5,0,75
2020-03-27,울산,대구,1070,51,64,67,150,50,1452,985,53,64,72,133,51,1358
2020-03-27,울산,대전,144,4,3,9,23,8,191,128,3,7,13,17,4,172
2020-03-27,울산,부산,16298,338,392,419,2106,1245,20798,14710,315,418,589,2201,1083,19316
2020-03-27,울산,서울,26,0,4,4,11,1,46,24,1,2,2,4,3,36
2020-03-27,울산,세종,9,1,0,0,4,0,14,10,1,0,1,2,0,14
2020-03-27,울산,울산,7592,254,462,241,446,627,9622,7592,254,462,241,446,627,9622
2020-03-27,울산,전남,205,11,21,16,28,9,290,225,13,14,6,56,10,324
2020-03-27,울산,전북,62,0,7,2,12,3,86,47,0,4,4,6,0,61
2020-03-27,울산,충남,127,4,13,42,115,4,305,199,6,13,36,103,8,365
2020-03-27,울산,충북,24,5,4,15,37,1,86,22,3,3,17,23,1,69
2020-03-27,전남,강원,49,4,5,9,14,4,85,52,1,1,2,17,0,73
2020-03-27,전남,경기,858,16,54,123,102,25,1178,1189,19,72,140,148,32,1600
2020-03-27,전남,경남,6137,232,399,335,1123,265,8491,5958,222,340,416,1198,260,8394
2020-03-27,전남,경북,970,21,76,69,533,27,1696,1125,30,65,102,406,35,1763
2020-03-27,전남,광주,32488,855,852,574,1523,1277,37569,32466,863,936,670,1515,1314,37764
2020-03-27,전남,대구,383,19,41,29,38,15,525,486,10,31,24,35,11,597
2020-03-27,전남,대전,362,7,4,19,10,7,409,310,5,1,21,23,10,370
2020-03-27,전남,부산,1733,64,91,95,545,89,2617,2029,80,95,176,519,78,2977
2020-03-27,전남,서울,844,11,28,43,36,34,996,1331,10,18,28,20,41,1448
2020-03-27,전남,세종,202,1,2,3,20,2,230,223,1,3,3,12,6,248
2020-03-27,전남,울산,225,13,14,6,56,10,324,205,11,21,16,28,9,290
2020-03-27,전남,전남,43752,1125,1291,1178,4129,1769,53244,43752,1125,1291,1178,4129,1769,53244
2020-03-27,전남,전북,5125,240,420,423,1219,157,7584,5135,186,352,486,1169,161,7489
2020-03-27,전남,충남,4776,82,327,542,948,139,6814,6617,98,353,483,945,173,8669
2020-03-27,전남,충북,424,18,28,73,216,23,782,500,10,30,97,225,13,875
2020-03-27,전북,강원,134,2,10,17,16,1,180,113,2,7,11,16,4,153
2020-03-27,전북,경기,1431,51,101,156,170,54,1963,2113,39,126,126,207,73,2684
2020-03-27,전북,경남,1183,35,103,116,142,43,1622,1180,33,114,91,163,30,1611
2020-03-27,전북,경북,1444,83,117,144,227,53,2068,1692,72,147,159,280,49,2399
2020-03-27,전북,광주,8146,445,444,308,339,305,9987,7619,437,496,338,346,286,9522
2020-03-27,전북,대구,294,6,25,14,17,11,367,272,9,28,10,11,12,342
2020-03-27,전북,대전,3067,82,84,64,61,127,3485,2998,59,90,70,47,132,3396
2020-03-27,전북,부산,278,9,20,42,58,15,422,376,10,30,33,77,13,539
2020-03-27,전북,서울,1287,17,38,23,21,44,1430,2093,13,36,25,29,68,2264
2020-03-27,전북,세종,677,11,26,17,42,19,792,728,26,26,17,34,25,856
2020-03-27,전북,울산,47,0,4,4,6,0,61,62,0,7,2,12,3,86
2020-03-27,전북,전남,5135,186,352,486,1169,161,7489,5125,240,420,423,1219,157,7584
2020-03-27,전북,전북,15366,555,812,598,672,606,18609,15366,555,812,598,672,606,18609
2020-03-27,전북,충남,14134,451,1259,1066,1268,497,18675,16751,436,1247,898,1275,620,21227
2020-03-27,전북,충북,1736,100,168,250,263,58,2575,1984,114,184,239,255,77,2853
2020-03-27,충남,강원,508,8,17,31,66,34,664,309,4,12,20,44,11,400
2020-03-27,충남,경기,42521,1465,2492,2333,3912,2135,54858,44142,1596,2557,2474,4131,2231,57131
2020-03-27,충남,경남,2402,45,138,322,417,95,3419,1183,46,103,273,222,41,1868
2020-03-27,충남,경북,3608,117,330,482,780,151,5468,2975,122,328,561,594,114,4694
2020-03-27,충남,광주,5449,107,423,576,322,157,7034,4293,95,397,406,222,124,5537
2020-03-27,충남,대구,1016,48,97,159,161,32,1513,1157,63,123,194,210,37,1784
2020-03-27,충남,대전,14694,390,423,218,204,1091,17020,15357,440,478,224,281,1151,17931
2020-03-27,충남,부산,198,17,26,65,187,4,497,141,8,19,60,153,9,390
2020-03-27,충남,서울,28995,563,1748,1084,1059,1252,34701,31016,478,1712,752,687,1220,35865
2020-03-27,충남,세종,4876,141,125,110,173,230,5655,5782,147,134,123,188,293,6667
2020-03-27,충남,울산,199,6,13,36,103,8,365,127,4,13,42,115,4,305
2020-03-27,충남,전남,6617,98,353,483,945,173,8669,4776,82,327,542,948,139,6814
2020-03-27,충남,전북,16751,436,1247,898,1275,620,21227,14134,451,1259,1066,1268,497,18675
2020-03-27,충남,충남,104668,3336,6616,6740,9722,4972,136054,104668,3336,6616,6740,9722,4972,136054
2020-03-27,충남,충북,13818,596,751,932,1366,775,18238,12318,591,745,811,1379,685,16529
2020-03-27,충북,강원,4967,181,190,193,354,265,6150,4527,189,227,238,386,248,5815
2020-03-27,충북,경기,29579,2079,2567,2780,3553,1481,42039,30906,2139,2684,3216,3372,1543,43860
2020-03-27,충북,경남,1815,74,182,441,528,58,3098,1118,39,110,271,252,35,1825
2020-03-27,충북,경북,4707,183,435,613,935,142,7015,4981,173,379,632,905,181,7251
2020-03-27,충북,광주,877,24,65,164,88,43,1261,586,18,57,87,68,15,831
2020-03-27,충북,대구,1122,76,101,191,134,40,1664,1373,89,138,234,350,62,2246
2020-03-27,충북,대전,9957,365,382,160,138,735,11737,10564,429,380,191,166,785,12515
2020-03-27,충북,부산,114,9,29,115,167,5,439,117,4,19,94,204,3,441
2020-03-27,충북,서울,15152,587,855,780,894,601,18869,15102,531,859,800,736,649,18677
2020-03-27,충북,세종,329,20,21,7,11,30,418,349,13,26,20,13,39,460
2020-03-27,충북,울산,22,3,3,17,23,1,69,24,5,4,15,37,1,86
2020-03-27,충북,전남,500,10,30,97,225,13,875,424,18,28,73,216,23,782
2020-03-27,충북,전북,1984,114,184,239,255,77,2853,1736,100,168,250,263,58,2575
2020-03-27,충북,충남,12318,591,745,811,1379,685,16529,13818,596,751,932,1366,775,18238
2020-03-27,충북,충북,35594,1800,2145,2076,3017,2102,46734,35594,1800,2145,2076,3017,2102,46734
2020-03-28,강원,강원,86269,1558,1649,980,2284,4331,97071,86269,1558,1649,980,2284,4331,97071
2020-03-28,강원,경기,30185,332,607,355,376,1294,33149,43801,399,579,402,583,1687,47451
2020-03-28,강원,경남,123,5,6,5,5,6,150,85,2,2,11,3,6,109
2020-03-28,강원,경북,440,14,11,6,9,20,500,434,14,9,22,15,12,506
2020-03-28,강원,광주,77,6,5,6,1,2,97,100,2,3,12,3,4,124
2020-03-28,강원,대구,140,2,6,5,1,12,166,239,5,6,11,7,6,274
2020-03-28,강원,대전,164,0,5,3,0,5,177,210,3,5,3,1,9,231
2020-03-28,강원,부산,2,0,1,0,1,0,4,5,1,1,0,1,0,8
2020-03-28,강원,서울,938,7,129,3,19,39,1135,1728,10,131,9,10,57,1945
2020-03-28,강원,세종,4,0,0,1,1,0,6,9,0,0,0,2,0,11
2020-03-28,강원,울산,1,0,0,0,0,0,1,0,0,0,0,0,0,0
2020-03-28,강원,전남,45,1,3,4,4,5,62,44,1,3,3,10,2,63
2020-03-28,강원,전북,120,1,4,4,5,5,139,142,5,7,9,9,3,175
2020-03-28,강원,충남,297,1,5,15,17,7,342,537,11,11,26,54,12,651
2020-03-28,강원,충북,4724,145,145,143,276,240,5673,5558,150,153,127,256,287,6531
2020-03-28,경기,강원,43801,399,579,402,583,1687,47451,30185,332,607,355,376,1294,33149
2020-03-28,경기,경기,378142,10621,11327,10181,14683,22497,447451,378142,10621,11327,10181,14683,22497,447451
2020-03-28,경기,경남,3169,46,205,501,347,131,4399,1736,36,141,271,198,65,2447
2020-03-28,경기,경북,4291,81,179,429,336,145,5461,3433,66,173,439,306,100,4517
2020-03-28,경기,광주,1010,10,61,161,90,42,1374,594,7,37,101,46,27,812
2020-03-28,경기,대구,1294,45,77,260,135,46,1857,1934,41,84,240,177,56,2532
2020-03-28,경기,대전,2974,46,116,80,25,156,3397,2379,50,104,53,21,136,2743
2020-03-28,경기,부산,291,8,35,125,88,11,558,221,9,16,96,115,9,466
2020-03-28,경기,서울,130385,4131,4644,2942,2815,7379,152296,128887,3661,4862,2410,2452,7236,149508
2020-03-28,경기,세종,46,1,2,0,0,2,51,59,2,1,2,3,4,71
2020-03-28,경기,울산,13,2,1,3,8,1,28,32,2,4,11,26,2,77
2020-03-28,경기,전남,1344,11,55,93,81,40,1624,811,12,37,60,66,20,1006
2020-03-28,경기,전북,2460,29,92,63,127,89,2860,1590,24,57,83,80,70,1904
2020-03-28,경기,충남,48288,768,1391,1180,2265,2181,56073,43642,710,1337,1153,2331,2029,51202
2020-03-28,경기,충북,33713,955,1314,1607,2189,1561,41339,29441,919,1166,1373,2596,1348,36843
2020-03-28,경남,강원,85,2,2,11,3,6,109,123,5,6,5,5,6,150
2020-03-28,경남,경기,1736,36,141,271,198,65,2447,3169,46,205,501,347,131,4399
2020-03-28,경남,경남,180141,5744,5071,3486,7353,11603,213398,180141,5744,5071,3486,7353,11603,213398
2020-03-28,경남,경북,10695,291,470,451,1017,505,13429,13154,390,588,632,1349,625,16738
2020-03-28,경남,광주,1318,25,69,106,68,36,1622,1379,22,68,86,55,52,1662
2020-03-28,경남,대구,11257,336,503,452,585,480,13613,10606,257,349,237,236,406,12091
2020-03-28,경남,대전,835,11,65,26,21,44,1002,1364,9,65,75,35,57,1605
2020-03-28,경남,부산,82447,1519,1581,963,2091,5244,93845,82701,1491,1666,882,2126,5338,94204
2020-03-28,경남,서울,1801,14,274,153,84,55,2381,3122,21,310,146,80,120,3799
2020-03-28,경남,세종,188,3,5,0,4,6,206,355,1,5,9,5,12,387
2020-03-28,경남,울산,9580,351,339,266,240,581,11357,9584,315,391,252,245,514,11301
2020-03-28,경남,전남,7213,138,221,261,710,301,8844,6938,160,247,197,711,300,8553
2020-03-28,경남,전북,1422,27,72,43,140,72,1776,1350,26,74,42,129,41,1662
2020-03-28,경남,충남,1077,20,49,112,109,46,1413,1940,28,88,188,263,68,2575
2020-03-28,경남,충북,1141,15,54,114,147,44,1515,1652,25,106,281,341,73,2478
2020-03-28,경북,강원,434,14,9,22,15,12,506,440,14,11,6,9,20,500
2020-03-28,경북,경기,3433,66,173,439,306,100,4517,4291,81,179,429,336,145,5461
2020-03-28,경북,경남,13154,390,588,632,1349,625,16738,10695,291,470,451,1017,505,13429
2020-03-28,경북,경북,71495,2230,2158,1549,3223,3398,84053,71495,2230,2158,1549,3223,3398,84053
2020-03-28,경북,광주,749,20,58,94,76,22,1019,671,18,41,78,40,18,866
2020-03-28,경북,대구,61388,1695,1385,930,2278,2829,70505,69079,1734,1489,1029,2300,3046,78677
2020-03-28,경북,대전,1948,31,45,53,41,103,2221,2032,21,48,76,35,98,2310
2020-03-28,경북,부산,5322,48,145,91,239,254,6099,6042,54,159,90,331,269,6945
2020-03-28,경북,서울,2410,41,160,164,81,92,2948,3332,31,164,127,77,121,3852
2020-03-28,경북,세종,275,3,6,13,9,7,313,289,7,5,5,6,12,324
2020-03-28,경북,울산,5659,70,154,248,622,290,7043,5795,67,140,172,749,295,7218
2020-03-28,경북,전남,1402,29,45,49,248,37,1810,1252,30,41,42,313,45,1723
2020-03-28,경북,전북,1940,71,104,98,145,73,2431,1553,65,99,69,136,47,1969
2020-03-28,경북,충남,2912,59,138,251,307,109,3776,3512,49,170,303,364,140,4538
2020-03-28,경북,충북,5216,104,236,288,534,186,6564,5454,122,270,352,643,216,7057
2020-03-28,광주,강원,100,2,3,12,3,4,124,77,6,5,6,1,2,97
2020-03-28,광주,경기,594,7,37,101,46,27,812,1010,10,61,161,90,42,1374
2020-03-28,광주,경남,1379,22,68,86,55,52,1662,1318,25,69,106,68,36,1622
2020-03-28,광주,경북,671,18,41,78,40,18,866,749,20,58,94,76,22,1019
2020-03-28,광주,광주,13275,365,422,205,159,482,14908,13275,365,422,205,159,482,14908
2020-03-28,광주,대구,332,14,49,59,11,9,474,445,13,52,40,10,11,571
2020-03-28,광주,대전,508,12,4,11,8,15,558,567,4,8,17,13,16,625
2020-03-28,광주,부산,433,7,28,16,28,14,526,456,5,36,33,39,13,582
2020-03-28,광주,서울,657,10,16,44,14,20,761,1004,10,14,35,7,32,1102
2020-03-28,광주,세종,188,0,4,5,0,3,200,244,2,5,4,1,4,260
2020-03-28,광주,울산,40,0,5,2,3,1,51,41,0,4,4,2,4,55
2020-03-28,광주,전남,40522,630,748,420,1076,1330,44726,37016,650,677,348,1122,1221,41034
2020-03-28,광주,전북,8812,261,279,152,188,288,9980,8535,295,277,189,237,239,9772
2020-03-28,광주,충남,4622,57,323,214,160,128,5504,5576,72,336,328,220,149,6681
2020-03-28,광주,충북,572,16,26,46,19,13,692,773,13,34,79,57,23,979
2020-03-28,대구,강원,239,5,6,11,7,6,274,140,2,6,5,1,12,166
2020-03-28,대구,경기,1934,41,84,240,177,56,2532,1294,45,77,260,135,46,1857
2020-03-28,대구,경남,10606,257,349,237,236,406,12091,11257,336,503,452,585,480,13613
2020-03-28,대구,경북,69079,1734,1489,1029,2300,3046,78677,61388,1695,1385,930,2278,2829,70505
2020-03-28,대구,광주,445,13,52,40,10,11,571,332,14,49,59,11,9,474
2020-03-28,대구,대구,45011,1129,895,475,717,2551,50778,45011,1129,895,475,717,2551,50778
2020-03-28,대구,대전,788,12,17,38,22,31,908,482,15,12,42,13,16,580
2020-03-28,대구,부산,697,19,76,35,57,19,903,2814,32,122,44,78,101,3191
2020-03-28,대구,서울,1906,34,81,100,58,60,2239,1149,28,54,93,33,41,1398
2020-03-28,대구,세종,172,1,3,6,3,3,188,119,1,1,1,3,3,128
2020-03-28,대구,울산,1093,28,38,43,69,56,1327,1031,23,38,33,94,40,1259
2020-03-28,대구,전남,874,13,21,12,14,30,964,658,11,23,16,15,17,740
2020-03-28,대구,전북,392,2,13,12,7,5,431,286,6,18,8,10,11,339
2020-03-28,대구,충남,1120,25,54,95,88,45,1427,757,18,55,82,117,37,1066
2020-03-28,대구,충북,1376,36,79,109,154,66,1820,930,30,72,148,108,42,1330
2020-03-28,대전,강원,210,3,5,3,1,9,231,164,0,5,3,0,5,177
2020-03-28,대전,경기,2379,50,104,53,21,136,2743,2974,46,116,80,25,156,3397
2020-03-28,대전,경남,1364,9,65,75,35,57,1605,835,11,65,26,21,44,1002
2020-03-28,대전,경북,2032,21,48,76,35,98,2310,1948,31,45,53,41,103,2221
2020-03-28,대전,광주,567,4,8,17,13,16,625,508,12,4,11,8,15,558
2020-03-28,대전,대구,482,15,12,42,13,16,580,788,12,17,38,22,31,908
2020-03-28,대전,대전,11949,223,257,155,156,764,13504,11949,223,257,155,156,764,13504
2020-03-28,대전,부산,87,3,3,12,5,2,112,82,1,5,12,17,4,121
2020-03-28,대전,서울,1963,14,128,15,4,78,2202,2381,11,112,28,6,110,2648
2020-03-28,대전,세종,2684,69,36,15,49,147,3000,2709,77,32,13,54,166,3051
2020-03-28,대전,울산,93,0,1,9,16,4,123,105,0,4,6,14,5,134
2020-03-28,대전,전남,637,4,8,22,14,15,700,443,4,9,10,15,11,492
2020-03-28,대전,전북,4251,44,57,48,59,190,4649,3751,60,59,27,46,165,4108
2020-03-28,대전,충남,15058,284,293,141,182,849,16807,13793,246,282,120,164,835,15440
2020-03-28,대전,충북,10006,280,276,103,126,638,11429,9311,237,262,102,127,591,10630
2020-03-28,부산,강원,5,1,1,0,1,0,8,2,0,1,0,1,0,4
2020-03-28,부산,경기,221,9,16,96,115,9,466,291,8,35,125,88,11,558
2020-03-28,부산,경남,82701,1491,1666,882,2126,5338,94204,82447,1519,1581,963,2091,5244,93845
2020-03-28,부산,경북,6042,54,159,90,331,269,6945,5322,48,145,91,239,254,6099
2020-03-28,부산,광주,456,5,36,33,39,13,582,433,7,28,16,28,14,526
2020-03-28,부산,대구,2814,32,122,44,78,101,3191,697,19,76,35,57,19,903
2020-03-28,부산,대전,82,1,5,12,17,4,121,87,3,3,12,5,2,112
2020-03-28,부산,부산,45119,383,310,477,835,2787,49911,45119,383,310,477,835,2787,49911
2020-03-28,부산,서울,224,8,9,35,36,7,319,266,5,22,40,18,6,357
2020-03-28,부산,세종,16,0,0,4,1,2,23,30,0,0,0,1,2,33
2020-03-28,부산,울산,15868,210,209,244,943,1041,18515,17512,198,195,176,918,1128,20127
2020-03-28,부산,전남,2245,36,62,70,276,80,2769,1846,35,56,49,282,63,2331
2020-03-28,부산,전북,374,4,23,14,37,12,464,273,4,20,17,21,4,339
2020-03-28,부산,충남,140,5,12,19,61,8,245,164,3,14,51,131,5,368
2020-03-28,부산,충북,119,2,9,25,90,3,248,129,6,11,59,87,1,293
2020-03-28,서울,강원,1728,10,131,9,10,57,1945,938,7,129,3,19,39,1135
2020-03-28,서울,경기,128887,3661,4862,2410,2452,7236,149508,130385,4131,4644,2942,2815,7379,152296
2020-03-28,서울,경남,3122,21,310,146,80,120,3799,1801,14,274,153,84,55,2381
2020-03-28,서울,경북,3332,31,164,127,77,121,3852,2410,41,160,164,81,92,2948
2020-03-28,서울,광주,1004,10,14,35,7,32,1102,657,10,16,44,14,20,761
2020-03-28,서울,대구,1149,28,54,93,33,41,1398,1906,34,81,100,58,60,2239
2020-03-28,서울,대전,2381,11,112,28,6,110,2648,1963,14,128,15,4,78,2202
2020-03-28,서울,부산,266,5,22,40,18,6,357,224,8,9,35,36,7,319
2020-03-28,서울,서울,181,1,9,2,1,5,199,181,1,9,2,1,5,199
2020-03-28,서울,세종,34,0,0,2,1,3,40,32,0,0,0,0,2,34
2020-03-28,서울,울산,33,1,1,0,2,0,37,26,1,2,7,9,0,45
2020-03-28,서울,전남,1459,4,15,23,20,44,1565,864,4,16,16,9,23,932
2020-03-28,서울,전북,2432,7,23,11,15,80,2568,1556,9,22,17,17,44,1665
2020-03-28,서울,충남,37805,251,1401,456,461,1522,41896,32741,255,1415,549,759,1358,37077
2020-03-28,서울,충북,18164,203,626,458,473,789,20713,15947,226,605,495,670,693,18636
2020-03-28,세종,강원,9,0,0,0,2,0,11,4,0,0,1,1,0,6
2020-03-28,세종,경기,59,2,1,2,3,4,71,46,1,2,0,0,2,51
2020-03-28,세종,경남,355,1,5,9,5,12,387,188,3,5,0,4,6,206
2020-03-28,세종,경북,289,7,5,5,6,12,324,275,3,6,13,9,7,313
2020-03-28,세종,광주,244,2,5,4,1,4,260,188,0,4,5,0,3,200
2020-03-28,세종,대구,119,1,1,1,3,3,128,172,1,3,6,3,3,188
2020-03-28,세종,대전,2709,77,32,13,54,166,3051,2684,69,36,15,49,147,3000
2020-03-28,세종,부산,30,0,0,0,1,2,33,16,0,0,4,1,2,23
2020-03-28,세종,서울,32,0,0,0,0,2,34,34,0,0,2,1,3,40
2020-03-28,세종,세종,220,18,0,1,1,24,264,220,18,0,1,1,24,264
2020-03-28,세종,울산,5,0,0,0,0,2,7,13,0,0,0,2,0,15
2020-03-28,세종,전남,300,2,5,4,6,7,324,192,0,4,1,7,7,211
2020-03-28,세종,전북,1163,8,12,8,18,40,1249,909,8,6,10,14,26,973
2020-03-28,세종,충남,6623,101,87,91,110,296,7308,4698,85,84,74,143,208,5292
2020-03-28,세종,충북,394,12,12,18,14,27,477,319,11,12,13,10,17,382
2020-03-28,울산,강원,0,0,0,0,0,0,0,1,0,0,0,0,0,1
2020-03-28,울산,경기,32,2,4,11,26,2,77,13,2,1,3,8,1,28
2020-03-28,울산,경남,9584,315,391,252,245,514,11301,9580,351,339,266,240,581,11357
2020-03-28,울산,경북,5795,67,140,172,749,295,7218,5659,70,154,248,622,290,7043
2020-03-28,울산,광주,41,0,4,4,2,4,55,40,0,5,2,3,1,51
2020-03-28,울산,대구,1031,23,38,33,94,40,1259,1093,28,38,43,69,56,1327
2020-03-28,울산,대전,105,0,4,6,14,5,134,93,0,1,9,16,4,123
2020-03-28,울산,부산,17512,198,195,176,918,1128,20127,15868,210,209,244,943,1041,18515
2020-03-28,울산,서울,26,1,2,7,9,0,45,33,1,1,0,2,0,37
2020-03-28,울산,세종,13,0,0,0,2,0,15,5,0,0,0,0,2,7
2020-03-28,울산,울산,6052,126,221,104,275,478,7256,6052,126,221,104,275,478,7256
2020-03-28,울산,전남,190,3,10,5,15,9,232,168,6,9,4,17,6,210
2020-03-28,울산,전북,58,0,4,3,10,4,79,40,1,4,1,2,4,52
2020-03-28,울산,충남,109,1,5,19,62,6,202,103,3,6,17,41,5,175
2020-03-28,울산,충북,22,1,0,8,16,1,48,11,0,3,10,20,1,45
2020-03-28,전남,강원,44,1,3,3,10,2,63,45,1,3,4,4,5,62
2020-03-28,전남,경기,811,12,37,60,66,20,1006,1344,11,55,93,81,40,1624
2020-03-28,전남,경남,6938,160,247,197,711,300,8553,7213,138,221,261,710,301,8844
2020-03-28,전남,경북,1252,30,41,42,313,45,1723,1402,29,45,49,248,37,1810
2020-03-28,전남,광주,37016,650,677,348,1122,1221,41034,40522,630,748,420,1076,1330,44726
2020-03-28,전남,대구,658,11,23,16,15,17,740,874,13,21,12,14,30,964
2020-03-28,전남,대전,443,4,9,10,15,11,492,637,4,8,22,14,15,700
2020-03-28,전남,부산,1846,35,56,49,282,63,2331,2245,36,62,70,276,80,2769
2020-03-28,전남,서울,864,4,16,16,9,23,932,1459,4,15,23,20,44,1565
2020-03-28,전남,세종,192,0,4,1,7,7,211,300,2,5,4,6,7,324
2020-03-28,전남,울산,168,6,9,4,17,6,210,190,3,10,5,15,9,232
2020-03-28,전남,전남,50305,783,887,847,3063,1684,57569,50305,783,887,847,3063,1684,57569
2020-03-28,전남,전북,6793,173,307,270,792,209,8544,7324,143,255,328,867,190,9107
2020-03-28,전남,충남,5121,41,241,213,411,147,6174,7723,62,279,289,461,210,9024
2020-03-28,전남,충북,418,10,11,35,86,15,575,617,5,8,54,125,28,837
2020-03-28,전북,강원,142,5,7,9,9,3,175,120,1,4,4,5,5,139
2020-03-28,전북,경기,1590,24,57,83,80,70,1904,2460,29,92,63,127,89,2860
2020-03-28,전북,경남,1350,26,74,42,129,41,1662,1422,27,72,43,140,72,1776
2020-03-28,전북,경북,1553,65,99,69,136,47,1969,1940,71,104,98,145,73,2431
2020-03-28,전북,광주,8535,295,277,189,237,239,9772,8812,261,279,152,188,288,9980
2020-03-28,전북,대구,286,6,18,8,10,11,339,392,2,13,12,7,5,431
2020-03-28,전북,대전,3751,60,59,27,46,165,4108,4251,44,57,48,59,190,4649
2020-03-28,전북,부산,273,4,20,17,21,4,339,374,4,23,14,37,12,464
2020-03-28,전북,서울,1556,9,22,17,17,44,1665,2432,7,23,11,15,80,2568
2020-03-28,전북,세종,909,8,6,10,14,26,973,1163,8,12,8,18,40,1249
2020-03-28,전북,울산,40,1,4,1,2,4,52,58,0,4,3,10,4,79
2020-03-28,전북,전남,7324,143,255,328,867,190,9107,6793,173,307,270,792,209,8544
2020-03-28,전북,전북,16335,408,552,362,514,596,18767,16335,408,552,362,514,596,18767
2020-03-28,전북,충남,16797,256,842,469,675,574,19613,20344,276,906,467,794,691,23478
2020-03-28,전북,충북,1890,53,93,110,133,70,2349,2407,62,95,137,154,86,2941
2020-03-28,충남,강원,537,11,11,26,54,12,651,297,1,5,15,17,7,342
2020-03-28,충남,경기,43642,710,1337,1153,2331,2029,51202,48288,768,1391,1180,2265,2181,56073
2020-03-28,충남,경남,1940,28,88,188,263,68,2575,1077,20,49,112,109,46,1413
2020-03-28,충남,경북,3512,49,170,303,364,140,4538,2912,59,138,251,307,109,3776
2020-03-28,충남,광주,5576,72,336,328,220,149,6681,4622,57,323,214,160,128,5504
2020-03-28,충남,대구,757,18,55,82,117,37,1066,1120,25,54,95,88,45,1427
2020-03-28,충남,대전,13793,246,282,120,164,835,15440,15058,284,293,141,182,849,16807
2020-03-28,충남,부산,164,3,14,51,131,5,368,140,5,12,19,61,8,245
2020-03-28,충남,서울,32741,255,1415,549,759,1358,37077,37805,251,1401,456,461,1522,41896
2020-03-28,충남,세종,4698,85,84,74,143,208,5292,6623,101,87,91,110,296,7308
2020-03-28,충남,울산,103,3,6,17,41,5,175,109,1,5,19,62,6,202
2020-03-28,충남,전남,7723,62,279,289,461,210,9024,5121,41,241,213,411,147,6174
2020-03-28,충남,전북,20344,276,906,467,794,691,23478,16797,256,842,469,675,574,19613
2020-03-28,충남,충남,108646,1913,4262,3177,5284,4472,127754,108646,1913,4262,3177,5284,4472,127754
2020-03-28,충남,충북,12094,335,437,483,860,636,14845,11165,329,366,397,851,562,13670
2020-03-28,충북,강원,5558,150,153,127,256,287,6531,4724,145,145,143,276,240,5673
2020-03-28,충북,경기,29441,919,1166,1373,2596,1348,36843,33713,955,1314,1607,2189,1561,41339
2020-03-28,충북,경남,1652,25,106,281,341,73,2478,1141,15,54,114,147,44,1515
2020-03-28,충북,경북,5454,122,270,352,643,216,7057,5216,104,236,288,534,186,6564
2020-03-28,충북,광주,773,13,34,79,57,23,979,572,16,26,46,19,13,692
2020-03-28,충북,대구,930,30,72,148,108,42,1330,1376,36,79,109,154,66,1820
2020-03-28,충북,대전,9311,237,262,102,127,591,10630,10006,280,276,103,126,638,11429
2020-03-28,충북,부산,129,6,11,59,87,1,293,119,2,9,25,90,3,248
2020-03-28,충북,서울,15947,226,605,495,670,693,18636,18164,203,626,458,473,789,20713
2020-03-28,충북,세종,319,11,12,13,10,17,382,394,12,12,18,14,27,477
2020-03-28,충북,울산,11,0,3,10,20,1,45,22,1,0,8,16,1,48
2020-03-28,충북,전남,617,5,8,54,125,28,837,418,10,11,35,86,15,575
2020-03-28,충북,전북,2407,62,95,137,154,86,2941,1890,53,93,110,133,70,2349
2020-03-28,충북,충남,11165,329,366,397,851,562,13670,12094,335,437,483,860,636,14845
2020-03-28,충북,충북,33563,1090,1051,1040,2016,1698,40458,33563,1090,1051,1040,2016,1698,40458
2020-03-29,강원,강원,69758,752,1156,334,515,3767,76282,69758,752,1156,334,515,3767,76282
2020-03-29,강원,경기,42412,230,401,207,153,1594,44997,27109,144,393,155,223,1137,29161
2020-03-29,강원,경남,171,1,6,2,2,7,189,83,0,3,5,1,3,95
2020-03-29,강원,경북,516,13,9,9,3,14,564,417,11,7,12,7,12,466
2020-03-29,강원,광주,102,1,5,5,0,5,118,90,1,5,3,3,2,104
2020-03-29,강원,대구,188,0,3,3,0,8,202,197,2,1,7,1,9,217
2020-03-29,강원,대전,197,0,4,0,0,5,206,191,3,4,0,1,7,206
2020-03-29,강원,부산,3,0,0,0,0,0,3,4,0,0,0,0,0,4
2020-03-29,강원,서울,2186,6,143,1,5,77,2418,964,10,127,2,4,47,1154
2020-03-29,강원,세종,6,0,0,0,0,0,6,7,0,0,0,0,0,7
2020-03-29,강원,울산,1,0,0,0,1,0,2,3,0,0,0,0,0,3
2020-03-29,강원,전남,51,1,0,0,1,1,54,72,1,0,4,2,1,80
2020-03-29,강원,전북,147,0,2,1,3,5,158,151,1,3,8,4,5,172
2020-03-29,강원,충남,453,2,5,3,9,22,494,373,0,5,6,13,16,413
2020-03-29,강원,충북,5251,81,78,51,68,258,5787,4526,63,74,33,61,250,5007
2020-03-29,경기,강원,27109,144,393,155,223,1137,29161,42412,230,401,207,153,1594,44997
2020-03-29,경기,경기,314093,5137,5776,3405,5056,17728,351195,314093,5137,5776,3405,5056,17728,351195
2020-03-29,경기,경남,2530,16,142,140,84,100,3012,3011,18,107,127,89,135,3487
2020-03-29,경기,경북,3652,30,95,157,75,128,4137,4774,35,73,192,80,185,5339
2020-03-29,경기,광주,693,2,38,26,15,21,795,1009,6,30,30,24,30,1129
2020-03-29,경기,대구,1362,12,38,84,18,42,1556,2157,15,34,81,54,73,2414
2020-03-29,경기,대전,2061,18,79,22,7,121,2308,3088,30,84,17,6,187,3412
2020-03-29,경기,부산,219,0,10,36,20,6,291,498,6,9,24,48,17,602
2020-03-29,경기,서울,105485,1738,3310,1269,545,5772,118119,115773,1884,3419,1240,534,6406,129256
2020-03-29,경기,세종,38,0,1,1,0,5,45,37,0,3,2,0,1,43
2020-03-29,경기,울산,31,0,0,1,4,1,37,49,1,1,3,8,2,64
2020-03-29,경기,전남,755,6,42,33,23,25,884,1400,9,35,46,40,38,1568
2020-03-29,경기,전북,1398,17,50,27,25,58,1575,2586,16,42,35,25,92,2796
2020-03-29,경기,충남,39284,313,931,532,710,1904,43674,44850,332,849,440,647,1969,49087
2020-03-29,경기,충북,25603,498,581,460,509,1265,28916,32184,522,571,441,425,1495,35638
2020-03-29,경남,강원,83,0,3,5,1,3,95,171,1,6,2,2,7,189
2020-03-29,경남,경기,3011,18,107,127,89,135,3487,2530,16,142,140,84,100,3012
2020-03-29,경남,경남,160562,2399,2447,929,1338,9783,177458,160562,2399,2447,929,1338,9783,177458
2020-03-29,경남,경북,11070,128,259,169,216,559,12401,13103,216,325,214,241,662,14761
2020-03-29,경남,광주,1282,17,49,35,15,49,1447,1408,8,63,44,13,42,1578
2020-03-29,경남,대구,12708,154,238,256,340,568,14264,8571,101,207,108,49,361,9397
2020-03-29,경남,대전,1149,5,51,35,9,56,1305,1188,3,53,14,5,53,1316
2020-03-29,경남,부산,73741,646,1009,281,564,4308,80549,69119,660,1013,267,596,4292,75947
2020-03-29,경남,서울,2589,14,254,136,54,81,3128,2456,16,294,45,16,87,2914
2020-03-29,경남,세종,336,1,7,6,7,12,369,285,2,5,2,1,7,302
2020-03-29,경남,울산,9624,151,177,52,51,605,10660,9122,135,174,47,68,532,10078
2020-03-29,경남,전남,6448,73,129,107,166,279,7202,7479,84,113,90,142,318,8226
2020-03-29,경남,전북,1320,13,38,25,23,49,1468,1507,12,51,19,37,67,1693
2020-03-29,경남,충남,1720,17,30,46,46,68,1927,1516,19,41,72,76,53,1777
2020-03-29,경남,충북,1610,12,37,68,52,56,1835,1513,17,55,91,55,50,1781
2020-03-29,경북,강원,417,11,7,12,7,12,466,516,13,9,9,3,14,564
2020-03-29,경북,경기,4774,35,73,192,80,185,5339,3652,30,95,157,75,128,4137
2020-03-29,경북,경남,13103,216,325,214,241,662,14761,11070,128,259,169,216,559,12401
2020-03-29,경북,경북,71589,952,838,500,565,3298,77742,71589,952,838,500,565,3298,77742
2020-03-29,경북,광주,617,21,34,51,20,24,767,864,22,26,33,16,29,990
2020-03-29,경북,대구,62133,619,474,286,511,2601,66624,61317,656,603,313,561,2595,66045
2020-03-29,경북,대전,1919,10,26,29,17,95,2096,2081,13,28,15,10,81,2228
2020-03-29,경북,부산,5987,16,89,38,86,290,6506,6782,26,101,43,110,296,7358
2020-03-29,경북,서울,3452,26,145,144,38,121,3926,2908,30,133,51,19,115,3256
2020-03-29,경북,세종,322,2,2,3,3,18,350,345,3,4,5,1,14,372
2020-03-29,경북,울산,6631,31,49,79,194,293,7277,5905,28,43,47,189,259,6471
2020-03-29,경북,전남,1295,25,33,22,80,47,1502,1557,20,24,15,112,55,1783
2020-03-29,경북,전북,1707,27,64,29,53,58,1938,1833,27,51,38,44,64,2057
2020-03-29,경북,충남,3466,27,30,60,92,137,3812,3109,25,53,52,106,125,3470
2020-03-29,경북,충북,5666,77,97,132,139,220,6331,5153,79,124,93,119,210,5778
2020-03-29,광주,강원,90,1,5,3,3,2,104,102,1,5,5,0,5,118
2020-03-29,광주,경기,1009,6,30,30,24,30,1129,693,2,38,26,15,21,795
2020-03-29,광주,경남,1408,8,63,44,13,42,1578,1282,17,49,35,15,49,1447
2020-03-29,광주,경북,864,22,26,33,16,29,990,617,21,34,51,20,24,767
2020-03-29,광주,광주,12641,160,357,85,44,422,13709,12641,160,357,85,44,422,13709
2020-03-29,광주,대구,478,7,37,47,6,13,588,337,6,49,24,2,14,432
2020-03-29,광주,대전,526,4,1,3,6,21,561,504,5,1,2,4,12,528
2020-03-29,광주,부산,439,2,21,10,9,11,492,465,2,32,10,8,14,531
2020-03-29,광주,서울,995,8,12,18,6,30,1069,655,12,4,8,4,19,702
2020-03-29,광주,세종,282,0,3,0,1,8,294,209,1,2,0,2,5,219
2020-03-29,광주,울산,62,0,5,0,0,4,71,34,0,6,1,1,2,44
2020-03-29,광주,전남,39208,297,560,162,134,1228,41589,40376,302,484,241,134,1345,42882
2020-03-29,광주,전북,8192,108,158,62,37,254,8811,8344,109,173,74,34,271,9005
2020-03-29,광주,충남,6076,42,263,118,86,175,6760,4077,29,293,120,41,131,4691
2020-03-29,광주,충북,732,7,20,24,8,28,819,571,7,22,24,9,13,646
2020-03-29,대구,강원,197,2,1,7,1,9,217,188,0,3,3,0,8,202
2020-03-29,대구,경기,2157,15,34,81,54,73,2414,1362,12,38,84,18,42,1556
2020-03-29,대구,경남,8571,101,207,108,49,361,9397,12708,154,238,256,340,568,14264
2020-03-29,대구,경북,61317,656,603,313,561,2595,66045,62133,619,474,286,511,2601,66624
2020-03-29,대구,광주,337,6,49,24,2,14,432,478,7,37,47,6,13,588
2020-03-29,대구,대구,36411,463,340,161,170,1888,39433,36411,463,340,161,170,1888,39433
2020-03-29,대구,대전,739,3,12,12,8,25,799,532,2,7,8,5,30,584
2020-03-29,대구,부산,506,4,40,22,11,24,607,3584,17,90,30,20,134,3875
2020-03-29,대구,서울,1752,19,49,53,29,58,1960,1419,11,31,21,8,43,1533
2020-03-29,대구,세종,242,1,1,3,0,12,259,123,0,0,2,2,7,134
2020-03-29,대구,울산,978,6,25,7,46,50,1112,1009,6,29,10,38,52,1144
2020-03-29,대구,전남,808,3,17,6,4,24,862,958,6,18,12,8,28,1030
2020-03-29,대구,전북,305,1,8,5,3,10,332,375,2,11,8,2,8,406
2020-03-29,대구,충남,1242,10,15,30,35,47,1379,771,8,14,33,19,26,871
2020-03-29,대구,충북,1446,15,45,59,56,52,1673,1015,11,27,48,22,49,1172
2020-03-29,대전,강원,191,3,4,0,1,7,206,197,0,4,0,0,5,206
2020-03-29,대전,경기,3088,30,84,17,6,187,3412,2061,18,79,22,7,121,2308
2020-03-29,대전,경남,1188,3,53,14,5,53,1316,1149,5,51,35,9,56,1305
2020-03-29,대전,경북,2081,13,28,15,10,81,2228,1919,10,26,29,17,95,2096
2020-03-29,대전,광주,504,5,1,2,4,12,528,526,4,1,3,6,21,561
2020-03-29,대전,대구,532,2,7,8,5,30,584,739,3,12,12,8,25,799
2020-03-29,대전,대전,10474,105,127,53,30,663,11452,10474,105,127,53,30,663,11452
2020-03-29,대전,부산,81,0,0,2,1,1,85,110,0,2,1,2,4,119
2020-03-29,대전,서울,2428,9,110,3,1,111,2662,1907,8,107,8,2,85,2117
2020-03-29,대전,세종,2250,38,18,2,9,149,2466,1946,37,13,9,11,120,2136
2020-03-29,대전,울산,137,0,3,2,5,7,154,95,0,1,1,2,4,103
2020-03-29,대전,전남,522,5,2,4,3,13,549,637,0,3,3,2,19,664
2020-03-29,대전,전북,3556,18,42,7,7,161,3791,4072,24,33,18,12,173,4332
2020-03-29,대전,충남,13333,131,172,34,36,718,14424,12600,146,165,46,28,682,13667
2020-03-29,대전,충북,9058,137,176,35,26,543,9975,8098,118,170,31,21,481,8919
2020-03-29,부산,강원,4,0,0,0,0,0,4,3,0,0,0,0,0,3
2020-03-29,부산,경기,498,6,9,24,48,17,602,219,0,10,36,20,6,291
2020-03-29,부산,경남,69119,660,1013,267,596,4292,75947,73741,646,1009,281,564,4308,80549
2020-03-29,부산,경북,6782,26,101,43,110,296,7358,5987,16,89,38,86,290,6506
2020-03-29,부산,광주,465,2,32,10,8,14,531,439,2,21,10,9,11,492
2020-03-29,부산,대구,3584,17,90,30,20,134,3875,506,4,40,22,11,24,607
2020-03-29,부산,대전,110,0,2,1,2,4,119,81,0,0,2,1,1,85
2020-03-29,부산,부산,44430,152,117,86,201,2451,47437,44430,152,117,86,201,2451,47437
2020-03-29,부산,서울,387,0,11,22,6,10,436,231,1,7,13,6,3,261
2020-03-29,부산,세종,45,0,1,0,2,2,50,28,0,1,0,0,2,31
2020-03-29,부산,울산,16666,79,82,65,239,1026,18157,15344,83,61,53,248,966,16755
2020-03-29,부산,전남,2059,12,57,27,119,107,2381,1968,11,41,52,106,63,2241
2020-03-29,부산,전북,332,3,20,0,13,9,377,336,2,16,9,12,15,390
2020-03-29,부산,충남,266,2,4,6,24,11,313,149,1,1,3,21,7,182
2020-03-29,부산,충북,183,2,2,6,30,5,228,110,4,4,22,17,11,168
2020-03-29,서울,강원,964,10,127,2,4,47,1154,2186,6,143,1,5,77,2418
2020-03-29,서울,경기,115773,1884,3419,1240,534,6406,129256,105485,1738,3310,1269,545,5772,118119
2020-03-29,서울,경남,2456,16,294,45,16,87,2914,2589,14,254,136,54,81,3128
2020-03-29,서울,경북,2908,30,133,51,19,115,3256,3452,26,145,144,38,121,3926
2020-03-29,서울,광주,655,12,4,8,4,19,702,995,8,12,18,6,30,1069
2020-03-29,서울,대구,1419,11,31,21,8,43,1533,1752,19,49,53,29,58,1960
2020-03-29,서울,대전,1907,8,107,8,2,85,2117,2428,9,110,3,1,111,2662
2020-03-29,서울,부산,231,1,7,13,6,3,261,387,0,11,22,6,10,436
2020-03-29,서울,서울,176,2,7,0,0,10,195,176,2,7,0,0,10,195
2020-03-29,서울,세종,20,0,0,1,0,3,24,27,1,0,0,0,0,28
2020-03-29,서울,울산,25,0,5,0,0,0,30,18,0,1,1,1,0,21
2020-03-29,서울,전남,848,3,13,12,5,31,912,1695,7,19,45,12,48,1826
2020-03-29,서울,전북,1262,7,15,5,4,45,1338,2524,8,26,14,6,78,2656
2020-03-29,서울,충남,34256,159,1344,223,157,1382,37521,40769,173,1260,528,246,1490,44466
2020-03-29,서울,충북,15366,103,512,205,130,663,16979,16836,124,507,205,128,714,18514
2020-03-29,세종,강원,7,0,0,0,0,0,7,6,0,0,0,0,0,6
2020-03-29,세종,경기,37,0,3,2,0,1,43,38,0,1,1,0,5,45
2020-03-29,세종,경남,285,2,5,2,1,7,302,336,1,7,6,7,12,369
2020-03-29,세종,경북,345,3,4,5,1,14,372,322,2,2,3,3,18,350
2020-03-29,세종,광주,209,1,2,0,2,5,219,282,0,3,0,1,8,294
2020-03-29,세종,대구,123,0,0,2,2,7,134,242,1,1,3,0,12,259
2020-03-29,세종,대전,1946,37,13,9,11,120,2136,2250,38,18,2,9,149,2466
2020-03-29,세종,부산,28,0,1,0,0,2,31,45,0,1,0,2,2,50
2020-03-29,세종,서울,27,1,0,0,0,0,28,20,0,0,1,0,3,24
2020-03-29,세종,세종,215,6,3,1,0,11,236,215,6,3,1,0,11,236
2020-03-29,세종,울산,13,0,0,0,0,1,14,13,1,0,0,0,1,15
2020-03-29,세종,전남,224,0,2,1,1,8,236,343,0,1,3,1,7,355
2020-03-29,세종,전북,901,1,9,5,15,23,954,1223,3,5,2,18,28,1279
2020-03-29,세종,충남,5649,52,67,36,25,225,6054,5680,46,69,42,32,222,6091
2020-03-29,세종,충북,373,6,6,3,1,21,410,384,6,6,2,3,37,438
2020-03-29,울산,강원,3,0,0,0,0,0,3,1,0,0,0,1,0,2
2020-03-29,울산,경기,49,1,1,3,8,2,64,31,0,0,1,4,1,37
2020-03-29,울산,경남,9122,135,174,47,68,532,10078,9624,151,177,52,51,605,10660
2020-03-29,울산,경북,5905,28,43,47,189,259,6471,6631,31,49,79,194,293,7277
2020-03-29,울산,광주,34,0,6,1,1,2,44,62,0,5,0,0,4,71
2020-03-29,울산,대구,1009,6,29,10,38,52,1144,978,6,25,7,46,50,1112
2020-03-29,울산,대전,95,0,1,1,2,4,103,137,0,3,2,5,7,154
2020-03-29,울산,부산,15344,83,61,53,248,966,16755,16666,79,82,65,239,1026,18157
2020-03-29,울산,서울,18,0,1,1,1,0,21,25,0,5,0,0,0,30
2020-03-29,울산,세종,13,1,0,0,0,1,15,13,0,0,0,0,1,14
2020-03-29,울산,울산,5560,35,96,41,95,401,6228,5560,35,96,41,95,401,6228
2020-03-29,울산,전남,255,1,2,3,7,4,272,224,1,5,0,3,7,240
2020-03-29,울산,전북,50,2,5,0,9,1,67,71,0,7,1,1,1,81
2020-03-29,울산,충남,172,1,3,4,26,4,210,139,3,0,4,18,9,173
2020-03-29,울산,충북,23,1,2,3,6,0,35,21,0,0,1,9,1,32
2020-03-29,전남,강원,72,1,0,4,2,1,80,51,1,0,0,1,1,54
2020-03-29,전남,경기,1400,9,35,46,40,38,1568,755,6,42,33,23,25,884
2020-03-29,전남,경남,7479,84,113,90,142,318,8226,6448,73,129,107,166,279,7202
2020-03-29,전남,경북,1557,20,24,15,112,55,1783,1295,25,33,22,80,47,1502
2020-03-29,전남,광주,40376,302,484,241,134,1345,42882,39208,297,560,162,134,1228,41589
2020-03-29,전남,대구,958,6,18,12,8,28,1030,808,3,17,6,4,24,862
2020-03-29,전남,대전,637,0,3,3,2,19,664,522,5,2,4,3,13,549
2020-03-29,전남,부산,1968,11,41,52,106,63,2241,2059,12,57,27,119,107,2381
2020-03-29,전남,서울,1695,7,19,45,12,48,1826,848,3,13,12,5,31,912
2020-03-29,전남,세종,343,0,1,3,1,7,355,224,0,2,1,1,8,236
2020-03-29,전남,울산,224,1,5,0,3,7,240,255,1,2,3,7,4,272
2020-03-29,전남,전남,51523,501,643,402,808,1664,55541,51523,501,643,402,808,1664,55541
2020-03-29,전남,전북,8009,95,145,169,253,206,8877,7255,83,138,93,241,226,8036
2020-03-29,전남,충남,9175,42,270,405,355,286,10533,5176,28,271,103,168,168,5914
2020-03-29,전남,충북,656,8,4,31,32,19,750,481,1,11,16,35,16,560
2020-03-29,전북,강원,151,1,3,8,4,5,172,147,0,2,1,3,5,158
2020-03-29,전북,경기,2586,16,42,35,25,92,2796,1398,17,50,27,25,58,1575
2020-03-29,전북,경남,1507,12,51,19,37,67,1693,1320,13,38,25,23,49,1468
2020-03-29,전북,경북,1833,27,51,38,44,64,2057,1707,27,64,29,53,58,1938
2020-03-29,전북,광주,8344,109,173,74,34,271,9005,8192,108,158,62,37,254,8811
2020-03-29,전북,대구,375,2,11,8,2,8,406,305,1,8,5,3,10,332
2020-03-29,전북,대전,4072,24,33,18,12,173,4332,3556,18,42,7,7,161,3791
2020-03-29,전북,부산,336,2,16,9,12,15,390,332,3,20,0,13,9,377
2020-03-29,전북,서울,2524,8,26,14,6,78,2656,1262,7,15,5,4,45,1338
2020-03-29,전북,세종,1223,3,5,2,18,28,1279,901,1,9,5,15,23,954
2020-03-29,전북,울산,71,0,7,1,1,1,81,50,2,5,0,9,1,67
2020-03-29,전북,전남,7255,83,138,93,241,226,8036,8009,95,145,169,253,206,8877
2020-03-29,전북,전북,15668,184,279,106,78,489,16804,15668,184,279,106,78,489,16804
2020-03-29,전북,충남,22406,144,658,290,309,829,24636,15233,123,630,181,234,545,16946
2020-03-29,전북,충북,2488,44,42,98,53,86,2811,1781,36,40,77,41,68,2043
2020-03-29,충남,강원,373,0,5,6,13,16,413,453,2,5,3,9,22,494
2020-03-29,충남,경기,44850,332,849,440,647,1969,49087,39284,313,931,532,710,1904,43674
2020-03-29,충남,경남,1516,19,41,72,76,53,1777,1720,17,30,46,46,68,1927
2020-03-29,충남,경북,3109,25,53,52,106,125,3470,3466,27,30,60,92,137,3812
2020-03-29,충남,광주,4077,29,293,120,41,131,4691,6076,42,263,118,86,175,6760
2020-03-29,충남,대구,771,8,14,33,19,26,871,1242,10,15,30,35,47,1379
2020-03-29,충남,대전,12600,146,165,46,28,682,13667,13333,131,172,34,36,718,14424
2020-03-29,충남,부산,149,1,1,3,21,7,182,266,2,4,6,24,11,313
2020-03-29,충남,서울,40769,173,1260,528,246,1490,44466,34256,159,1344,223,157,1382,37521
2020-03-29,충남,세종,5680,46,69,42,32,222,6091,5649,52,67,36,25,225,6054
2020-03-29,충남,울산,139,3,0,4,18,9,173,172,1,3,4,26,4,210
2020-03-29,충남,전남,5176,28,271,103,168,168,5914,9175,42,270,405,355,286,10533
2020-03-29,충남,전북,15233,123,630,181,234,545,16946,22406,144,658,290,309,829,24636
2020-03-29,충남,충남,109344,997,3067,1627,1738,4521,121294,109344,997,3067,1627,1738,4521,121294
2020-03-29,충남,충북,10663,150,219,198,255,541,12026,10267,139,211,153,294,528,11592
2020-03-29,충북,강원,4526,63,74,33,61,250,5007,5251,81,78,51,68,258,5787
2020-03-29,충북,경기,32184,522,571,441,425,1495,35638,25603,498,581,460,509,1265,28916
2020-03-29,충북,경남,1513,17,55,91,55,50,1781,1610,12,37,68,52,56,1835
2020-03-29,충북,경북,5153,79,124,93,119,210,5778,5666,77,97,132,139,220,6331
2020-03-29,충북,광주,571,7,22,24,9,13,646,732,7,20,24,8,28,819
2020-03-29,충북,대구,1015,11,27,48,22,49,1172,1446,15,45,59,56,52,1673
2020-03-29,충북,대전,8098,118,170,31,21,481,8919,9058,137,176,35,26,543,9975
2020-03-29,충북,부산,110,4,4,22,17,11,168,183,2,2,6,30,5,228
2020-03-29,충북,서울,16836,124,507,205,128,714,18514,15366,103,512,205,130,663,16979
2020-03-29,충북,세종,384,6,6,2,3,37,438,373,6,6,3,1,21,410
2020-03-29,충북,울산,21,0,0,1,9,1,32,23,1,2,3,6,0,35
2020-03-29,충북,전남,481,1,11,16,35,16,560,656,8,4,31,32,19,750
2020-03-29,충북,전북,1781,36,40,77,41,68,2043,2488,44,42,98,53,86,2811
2020-03-29,충북,충남,10267,139,211,153,294,528,11592,10663,150,219,198,255,541,12026
2020-03-29,충북,충북,30685,463,496,352,436,1575,34007,30685,463,496,352,436,1575,34007
2020-03-30,강원,강원,63624,2330,2347,1407,3135,4339,77182,63624,2330,2347,1407,3135,4339,77182
2020-03-30,강원,경기,22388,601,820,645,735,1067,26256,21187,664,831,692,956,1057,25387
2020-03-30,강원,경남,169,2,16,11,14,4,216,123,1,6,12,15,2,159
2020-03-30,강원,경북,382,18,16,18,17,14,465,345,19,14,37,25,23,463
2020-03-30,강원,광주,81,3,9,2,6,1,102,71,6,5,10,4,2,98
2020-03-30,강원,대구,120,2,6,5,12,1,146,228,10,14,19,17,11,299
2020-03-30,강원,대전,150,3,8,4,0,9,174,182,2,7,4,2,7,204
2020-03-30,강원,부산,2,0,0,0,1,0,3,5,0,0,0,0,1,6
2020-03-30,강원,서울,783,9,124,14,22,32,984,985,21,143,15,15,46,1225
2020-03-30,강원,세종,6,0,0,1,0,0,7,8,0,0,0,0,1,9
2020-03-30,강원,울산,2,0,1,0,0,0,3,0,0,0,0,0,0,0
2020-03-30,강원,전남,51,0,0,4,14,2,71,51,0,3,9,26,4,93
2020-03-30,강원,전북,103,2,5,8,15,2,135,110,9,14,20,11,2,166
2020-03-30,강원,충남,319,6,16,25,43,12,421,419,8,22,28,76,14,567
2020-03-30,강원,충북,4634,238,246,271,458,292,6139,4592,196,225,194,427,255,5889
2020-03-30,경기,강원,21187,664,831,692,956,1057,25387,22388,601,820,645,735,1067,26256
2020-03-30,경기,경기,430102,22891,23285,18953,24717,31537,551485,430102,22891,23285,18953,24717,31537,551485
2020-03-30,경기,경남,2552,75,240,424,401,99,3791,2029,54,179,361,358,75,3056
2020-03-30,경기,경북,3841,190,409,613,468,135,5656,3320,183,379,794,526,114,5316
2020-03-30,경기,광주,706,21,105,254,132,19,1237,737,16,85,228,130,25,1221
2020-03-30,경기,대구,1416,70,136,258,150,53,2083,2244,91,145,350,371,72,3273
2020-03-30,경기,대전,1936,87,148,78,46,118,2413,2415,97,134,70,57,116,2889
2020-03-30,경기,부산,230,16,17,76,94,7,440,280,23,30,76,180,7,596
2020-03-30,경기,서울,144814,7188,8218,4784,3978,9711,178693,150405,6658,8448,4843,3540,9903,183797
2020-03-30,경기,세종,28,2,4,1,3,1,39,41,2,3,0,4,2,52
2020-03-30,경기,울산,27,1,0,3,9,1,41,30,2,3,14,48,0,97
2020-03-30,경기,전남,729,20,90,138,136,25,1138,742,16,50,118,105,22,1053
2020-03-30,경기,전북,1202,59,127,117,159,51,1715,1315,45,101,149,189,61,1860
2020-03-30,경기,충남,40489,1576,2627,2394,4417,2095,53598,37384,1493,2498,2252,4127,2017,49771
2020-03-30,경기,충북,29306,2145,2747,3054,3573,1405,42230,26921,2113,2648,2718,3866,1382,39648
2020-03-30,경남,강원,123,1,6,12,15,2,159,169,2,16,11,14,4,216
2020-03-30,경남,경기,2029,54,179,361,358,75,3056,2552,75,240,424,401,99,3791
2020-03-30,경남,경남,191667,9984,9485,6944,12945,14390,245415,191667,9984,9485,6944,12945,14390,245415
2020-03-30,경남,경북,9377,627,882,881,1879,481,14127,10726,886,1079,1134,2500,515,16840
2020-03-30,경남,광주,993,46,103,167,111,31,1451,1078,37,123,143,100,32,1513
2020-03-30,경남,대구,10852,727,740,904,1711,458,15392,8252,475,480,403,515,367,10492
2020-03-30,경남,대전,679,22,83,66,37,27,914,966,16,74,75,47,42,1220
2020-03-30,경남,부산,83782,2677,2442,1581,4322,5964,100768,84929,2747,2671,1716,4734,6119,102916
2020-03-30,경남,서울,1949,33,281,219,123,71,2676,2598,40,288,99,63,85,3173
2020-03-30,경남,세종,155,3,5,18,14,3,198,259,3,16,14,17,7,316
2020-03-30,경남,울산,9538,646,606,433,693,591,12507,8882,595,667,408,717,553,11822
2020-03-30,경남,전남,5990,262,420,424,1320,279,8695,5759,272,402,361,1252,270,8316
2020-03-30,경남,전북,1117,41,109,94,182,29,1572,1071,36,125,90,173,35,1530
2020-03-30,경남,충남,1259,57,104,232,231,35,1918,1375,56,116,233,350,41,2171
2020-03-30,경남,충북,1058,36,136,217,243,41,1731,1209,79,164,321,455,40,2268
2020-03-30,경북,강원,345,19,14,37,25,23,463,382,18,16,18,17,14,465
2020-03-30,경북,경기,3320,183,379,794,526,114,5316,3841,190,409,613,468,135,5656
2020-03-30,경북,경남,10726,886,1079,1134,2500,515,16840,9377,627,882,881,1879,481,14127
2020-03-30,경북,경북,69210,3878,3799,2942,5457,3664,88950,69210,3878,3799,2942,5457,3664,88950
2020-03-30,경북,광주,613,50,113,182,119,22,1099,715,39,93,167,82,23,1119
2020-03-30,경북,대구,66130,2862,2212,1601,3401,3518,79724,72536,3063,2517,1972,3957,3681,87726
2020-03-30,경북,대전,1451,49,74,101,64,70,1809,1714,54,77,91,73,74,2083
2020-03-30,경북,부산,3804,98,184,185,677,191,5139,4876,126,203,200,766,265,6436
2020-03-30,경북,서울,2321,86,215,341,146,72,3181,2848,65,201,182,75,84,3455
2020-03-30,경북,세종,224,5,20,20,14,10,293,276,7,18,26,10,7,344
2020-03-30,경북,울산,5120,165,287,479,977,330,7358,4927,161,263,329,1320,300,7300
2020-03-30,경북,전남,982,53,62,120,430,35,1682,979,71,78,98,554,33,1813
2020-03-30,경북,전북,1688,88,164,194,278,53,2465,1491,88,149,187,249,54,2218
2020-03-30,경북,충남,2938,131,332,522,535,101,4559,2954,156,304,434,673,105,4626
2020-03-30,경북,충북,4389,252,460,683,995,180,6959,4522,258,451,569,1026,164,6990
2020-03-30,광주,강원,71,6,5,10,4,2,98,81,3,9,2,6,1,102
2020-03-30,광주,경기,737,16,85,228,130,25,1221,706,21,105,254,132,19,1237
2020-03-30,광주,경남,1078,37,123,143,100,32,1513,993,46,103,167,111,31,1451
2020-03-30,광주,경북,715,39,93,167,82,23,1119,613,50,113,182,119,22,1099
2020-03-30,광주,광주,13360,468,572,362,430,521,15713,13360,468,572,362,430,521,15713
2020-03-30,광주,대구,461,24,56,72,29,15,657,479,30,45,62,43,13,672
2020-03-30,광주,대전,393,15,19,16,9,8,460,426,13,14,13,16,12,494
2020-03-30,광주,부산,347,9,31,33,63,13,496,366,17,41,79,78,13,594
2020-03-30,광주,서울,632,16,14,62,38,17,779,668,16,18,25,15,26,768
2020-03-30,광주,세종,150,2,8,5,0,1,166,145,3,5,4,0,2,159
2020-03-30,광주,울산,59,2,6,2,6,0,75,54,0,6,2,5,0,67
2020-03-30,광주,전남,35339,1011,1055,734,2012,1371,41522,32361,968,915,638,1910,1284,38076
2020-03-30,광주,전북,7768,427,490,359,405,294,9743,7194,461,452,334,394,289,9124
2020-03-30,광주,충남,4253,118,412,444,262,140,5629,3890,130,394,506,279,120,5319
2020-03-30,광주,충북,609,21,53,125,69,17,894,535,26,65,161,77,8,872
2020-03-30,대구,강원,228,10,14,19,17,11,299,120,2,6,5,12,1,146
2020-03-30,대구,경기,2244,91,145,350,371,72,3273,1416,70,136,258,150,53,2083
2020-03-30,대구,경남,8252,475,480,403,515,367,10492,10852,727,740,904,1711,458,15392
2020-03-30,대구,경북,72536,3063,2517,1972,3957,3681,87726,66130,2862,2212,1601,3401,3518,79724
2020-03-30,대구,광주,479,30,45,62,43,13,672,461,24,56,72,29,15,657
2020-03-30,대구,대구,57777,2181,1538,892,1156,3757,67301,57777,2181,1538,892,1156,3757,67301
2020-03-30,대구,대전,712,36,24,52,37,25,886,465,21,19,24,24,16,569
2020-03-30,대구,부산,520,50,85,65,150,15,885,2629,113,113,80,258,96,3289
2020-03-30,대구,서울,1981,47,70,182,100,74,2454,1349,44,48,63,19,53,1576
2020-03-30,대구,세종,206,3,14,10,5,6,244,137,5,10,3,3,6,164
2020-03-30,대구,울산,1068,55,70,76,157,41,1467,876,47,78,65,166,43,1275
2020-03-30,대구,전남,520,13,26,29,43,14,645,413,12,20,21,41,13,520
2020-03-30,대구,전북,295,10,19,14,20,10,368,268,10,26,17,23,8,352
2020-03-30,대구,충남,1208,76,138,172,266,49,1909,737,53,108,140,143,16,1197
2020-03-30,대구,충북,1436,112,145,231,338,34,2296,903,83,115,158,133,27,1419
2020-03-30,대전,강원,182,2,7,4,2,7,204,150,3,8,4,0,9,174
2020-03-30,대전,경기,2415,97,134,70,57,116,2889,1936,87,148,78,46,118,2413
2020-03-30,대전,경남,966,16,74,75,47,42,1220,679,22,83,66,37,27,914
2020-03-30,대전,경북,1714,54,77,91,73,74,2083,1451,49,74,101,64,70,1809
2020-03-30,대전,광주,426,13,14,13,16,12,494,393,15,19,16,9,8,460
2020-03-30,대전,대구,465,21,19,24,24,16,569,712,36,24,52,37,25,886
2020-03-30,대전,대전,13701,405,387,454,242,1061,16250,13701,405,387,454,242,1061,16250
2020-03-30,대전,부산,59,1,7,14,15,1,97,75,7,4,7,21,2,116
2020-03-30,대전,서울,1907,31,118,32,23,82,2193,1795,44,116,26,9,58,2048
2020-03-30,대전,세종,3295,123,85,32,55,253,3843,3344,115,76,40,59,277,3911
2020-03-30,대전,울산,111,1,5,9,23,2,151,75,5,3,10,21,1,115
2020-03-30,대전,전남,409,10,3,20,20,11,473,303,6,6,21,24,8,368
2020-03-30,대전,전북,3277,90,74,43,75,137,3696,2852,99,92,62,65,130,3300
2020-03-30,대전,충남,16883,467,525,387,327,1250,19839,14286,420,456,381,288,1080,16911
2020-03-30,대전,충북,11121,463,420,202,183,835,13224,9632,396,358,176,159,722,11443
2020-03-30,부산,강원,5,0,0,0,0,1,6,2,0,0,0,1,0,3
2020-03-30,부산,경기,280,23,30,76,180,7,596,230,16,17,76,94,7,440
2020-03-30,부산,경남,84929,2747,2671,1716,4734,6119,102916,83782,2677,2442,1581,4322,5964,100768
2020-03-30,부산,경북,4876,126,203,200,766,265,6436,3804,98,184,185,677,191,5139
2020-03-30,부산,광주,366,17,41,79,78,13,594,347,9,31,33,63,13,496
2020-03-30,부산,대구,2629,113,113,80,258,96,3289,520,50,85,65,150,15,885
2020-03-30,부산,대전,75,7,4,7,21,2,116,59,1,7,14,15,1,97
2020-03-30,부산,부산,40280,662,572,774,1941,3074,47303,40280,662,572,774,1941,3074,47303
2020-03-30,부산,서울,205,12,6,55,58,7,343,173,9,5,29,36,10,262
2020-03-30,부산,세종,14,0,3,4,1,1,23,21,3,1,3,1,0,29
2020-03-30,부산,울산,16047,372,466,613,2367,1172,21037,14712,395,400,393,2320,1142,19362
2020-03-30,부산,전남,1909,82,110,187,499,70,2857,1584,72,90,104,532,56,2438
2020-03-30,부산,전북,288,9,19,28,81,8,433,224,8,18,29,73,7,359
2020-03-30,부산,충남,193,11,17,61,141,4,427,147,11,16,38,157,3,372
2020-03-30,부산,충북,122,9,26,68,144,7,376,79,10,21,72,152,5,339
2020-03-30,서울,강원,985,21,143,15,15,46,1225,783,9,124,14,22,32,984
2020-03-30,서울,경기,150405,6658,8448,4843,3540,9903,183797,144814,7188,8218,4784,3978,9711,178693
2020-03-30,서울,경남,2598,40,288,99,63,85,3173,1949,33,281,219,123,71,2676
2020-03-30,서울,경북,2848,65,201,182,75,84,3455,2321,86,215,341,146,72,3181
2020-03-30,서울,광주,668,16,18,25,15,26,768,632,16,14,62,38,17,779
2020-03-30,서울,대구,1349,44,48,63,19,53,1576,1981,47,70,182,100,74,2454
2020-03-30,서울,대전,1795,44,116,26,9,58,2048,1907,31,118,32,23,82,2193
2020-03-30,서울,부산,173,9,5,29,36,10,262,205,12,6,55,58,7,343
2020-03-30,서울,서울,186,3,16,2,4,11,222,186,3,16,2,4,11,222
2020-03-30,서울,세종,25,0,0,0,0,1,26,27,0,3,1,0,1,32
2020-03-30,서울,울산,32,0,3,1,1,0,37,22,1,1,5,7,0,36
2020-03-30,서울,전남,845,6,14,34,11,20,930,838,13,16,59,43,29,998
2020-03-30,서울,전북,1246,13,48,22,37,41,1407,1263,21,37,34,32,43,1430
2020-03-30,서울,충남,28614,501,1687,767,702,1140,33411,27035,608,1678,1215,1173,1093,32802
2020-03-30,서울,충북,15909,541,901,779,696,661,19487,13422,633,879,774,912,579,17199
2020-03-30,세종,강원,8,0,0,0,0,1,9,6,0,0,1,0,0,7
2020-03-30,세종,경기,41,2,3,0,4,2,52,28,2,4,1,3,1,39
2020-03-30,세종,경남,259,3,16,14,17,7,316,155,3,5,18,14,3,198
2020-03-30,세종,경북,276,7,18,26,10,7,344,224,5,20,20,14,10,293
2020-03-30,세종,광주,145,3,5,4,0,2,159,150,2,8,5,0,1,166
2020-03-30,세종,대구,137,5,10,3,3,6,164,206,3,14,10,5,6,244
2020-03-30,세종,대전,3344,115,76,40,59,277,3911,3295,123,85,32,55,253,3843
2020-03-30,세종,부산,21,3,1,3,1,0,29,14,0,3,4,1,1,23
2020-03-30,세종,서울,27,0,3,1,0,1,32,25,0,0,0,0,1,26
2020-03-30,세종,세종,194,26,2,2,2,17,243,194,26,2,2,2,17,243
2020-03-30,세종,울산,9,0,0,1,0,0,10,6,0,0,0,5,0,11
2020-03-30,세종,전남,156,1,5,9,14,1,186,137,2,3,4,19,5,170
2020-03-30,세종,전북,717,22,16,20,28,24,827,638,17,18,13,42,22,750
2020-03-30,세종,충남,6118,155,143,110,194,335,7055,4227,142,134,104,179,207,4993
2020-03-30,세종,충북,369,15,19,18,6,34,461,307,21,23,17,22,28,418
2020-03-30,울산,강원,0,0,0,0,0,0,0,2,0,1,0,0,0,3
2020-03-30,울산,경기,30,2,3,14,48,0,97,27,1,0,3,9,1,41
2020-03-30,울산,경남,8882,595,667,408,717,553,11822,9538,646,606,433,693,591,12507
2020-03-30,울산,경북,4927,161,263,329,1320,300,7300,5120,165,287,479,977,330,7358
2020-03-30,울산,광주,54,0,6,2,5,0,67,59,2,6,2,6,0,75
2020-03-30,울산,대구,876,47,78,65,166,43,1275,1068,55,70,76,157,41,1467
2020-03-30,울산,대전,75,5,3,10,21,1,115,111,1,5,9,23,2,151
2020-03-30,울산,부산,14712,395,400,393,2320,1142,19362,16047,372,466,613,2367,1172,21037
2020-03-30,울산,서울,22,1,1,5,7,0,36,32,0,3,1,1,0,37
2020-03-30,울산,세종,6,0,0,0,5,0,11,9,0,0,1,0,0,10
2020-03-30,울산,울산,8137,303,457,275,628,723,10523,8137,303,457,275,628,723,10523
2020-03-30,울산,전남,183,8,16,17,27,8,259,163,16,24,10,48,1,262
2020-03-30,울산,전북,28,2,5,2,13,1,51,42,1,4,1,5,2,55
2020-03-30,울산,충남,180,2,17,35,82,7,323,138,5,6,25,71,3,248
2020-03-30,울산,충북,14,1,2,14,36,0,67,21,0,4,13,28,2,68
2020-03-30,전남,강원,51,0,3,9,26,4,93,51,0,0,4,14,2,71
2020-03-30,전남,경기,742,16,50,118,105,22,1053,729,20,90,138,136,25,1138
2020-03-30,전남,경남,5759,272,402,361,1252,270,8316,5990,262,420,424,1320,279,8695
2020-03-30,전남,경북,979,71,78,98,554,33,1813,982,53,62,120,430,35,1682
2020-03-30,전남,광주,32361,968,915,638,1910,1284,38076,35339,1011,1055,734,2012,1371,41522
2020-03-30,전남,대구,413,12,20,21,41,13,520,520,13,26,29,43,14,645
2020-03-30,전남,대전,303,6,6,21,24,8,368,409,10,3,20,20,11,473
2020-03-30,전남,부산,1584,72,90,104,532,56,2438,1909,82,110,187,499,70,2857
2020-03-30,전남,서울,838,13,16,59,43,29,998,845,6,14,34,11,20,930
2020-03-30,전남,세종,137,2,3,4,19,5,170,156,1,5,9,14,1,186
2020-03-30,전남,울산,163,16,24,10,48,1,262,183,8,16,17,27,8,259
2020-03-30,전남,전남,45204,1346,1380,1728,4756,1732,56146,45204,1346,1380,1728,4756,1732,56146
2020-03-30,전남,전북,5027,289,515,505,1313,160,7809,5153,230,494,594,1322,172,7965
2020-03-30,전남,충남,4683,111,329,607,1071,140,6941,4453,94,316,434,835,162,6294
2020-03-30,전남,충북,357,15,25,96,197,7,697,404,24,32,89,211,19,779
2020-03-30,전북,강원,110,9,14,20,11,2,166,103,2,5,8,15,2,135
2020-03-30,전북,경기,1315,45,101,149,189,61,1860,1202,59,127,117,159,51,1715
2020-03-30,전북,경남,1071,36,125,90,173,35,1530,1117,41,109,94,182,29,1572
2020-03-30,전북,경북,1491,88,149,187,249,54,2218,1688,88,164,194,278,53,2465
2020-03-30,전북,광주,7194,461,452,334,394,289,9124,7768,427,490,359,405,294,9743
2020-03-30,전북,대구,268,10,26,17,23,8,352,295,10,19,14,20,10,368
2020-03-30,전북,대전,2852,99,92,62,65,130,3300,3277,90,74,43,75,137,3696
2020-03-30,전북,부산,224,8,18,29,73,7,359,288,9,19,28,81,8,433
2020-03-30,전북,서울,1263,21,37,34,32,43,1430,1246,13,48,22,37,41,1407
2020-03-30,전북,세종,638,17,18,13,42,22,750,717,22,16,20,28,24,827
2020-03-30,전북,울산,42,1,4,1,5,2,55,28,2,5,2,13,1,51
2020-03-30,전북,전남,5153,230,494,594,1322,172,7965,5027,289,515,505,1313,160,7809
2020-03-30,전북,전북,16092,643,907,827,854,644,19967,16092,643,907,827,854,644,19967
2020-03-30,전북,충남,13817,536,1293,1114,1445,515,18720,13169,507,1256,908,1376,463,17679
2020-03-30,전북,충북,1728,129,169,238,306,59,2629,1701,133,221,253,248,59,2615
2020-03-30,충남,강원,419,8,22,28,76,14,567,319,6,16,25,43,12,421
2020-03-30,충남,경기,37384,1493,2498,2252,4127,2017,49771,40489,1576,2627,2394,4417,2095,53598
2020-03-30,충남,경남,1375,56,116,233,350,41,2171,1259,57,104,232,231,35,1918
2020-03-30,충남,경북,2954,156,304,434,673,105,4626,2938,131,332,522,535,101,4559
2020-03-30,충남,광주,3890,130,394,506,279,120,5319,4253,118,412,444,262,140,5629
2020-03-30,충남,대구,737,53,108,140,143,16,1197,1208,76,138,172,266,49,1909
2020-03-30,충남,대전,14286,420,456,381,288,1080,16911,16883,467,525,387,327,1250,19839
2020-03-30,충남,부산,147,11,16,38,157,3,372,193,11,17,61,141,4,427
2020-03-30,충남,서울,27035,608,1678,1215,1173,1093,32802,28614,501,1687,767,702,1140,33411
2020-03-30,충남,세종,4227,142,134,104,179,207,4993,6118,155,143,110,194,335,7055
2020-03-30,충남,울산,138,5,6,25,71,3,248,180,2,17,35,82,7,323
2020-03-30,충남,전남,4453,94,316,434,835,162,6294,4683,111,329,607,1071,140,6941
2020-03-30,충남,전북,13169,507,1256,908,1376,463,17679,13817,536,1293,1114,1445,515,18720
2020-03-30,충남,충남,97919,3726,6682,6639,10288,4674,129928,97919,3726,6682,6639,10288,4674,129928
2020-03-30,충남,충북,13233,685,821,878,1379,718,17714,12354,615,775,800,1383,660,16587
2020-03-30,충북,강원,4592,196,225,194,427,255,5889,4634,238,246,271,458,292,6139
2020-03-30,충북,경기,26921,2113,2648,2718,3866,1382,39648,29306,2145,2747,3054,3573,1405,42230
2020-03-30,충북,경남,1209,79,164,321,455,40,2268,1058,36,136,217,243,41,1731
2020-03-30,충북,경북,4522,258,451,569,1026,164,6990,4389,252,460,683,995,180,6959
2020-03-30,충북,광주,535,26,65,161,77,8,872,609,21,53,125,69,17,894
2020-03-30,충북,대구,903,83,115,158,133,27,1419,1436,112,145,231,338,34,2296
2020-03-30,충북,대전,9632,396,358,176,159,722,11443,11121,463,420,202,183,835,13224
2020-03-30,충북,부산,79,10,21,72,152,5,339,122,9,26,68,144,7,376
2020-03-30,충북,서울,13422,633,879,774,912,579,17199,15909,541,901,779,696,661,19487
2020-03-30,충북,세종,307,21,23,17,22,28,418,369,15,19,18,6,34,461
2020-03-30,충북,울산,21,0,4,13,28,2,68,14,1,2,14,36,0,67
2020-03-30,충북,전남,404,24,32,89,211,19,779,357,15,25,96,197,7,697
2020-03-30,충북,전북,1701,133,221,253,248,59,2615,1728,129,169,238,306,59,2629
2020-03-30,충북,충남,12354,615,775,800,1383,660,16587,13233,685,821,878,1379,718,17714
2020-03-30,충북,충북,35728,1945,2205,2202,3109,2055,47244,35728,1945,2205,2202,3109,2055,47244
2020-03-31,강원,강원,58614,2445,2501,1625,3139,4033,72357,58614,2445,2501,1625,3139,4033,72357
2020-03-31,강원,경기,18533,617,900,687,777,880,22394,18399,676,881,756,985,899,22596
2020-03-31,강원,경남,117,1,4,12,22,5,161,74,2,2,28,16,3,125
2020-03-31,강원,경북,336,23,30,23,25,8,445,293,19,13,46,37,8,416
2020-03-31,강원,광주,61,1,10,11,15,2,100,57,4,7,11,4,2,85
2020-03-31,강원,대구,116,4,13,20,6,2,161,188,10,9,24,18,5,254
2020-03-31,강원,대전,119,5,9,5,1,4,143,120,3,9,12,1,5,150
2020-03-31,강원,부산,2,0,0,1,3,0,6,4,0,0,1,0,0,5
2020-03-31,강원,서울,947,28,122,24,24,33,1178,762,18,120,13,12,20,945
2020-03-31,강원,세종,3,1,0,0,1,0,5,4,0,0,0,2,0,6
2020-03-31,강원,울산,1,0,0,0,0,0,1,1,0,0,0,2,0,3
2020-03-31,강원,전남,33,0,2,4,8,1,48,49,3,4,11,18,1,86
2020-03-31,강원,전북,92,4,6,14,20,2,138,90,8,13,26,20,2,159
2020-03-31,강원,충남,238,7,16,26,49,4,340,320,14,16,49,82,11,492
2020-03-31,강원,충북,4199,233,294,296,492,241,5755,4248,207,243,247,402,240,5587
2020-03-31,경기,강원,18399,676,881,756,985,899,22596,18533,617,900,687,777,880,22394
2020-03-31,경기,경기,422834,23308,24248,19744,25545,31059,546738,422834,23308,24248,19744,25545,31059,546738
2020-03-31,경기,경남,2091,132,272,763,549,66,3873,1599,73,232,607,463,64,3038
2020-03-31,경기,경북,3067,207,460,767,588,108,5197,2970,199,434,945,603,96,5247
2020-03-31,경기,광주,616,41,121,354,188,19,1339,525,22,87,280,136,19,1069
2020-03-31,경기,대구,1084,98,145,344,182,26,1879,1731,137,182,448,442,61,3001
2020-03-31,경기,대전,1765,102,139,139,49,82,2276,1765,94,151,113,48,69,2240
2020-03-31,경기,부산,172,23,50,232,150,5,632,216,23,38,182,265,6,730
2020-03-31,경기,서울,145056,7402,8472,5759,4374,9709,180772,145532,7113,8760,5230,3896,9758,180289
2020-03-31,경기,세종,45,1,2,3,3,1,55,54,6,4,3,2,1,70
2020-03-31,경기,울산,25,2,0,7,13,2,49,32,5,9,30,51,0,127
2020-03-31,경기,전남,614,23,91,193,171,20,1112,640,17,67,148,143,24,1039
2020-03-31,경기,전북,1082,56,137,140,198,32,1645,1125,64,133,182,204,37,1745
2020-03-31,경기,충남,35490,1579,2644,2606,4561,1882,48762,34747,1502,2576,2463,4178,1765,47231
2020-03-31,경기,충북,25418,2162,2693,3222,3730,1217,38442,24919,2086,2611,2907,3952,1226,37701
2020-03-31,경남,강원,74,2,2,28,16,3,125,117,1,4,12,22,5,161
2020-03-31,경남,경기,1599,73,232,607,463,64,3038,2091,132,272,763,549,66,3873
2020-03-31,경남,경남,173608,9273,9011,7592,13229,13085,225798,173608,9273,9011,7592,13229,13085,225798
2020-03-31,경남,경북,6828,522,795,803,1719,315,10982,8424,688,860,1054,2334,366,13726
2020-03-31,경남,광주,855,44,130,174,148,25,1376,810,44,138,168,129,28,1317
2020-03-31,경남,대구,9535,712,778,1009,1786,385,14205,6079,433,503,364,416,249,8044
2020-03-31,경남,대전,557,23,83,93,34,24,814,686,34,88,111,48,25,992
2020-03-31,경남,부산,82615,2583,2490,2173,4373,6024,100258,80040,2625,2607,2060,4706,5862,97900
2020-03-31,경남,서울,1655,42,276,313,158,57,2501,2084,60,266,190,113,53,2766
2020-03-31,경남,세종,136,3,9,18,15,4,185,161,7,10,18,12,9,217
2020-03-31,경남,울산,8708,638,664,457,752,522,11741,8211,586,682,415,587,482,10963
2020-03-31,경남,전남,5320,279,396,475,1445,226,8141,5449,271,395,423,1331,228,8097
2020-03-31,경남,전북,857,43,108,119,221,35,1383,823,44,115,104,205,37,1328
2020-03-31,경남,충남,955,53,143,269,223,25,1668,1163,55,161,310,460,35,2184
2020-03-31,경남,충북,897,59,129,273,277,33,1668,963,78,189,451,522,37,2240
2020-03-31,경북,강원,293,19,13,46,37,8,416,336,23,30,23,25,8,445
2020-03-31,경북,경기,2970,199,434,945,603,96,5247,3067,207,460,767,588,108,5197
2020-03-31,경북,경남,8424,688,860,1054,2334,366,13726,6828,522,795,803,1719,315,10982
2020-03-31,경북,경북,66729,4043,3821,3045,5555,3623,86816,66729,4043,3821,3045,5555,3623,86816
2020-03-31,경북,광주,594,62,116,199,144,15,1130,587,48,97,180,85,17,1014
2020-03-31,경북,대구,58468,2738,2105,1425,3350,3090,71176,67858,3085,2672,2061,4169,3610,83455
2020-03-31,경북,대전,1328,69,86,107,91,67,1748,1321,64,87,135,66,58,1731
2020-03-31,경북,부산,3638,104,206,220,679,181,5028,3839,102,208,214,799,171,5333
2020-03-31,경북,서울,2264,115,229,468,176,81,3333,2340,88,208,248,116,74,3074
2020-03-31,경북,세종,217,5,22,23,15,3,285,206,11,17,18,7,8,267
2020-03-31,경북,울산,4857,169,284,493,984,289,7076,4821,155,302,321,1202,261,7062
2020-03-31,경북,전남,881,56,83,121,441,27,1609,888,53,82,101,495,27,1646
2020-03-31,경북,전북,1578,82,184,193,304,43,2384,1415,97,154,169,260,40,2135
2020-03-31,경북,충남,2512,155,337,553,588,94,4239,2479,127,335,533,620,102,4196
2020-03-31,경북,충북,4038,237,506,786,1042,143,6752,3916,276,499,681,1214,146,6732
2020-03-31,광주,강원,57,4,7,11,4,2,85,61,1,10,11,15,2,100
2020-03-31,광주,경기,525,22,87,280,136,19,1069,616,41,121,354,188,19,1339
2020-03-31,광주,경남,810,44,138,168,129,28,1317,855,44,130,174,148,25,1376
2020-03-31,광주,경북,587,48,97,180,85,17,1014,594,62,116,199,144,15,1130
2020-03-31,광주,광주,13822,522,551,441,401,566,16303,13822,522,551,441,401,566,16303
2020-03-31,광주,대구,350,30,67,84,31,10,572,405,24,75,69,28,9,610
2020-03-31,광주,대전,338,19,13,21,13,7,411,364,22,18,30,12,11,457
2020-03-31,광주,부산,323,11,35,50,57,9,485,346,17,57,83,94,13,610
2020-03-31,광주,서울,483,24,26,97,26,14,670,642,29,26,60,23,13,793
2020-03-31,광주,세종,116,1,10,1,1,1,130,115,4,7,10,3,3,142
2020-03-31,광주,울산,43,0,7,2,6,3,61,34,4,4,7,11,1,61
2020-03-31,광주,전남,33129,1004,1093,834,2022,1266,39348,32190,993,965,754,1960,1268,38130
2020-03-31,광주,전북,6884,440,524,358,438,282,8926,7073,472,470,357,470,280,9122
2020-03-31,광주,충남,3463,124,383,500,271,100,4841,3371,152,400,643,389,94,5049
2020-03-31,광주,충북,473,29,54,116,64,19,755,477,42,76,199,97,8,899
2020-03-31,대구,강원,188,10,9,24,18,5,254,116,4,13,20,6,2,161
2020-03-31,대구,경기,1731,137,182,448,442,61,3001,1084,98,145,344,182,26,1879
2020-03-31,대구,경남,6079,433,503,364,416,249,8044,9535,712,778,1009,1786,385,14205
2020-03-31,대구,경북,67858,3085,2672,2061,4169,3610,83455,58468,2738,2105,1425,3350,3090,71176
2020-03-31,대구,광주,405,24,75,69,28,9,610,350,30,67,84,31,10,572
2020-03-31,대구,대구,51550,1940,1533,756,1154,3405,60338,51550,1940,1533,756,1154,3405,60338
2020-03-31,대구,대전,609,32,39,83,42,19,824,367,20,23,47,18,13,488
2020-03-31,대구,부산,443,53,97,61,163,20,837,2057,96,138,92,257,77,2717
2020-03-31,대구,서울,1792,79,104,256,148,54,2433,1119,51,64,140,37,31,1442
2020-03-31,대구,세종,157,5,4,10,6,6,188,78,2,1,1,6,3,91
2020-03-31,대구,울산,826,51,71,101,145,32,1226,604,37,56,57,185,18,957
2020-03-31,대구,전남,462,24,34,24,43,10,597,403,14,34,18,42,13,524
2020-03-31,대구,전북,250,15,24,20,18,9,336,233,14,26,10,18,5,306
2020-03-31,대구,충남,1047,76,130,216,277,37,1783,610,50,115,141,161,18,1095
2020-03-31,대구,충북,1193,116,150,249,388,27,2123,781,82,101,203,136,15,1318
2020-03-31,대전,강원,120,3,9,12,1,5,150,119,5,9,5,1,4,143
2020-03-31,대전,경기,1765,94,151,113,48,69,2240,1765,102,139,139,49,82,2276
2020-03-31,대전,경남,686,34,88,111,48,25,992,557,23,83,93,34,24,814
2020-03-31,대전,경북,1321,64,87,135,66,58,1731,1328,69,86,107,91,67,1748
2020-03-31,대전,광주,364,22,18,30,12,11,457,338,19,13,21,13,7,411
2020-03-31,대전,대구,367,20,23,47,18,13,488,609,32,39,83,42,19,824
2020-03-31,대전,대전,13782,469,406,370,182,1023,16232,13782,469,406,370,182,1023,16232
2020-03-31,대전,부산,62,9,5,22,21,3,122,71,5,9,17,21,2,125
2020-03-31,대전,서울,1585,54,113,46,8,63,1869,1599,42,116,46,11,60,1874
2020-03-31,대전,세종,3195,112,88,35,77,263,3770,3251,107,77,57,81,264,3837
2020-03-31,대전,울산,98,3,7,18,29,3,158,79,1,6,13,21,3,123
2020-03-31,대전,전남,298,12,6,34,31,6,387,294,15,11,23,19,6,368
2020-03-31,대전,전북,2698,91,70,93,71,122,3145,2759,101,88,94,59,116,3217
2020-03-31,대전,충남,15455,498,508,363,265,1176,18265,14186,487,456,292,286,1062,16769
2020-03-31,대전,충북,10685,459,432,224,166,753,12719,9580,411,361,185,148,704,11389
2020-03-31,부산,강원,4,0,0,1,0,0,5,2,0,0,1,3,0,6
2020-03-31,부산,경기,216,23,38,182,265,6,730,172,23,50,232,150,5,632
2020-03-31,부산,경남,80040,2625,2607,2060,4706,5862,97900,82615,2583,2490,2173,4373,6024,100258
2020-03-31,부산,경북,3839,102,208,214,799,171,5333,3638,104,206,220,679,181,5028
2020-03-31,부산,광주,346,17,57,83,94,13,610,323,11,35,50,57,9,485
2020-03-31,부산,대구,2057,96,138,92,257,77,2717,443,53,97,61,163,20,837
2020-03-31,부산,대전,71,5,9,17,21,2,125,62,9,5,22,21,3,122
2020-03-31,부산,부산,39510,671,624,718,2191,2951,46665,39510,671,624,718,2191,2951,46665
2020-03-31,부산,서울,184,17,18,98,70,2,389,173,11,12,69,34,4,303
2020-03-31,부산,세종,17,1,1,0,4,0,23,7,0,0,0,2,0,9
2020-03-31,부산,울산,14444,375,473,597,2331,1100,19320,13574,382,442,410,2161,1081,18050
2020-03-31,부산,전남,1648,88,137,188,490,67,2618,1496,91,119,158,505,56,2425
2020-03-31,부산,전북,233,11,26,39,89,4,402,201,7,16,36,74,6,340
2020-03-31,부산,충남,142,14,27,78,171,3,435,105,19,22,79,220,6,451
2020-03-31,부산,충북,99,13,26,98,194,2,432,84,11,20,140,194,6,455
2020-03-31,서울,강원,762,18,120,13,12,20,945,947,28,122,24,24,33,1178
2020-03-31,서울,경기,145532,7113,8760,5230,3896,9758,180289,145056,7402,8472,5759,4374,9709,180772
2020-03-31,서울,경남,2084,60,266,190,113,53,2766,1655,42,276,313,158,57,2501
2020-03-31,서울,경북,2340,88,208,248,116,74,3074,2264,115,229,468,176,81,3333
2020-03-31,서울,광주,642,29,26,60,23,13,793,483,24,26,97,26,14,670
2020-03-31,서울,대구,1119,51,64,140,37,31,1442,1792,79,104,256,148,54,2433
2020-03-31,서울,대전,1599,42,116,46,11,60,1874,1585,54,113,46,8,63,1869
2020-03-31,서울,부산,173,11,12,69,34,4,303,184,17,18,98,70,2,389
2020-03-31,서울,서울,183,5,8,1,1,8,206,183,5,8,1,1,8,206
2020-03-31,서울,세종,38,0,0,1,0,3,42,26,0,1,0,0,1,28
2020-03-31,서울,울산,24,2,4,4,2,1,37,27,2,4,10,16,0,59
2020-03-31,서울,전남,778,22,18,45,26,21,910,685,15,17,77,46,17,857
2020-03-31,서울,전북,1145,23,37,33,28,38,1304,1012,30,48,41,26,36,1193
2020-03-31,서울,충남,24448,549,1691,904,761,944,29297,24256,636,1662,1441,1266,898,30159
2020-03-31,서울,충북,12798,516,932,869,777,534,16426,12772,693,910,879,986,527,16767
2020-03-31,세종,강원,4,0,0,0,2,0,6,3,1,0,0,1,0,5
2020-03-31,세종,경기,54,6,4,3,2,1,70,45,1,2,3,3,1,55
2020-03-31,세종,경남,161,7,10,18,12,9,217,136,3,9,18,15,4,185
2020-03-31,세종,경북,206,11,17,18,7,8,267,217,5,22,23,15,3,285
2020-03-31,세종,광주,115,4,7,10,3,3,142,116,1,10,1,1,1,130
2020-03-31,세종,대구,78,2,1,1,6,3,91,157,5,4,10,6,6,188
2020-03-31,세종,대전,3251,107,77,57,81,264,3837,3195,112,88,35,77,263,3770
2020-03-31,세종,부산,7,0,0,0,2,0,9,17,1,1,0,4,0,23
2020-03-31,세종,서울,26,0,1,0,0,1,28,38,0,0,1,0,3,42
2020-03-31,세종,세종,208,20,5,1,2,15,251,208,20,5,1,2,15,251
2020-03-31,세종,울산,16,0,0,1,2,2,21,9,0,0,5,4,1,19
2020-03-31,세종,전남,117,1,4,6,15,3,146,100,1,2,4,8,4,119
2020-03-31,세종,전북,552,15,25,15,46,30,683,557,16,17,13,53,20,676
2020-03-31,세종,충남,5368,153,161,153,210,291,6336,4218,135,148,141,202,227,5071
2020-03-31,세종,충북,370,20,19,22,19,25,475,343,15,28,20,20,32,458
2020-03-31,울산,강원,1,0,0,0,2,0,3,1,0,0,0,0,0,1
2020-03-31,울산,경기,32,5,9,30,51,0,127,25,2,0,7,13,2,49
2020-03-31,울산,경남,8211,586,682,415,587,482,10963,8708,638,664,457,752,522,11741
2020-03-31,울산,경북,4821,155,302,321,1202,261,7062,4857,169,284,493,984,289,7076
2020-03-31,울산,광주,34,4,4,7,11,1,61,43,0,7,2,6,3,61
2020-03-31,울산,대구,604,37,56,57,185,18,957,826,51,71,101,145,32,1226
2020-03-31,울산,대전,79,1,6,13,21,3,123,98,3,7,18,29,3,158
2020-03-31,울산,부산,13574,382,442,410,2161,1081,18050,14444,375,473,597,2331,1100,19320
2020-03-31,울산,서울,27,2,4,10,16,0,59,24,2,4,4,2,1,37
2020-03-31,울산,세종,9,0,0,5,4,1,19,16,0,0,1,2,2,21
2020-03-31,울산,울산,7956,285,465,322,652,705,10385,7956,285,465,322,652,705,10385
2020-03-31,울산,전남,179,13,26,16,29,6,269,188,15,20,18,46,8,295
2020-03-31,울산,전북,28,0,4,2,10,2,46,42,1,5,5,6,0,59
2020-03-31,울산,충남,116,8,22,54,104,3,307,88,4,16,38,95,1,242
2020-03-31,울산,충북,13,5,7,17,44,0,86,16,2,2,15,32,1,68
2020-03-31,전남,강원,49,3,4,11,18,1,86,33,0,2,4,8,1,48
2020-03-31,전남,경기,640,17,67,148,143,24,1039,614,23,91,193,171,20,1112
2020-03-31,전남,경남,5449,271,395,423,1331,228,8097,5320,279,396,475,1445,226,8141
2020-03-31,전남,경북,888,53,82,101,495,27,1646,881,56,83,121,441,27,1609
2020-03-31,전남,광주,32190,993,965,754,1960,1268,38130,33129,1004,1093,834,2022,1266,39348
2020-03-31,전남,대구,403,14,34,18,42,13,524,462,24,34,24,43,10,597
2020-03-31,전남,대전,294,15,11,23,19,6,368,298,12,6,34,31,6,387
2020-03-31,전남,부산,1496,91,119,158,505,56,2425,1648,88,137,188,490,67,2618
2020-03-31,전남,서울,685,15,17,77,46,17,857,778,22,18,45,26,21,910
2020-03-31,전남,세종,100,1,2,4,8,4,119,117,1,4,6,15,3,146
2020-03-31,전남,울산,188,15,20,18,46,8,295,179,13,26,16,29,6,269
2020-03-31,전남,전남,39984,1314,1445,1763,4934,1568,51008,39984,1314,1445,1763,4934,1568,51008
2020-03-31,전남,전북,4580,305,498,553,1433,138,7507,4624,241,404,583,1367,144,7363
2020-03-31,전남,충남,3884,115,387,723,1115,130,6354,3791,114,386,594,925,139,5949
2020-03-31,전남,충북,318,24,32,103,207,16,700,292,15,49,109,213,8,686
2020-03-31,전북,강원,90,8,13,26,20,2,159,92,4,6,14,20,2,138
2020-03-31,전북,경기,1125,64,133,182,204,37,1745,1082,56,137,140,198,32,1645
2020-03-31,전북,경남,823,44,115,104,205,37,1328,857,43,108,119,221,35,1383
2020-03-31,전북,경북,1415,97,154,169,260,40,2135,1578,82,184,193,304,43,2384
2020-03-31,전북,광주,7073,472,470,357,470,280,9122,6884,440,524,358,438,282,8926
2020-03-31,전북,대구,233,14,26,10,18,5,306,250,15,24,20,18,9,336
2020-03-31,전북,대전,2759,101,88,94,59,116,3217,2698,91,70,93,71,122,3145
2020-03-31,전북,부산,201,7,16,36,74,6,340,233,11,26,39,89,4,402
2020-03-31,전북,서울,1012,30,48,41,26,36,1193,1145,23,37,33,28,38,1304
2020-03-31,전북,세종,557,16,17,13,53,20,676,552,15,25,15,46,30,683
2020-03-31,전북,울산,42,1,5,5,6,0,59,28,0,4,2,10,2,46
2020-03-31,전북,전남,4624,241,404,583,1367,144,7363,4580,305,498,553,1433,138,7507
2020-03-31,전북,전북,15899,746,979,665,972,564,19825,15899,746,979,665,972,564,19825
2020-03-31,전북,충남,11916,527,1347,1192,1458,427,16867,11804,507,1315,1021,1455,409,16511
2020-03-31,전북,충북,1554,110,183,276,272,57,2452,1533,127,184,297,273,47,2461
2020-03-31,충남,강원,320,14,16,49,82,11,492,238,7,16,26,49,4,340
2020-03-31,충남,경기,34747,1502,2576,2463,4178,1765,47231,35490,1579,2644,2606,4561,1882,48762
2020-03-31,충남,경남,1163,55,161,310,460,35,2184,955,53,143,269,223,25,1668
2020-03-31,충남,경북,2479,127,335,533,620,102,4196,2512,155,337,553,588,94,4239
2020-03-31,충남,광주,3371,152,400,643,389,94,5049,3463,124,383,500,271,100,4841
2020-03-31,충남,대구,610,50,115,141,161,18,1095,1047,76,130,216,277,37,1783
2020-03-31,충남,대전,14186,487,456,292,286,1062,16769,15455,498,508,363,265,1176,18265
2020-03-31,충남,부산,105,19,22,79,220,6,451,142,14,27,78,171,3,435
2020-03-31,충남,서울,24256,636,1662,1441,1266,898,30159,24448,549,1691,904,761,944,29297
2020-03-31,충남,세종,4218,135,148,141,202,227,5071,5368,153,161,153,210,291,6336
2020-03-31,충남,울산,88,4,16,38,95,1,242,116,8,22,54,104,3,307
2020-03-31,충남,전남,3791,114,386,594,925,139,5949,3884,115,387,723,1115,130,6354
2020-03-31,충남,전북,11804,507,1315,1021,1455,409,16511,11916,527,1347,1192,1458,427,16867
2020-03-31,충남,충남,89159,3740,6940,7546,10811,4142,122338,89159,3740,6940,7546,10811,4142,122338
2020-03-31,충남,충북,12873,683,847,986,1511,770,17670,11622,662,758,887,1440,638,16007
2020-03-31,충북,강원,4248,207,243,247,402,240,5587,4199,233,294,296,492,241,5755
2020-03-31,충북,경기,24919,2086,2611,2907,3952,1226,37701,25418,2162,2693,3222,3730,1217,38442
2020-03-31,충북,경남,963,78,189,451,522,37,2240,897,59,129,273,277,33,1668
2020-03-31,충북,경북,3916,276,499,681,1214,146,6732,4038,237,506,786,1042,143,6752
2020-03-31,충북,광주,477,42,76,199,97,8,899,473,29,54,116,64,19,755
2020-03-31,충북,대구,781,82,101,203,136,15,1318,1193,116,150,249,388,27,2123
2020-03-31,충북,대전,9580,411,361,185,148,704,11389,10685,459,432,224,166,753,12719
2020-03-31,충북,부산,84,11,20,140,194,6,455,99,13,26,98,194,2,432
2020-03-31,충북,서울,12772,693,910,879,986,527,16767,12798,516,932,869,777,534,16426
2020-03-31,충북,세종,343,15,28,20,20,32,458,370,20,19,22,19,25,475
2020-03-31,충북,울산,16,2,2,15,32,1,68,13,5,7,17,44,0,86
2020-03-31,충북,전남,292,15,49,109,213,8,686,318,24,32,103,207,16,700
2020-03-31,충북,전북,1533,127,184,297,273,47,2461,1554,110,183,276,272,57,2452
2020-03-31,충북,충남,11622,662,758,887,1440,638,16007,12873,683,847,986,1511,770,17670
2020-03-31,충북,충북,34817,1978,2177,2170,3343,1985,46470,34817,1978,2177,2170,3343,1985,46470
2020-04-01,강원,강원,57878,2405,2448,1500,3009,3844,71084,57878,2405,2448,1500,3009,3844,71084
2020-04-01,강원,경기,17519,624,909,711,895,818,21476,18666,680,879,746,1130,870,22971
2020-04-01,강원,경남,89,3,11,8,11,4,126,67,3,6,19,20,0,115
2020-04-01,강원,경북,324,29,22,14,34,14,437,303,20,18,32,55,16,444
2020-04-01,강원,광주,54,2,6,4,14,4,84,58,0,8,19,5,1,91
2020-04-01,강원,대구,106,0,12,16,6,6,146,163,4,16,23,24,6,236
2020-04-01,강원,대전,119,3,7,8,0,3,140,116,4,7,8,3,8,146
2020-04-01,강원,부산,0,1,0,3,0,0,4,3,0,1,3,5,0,12
2020-04-01,강원,서울,724,16,134,10,28,22,934,756,15,124,20,22,22,959
2020-04-01,강원,세종,3,0,1,0,0,0,4,2,1,1,0,1,0,5
2020-04-01,강원,울산,2,0,0,0,0,0,2,0,0,0,0,0,0,0
2020-04-01,강원,전남,34,3,1,2,13,3,56,47,1,5,11,20,1,85
2020-04-01,강원,전북,82,1,10,11,16,2,122,99,9,9,20,21,0,158
2020-04-01,강원,충남,223,4,26,22,49,5,329,345,13,17,45,72,4,496
2020-04-01,강원,충북,4065,242,266,298,477,245,5593,4175,205,235,247,403,251,5516
2020-04-01,경기,강원,18666,680,879,746,1130,870,22971,17519,624,909,711,895,818,21476
2020-04-01,경기,경기,427929,23951,24262,20559,25639,31227,553567,427929,23951,24262,20559,25639,31227,553567
2020-04-01,경기,경남,2231,97,277,745,606,61,4017,1483,82,210,516,441,52,2784
2020-04-01,경기,경북,3134,196,423,778,600,93,5224,2860,190,367,921,588,101,5027
2020-04-01,경기,광주,630,35,120,362,173,23,1343,521,24,98,253,107,14,1017
2020-04-01,경기,대구,1237,93,162,391,193,46,2122,1835,119,157,436,439,65,3051
2020-04-01,경기,대전,1823,110,136,132,70,80,2351,1777,91,150,106,50,64,2238
2020-04-01,경기,부산,178,26,47,214,152,4,621,227,20,29,142,255,8,681
2020-04-01,경기,서울,146161,7667,8556,5576,4117,9763,181840,145799,7308,8793,5096,3708,9653,180357
2020-04-01,경기,세종,37,2,4,2,2,0,47,60,3,5,3,4,2,77
2020-04-01,경기,울산,40,1,7,17,15,2,82,39,2,7,30,74,4,156
2020-04-01,경기,전남,640,18,73,185,150,24,1090,628,15,60,130,181,19,1033
2020-04-01,경기,전북,1156,53,125,124,200,42,1700,1073,68,118,181,207,48,1695
2020-04-01,경기,충남,35800,1564,2652,2565,4710,1920,49211,34801,1541,2506,2555,4444,1839,47686
2020-04-01,경기,충북,25870,2281,2923,3449,3739,1262,39524,25190,2191,2746,2993,3961,1194,38275
2020-04-01,경남,강원,67,3,6,19,20,0,115,89,3,11,8,11,4,126
2020-04-01,경남,경기,1483,82,210,516,441,52,2784,2231,97,277,745,606,61,4017
2020-04-01,경남,경남,179026,9875,9383,7172,13171,13347,231974,179026,9875,9383,7172,13171,13347,231974
2020-04-01,경남,경북,7719,606,845,933,1877,341,12321,9524,838,1115,1241,2553,412,15683
2020-04-01,경남,광주,870,61,107,213,139,27,1417,842,53,139,172,102,22,1330
2020-04-01,경남,대구,9376,715,756,1015,1667,373,13902,7214,476,556,440,477,277,9440
2020-04-01,경남,대전,514,12,78,76,64,23,767,754,21,84,118,76,30,1083
2020-04-01,경남,부산,80876,2646,2489,1840,4200,5690,97741,79646,2720,2616,1923,4360,5687,96952
2020-04-01,경남,서울,1529,27,276,285,136,53,2306,2164,52,298,183,128,65,2890
2020-04-01,경남,세종,138,4,8,11,13,6,180,140,2,7,12,24,3,188
2020-04-01,경남,울산,8467,656,660,485,692,527,11487,8082,603,655,462,641,500,10943
2020-04-01,경남,전남,5194,275,404,540,1462,237,8112,5300,296,435,439,1434,245,8149
2020-04-01,경남,전북,864,51,100,119,200,38,1372,839,36,103,125,204,32,1339
2020-04-01,경남,충남,897,46,103,264,268,33,1611,1215,72,147,321,497,37,2289
2020-04-01,경남,충북,823,48,97,280,235,27,1510,1061,58,180,463,527,41,2330
2020-04-01,경북,강원,303,20,18,32,55,16,444,324,29,22,14,34,14,437
2020-04-01,경북,경기,2860,190,367,921,588,101,5027,3134,196,423,778,600,93,5224
2020-04-01,경북,경남,9524,838,1115,1241,2553,412,15683,7719,606,845,933,1877,341,12321
2020-04-01,경북,경북,66014,4116,4006,3074,5226,3507,85943,66014,4116,4006,3074,5226,3507,85943
2020-04-01,경북,광주,579,64,109,191,147,10,1100,499,48,98,171,102,17,935
2020-04-01,경북,대구,65970,3056,2447,1776,3530,3465,80244,68654,3189,2776,2073,4016,3558,84266
2020-04-01,경북,대전,1404,65,82,124,81,59,1815,1408,53,91,133,65,66,1816
2020-04-01,경북,부산,3576,122,207,215,574,176,4870,3835,137,221,198,699,175,5265
2020-04-01,경북,서울,2112,118,219,415,183,74,3121,2316,84,189,249,102,87,3027
2020-04-01,경북,세종,213,4,20,28,18,8,291,234,8,14,23,13,9,301
2020-04-01,경북,울산,4784,163,296,405,1050,263,6961,4608,169,299,345,1269,256,6946
2020-04-01,경북,전남,839,45,84,105,424,24,1521,852,44,79,94,518,24,1611
2020-04-01,경북,전북,1569,103,165,194,307,50,2388,1368,107,165,156,257,38,2091
2020-04-01,경북,충남,2414,166,347,593,614,80,4214,2555,156,369,544,736,89,4449
2020-04-01,경북,충북,4063,228,490,752,1064,153,6750,3985,235,509,668,1191,126,6714
2020-04-01,광주,강원,58,0,8,19,5,1,91,54,2,6,4,14,4,84
2020-04-01,광주,경기,521,24,98,253,107,14,1017,630,35,120,362,173,23,1343
2020-04-01,광주,경남,842,53,139,172,102,22,1330,870,61,107,213,139,27,1417
2020-04-01,광주,경북,499,48,98,171,102,17,935,579,64,109,191,147,10,1100
2020-04-01,광주,광주,13677,525,566,391,415,592,16166,13677,525,566,391,415,592,16166
2020-04-01,광주,대구,388,30,56,94,26,7,601,378,26,70,78,41,10,603
2020-04-01,광주,대전,360,17,14,22,16,19,448,373,17,14,23,20,21,468
2020-04-01,광주,부산,330,11,36,40,64,11,492,324,18,39,71,95,6,553
2020-04-01,광주,서울,451,15,21,71,26,17,601,618,20,16,43,24,19,740
2020-04-01,광주,세종,128,2,9,2,4,3,148,159,5,9,3,3,3,182
2020-04-01,광주,울산,51,1,7,3,5,0,67,46,1,8,4,11,0,70
2020-04-01,광주,전남,32910,1034,1093,785,1965,1244,39031,31943,1034,991,657,1845,1247,37717
2020-04-01,광주,전북,6933,433,498,380,466,246,8956,6981,442,423,311,477,261,8895
2020-04-01,광주,충남,3382,128,390,459,256,73,4688,3569,138,389,671,358,81,5206
2020-04-01,광주,충북,479,28,56,125,63,11,762,547,36,85,178,113,12,971
2020-04-01,대구,강원,163,4,16,23,24,6,236,106,0,12,16,6,6,146
2020-04-01,대구,경기,1835,119,157,436,439,65,3051,1237,93,162,391,193,46,2122
2020-04-01,대구,경남,7214,476,556,440,477,277,9440,9376,715,756,1015,1667,373,13902
2020-04-01,대구,경북,68654,3189,2776,2073,4016,3558,84266,65970,3056,2447,1776,3530,3465,80244
2020-04-01,대구,광주,378,26,70,78,41,10,603,388,30,56,94,26,7,601
2020-04-01,대구,대구,56083,2202,1645,1053,1190,3687,65860,56083,2202,1645,1053,1190,3687,65860
2020-04-01,대구,대전,584,26,28,68,40,29,775,399,19,23,56,19,12,528
2020-04-01,대구,부산,452,54,102,63,121,20,812,2123,98,155,81,226,84,2767
2020-04-01,대구,서울,1720,65,91,228,131,54,2289,1135,45,58,125,56,28,1447
2020-04-01,대구,세종,154,4,4,4,11,6,183,98,0,2,6,2,4,112
2020-04-01,대구,울산,822,52,73,83,170,28,1228,838,51,70,98,196,31,1284
2020-04-01,대구,전남,382,13,43,23,47,8,516,360,19,39,24,57,6,505
2020-04-01,대구,전북,241,8,34,17,22,9,331,232,12,27,23,18,4,316
2020-04-01,대구,충남,958,77,127,209,243,31,1645,675,61,105,168,251,27,1287
2020-04-01,대구,충북,1092,88,148,259,373,31,1991,777,74,140,218,150,18,1377
2020-04-01,대전,강원,116,4,7,8,3,8,146,119,3,7,8,0,3,140
2020-04-01,대전,경기,1777,91,150,106,50,64,2238,1823,110,136,132,70,80,2351
2020-04-01,대전,경남,754,21,84,118,76,30,1083,514,12,78,76,64,23,767
2020-04-01,대전,경북,1408,53,91,133,65,66,1816,1404,65,82,124,81,59,1815
2020-04-01,대전,광주,373,17,14,23,20,21,468,360,17,14,22,16,19,448
2020-04-01,대전,대구,399,19,23,56,19,12,528,584,26,28,68,40,29,775
2020-04-01,대전,대전,13934,455,436,332,196,1054,16407,13934,455,436,332,196,1054,16407
2020-04-01,대전,부산,44,4,3,13,22,2,88,46,6,5,17,22,3,99
2020-04-01,대전,서울,1518,55,114,36,15,65,1803,1620,40,106,42,8,64,1880
2020-04-01,대전,세종,3268,111,73,30,69,245,3796,3355,95,78,42,74,239,3883
2020-04-01,대전,울산,87,2,3,12,33,2,139,75,2,5,7,29,2,120
2020-04-01,대전,전남,260,7,9,38,20,7,341,276,10,12,25,24,11,358
2020-04-01,대전,전북,2817,110,87,75,50,121,3260,2764,116,104,68,57,125,3234
2020-04-01,대전,충남,15628,485,541,336,346,1182,18518,14389,469,461,278,305,1044,16946
2020-04-01,대전,충북,10403,496,415,219,151,769,12453,9412,441,380,191,137,716,11277
2020-04-01,부산,강원,3,0,1,3,5,0,12,0,1,0,3,0,0,4
2020-04-01,부산,경기,227,20,29,142,255,8,681,178,26,47,214,152,4,621
2020-04-01,부산,경남,79646,2720,2616,1923,4360,5687,96952,80876,2646,2489,1840,4200,5690,97741
2020-04-01,부산,경북,3835,137,221,198,699,175,5265,3576,122,207,215,574,176,4870
2020-04-01,부산,광주,324,18,39,71,95,6,553,330,11,36,40,64,11,492
2020-04-01,부산,대구,2123,98,155,81,226,84,2767,452,54,102,63,121,20,812
2020-04-01,부산,대전,46,6,5,17,22,3,99,44,4,3,13,22,2,88
2020-04-01,부산,부산,39515,671,573,803,1944,2940,46446,39515,671,573,803,1944,2940,46446
2020-04-01,부산,서울,158,10,26,80,64,8,346,168,7,25,64,31,5,300
2020-04-01,부산,세종,12,2,3,4,0,2,23,10,1,0,1,1,0,13
2020-04-01,부산,울산,14163,351,444,666,2443,1007,19074,14127,384,386,455,2359,1020,18731
2020-04-01,부산,전남,1557,91,104,218,542,58,2570,1500,81,94,158,523,53,2409
2020-04-01,부산,전북,208,9,31,47,121,6,422,183,3,20,47,60,6,319
2020-04-01,부산,충남,118,12,25,51,142,3,351,105,9,22,89,193,3,421
2020-04-01,부산,충북,85,8,23,83,170,4,373,88,11,36,117,163,4,419
2020-04-01,서울,강원,756,15,124,20,22,22,959,724,16,134,10,28,22,934
2020-04-01,서울,경기,145799,7308,8793,5096,3708,9653,180357,146161,7667,8556,5576,4117,9763,181840
2020-04-01,서울,경남,2164,52,298,183,128,65,2890,1529,27,276,285,136,53,2306
2020-04-01,서울,경북,2316,84,189,249,102,87,3027,2112,118,219,415,183,74,3121
2020-04-01,서울,광주,618,20,16,43,24,19,740,451,15,21,71,26,17,601
2020-04-01,서울,대구,1135,45,58,125,56,28,1447,1720,65,91,228,131,54,2289
2020-04-01,서울,대전,1620,40,106,42,8,64,1880,1518,55,114,36,15,65,1803
2020-04-01,서울,부산,168,7,25,64,31,5,300,158,10,26,80,64,8,346
2020-04-01,서울,서울,203,19,11,2,0,9,244,203,19,11,2,0,9,244
2020-04-01,서울,세종,27,1,1,1,0,1,31,33,2,0,2,2,2,41
2020-04-01,서울,울산,28,0,2,4,0,0,34,26,1,3,9,9,2,50
2020-04-01,서울,전남,825,14,23,36,21,22,941,673,12,18,69,53,27,852
2020-04-01,서울,전북,1161,16,33,27,21,42,1300,1001,20,30,36,31,34,1152
2020-04-01,서울,충남,24261,516,1663,857,773,923,28993,23903,625,1657,1345,1324,975,29829
2020-04-01,서울,충북,12911,563,916,836,774,476,16476,12669,713,884,935,975,485,16661
2020-04-01,세종,강원,2,1,1,0,1,0,5,3,0,1,0,0,0,4
2020-04-01,세종,경기,60,3,5,3,4,2,77,37,2,4,2,2,0,47
2020-04-01,세종,경남,140,2,7,12,24,3,188,138,4,8,11,13,6,180
2020-04-01,세종,경북,234,8,14,23,13,9,301,213,4,20,28,18,8,291
2020-04-01,세종,광주,159,5,9,3,3,3,182,128,2,9,2,4,3,148
2020-04-01,세종,대구,98,0,2,6,2,4,112,154,4,4,4,11,6,183
2020-04-01,세종,대전,3355,95,78,42,74,239,3883,3268,111,73,30,69,245,3796
2020-04-01,세종,부산,10,1,0,1,1,0,13,12,2,3,4,0,2,23
2020-04-01,세종,서울,33,2,0,2,2,2,41,27,1,1,1,0,1,31
2020-04-01,세종,세종,240,23,7,3,1,16,290,240,23,7,3,1,16,290
2020-04-01,세종,울산,9,0,0,1,5,0,15,8,0,0,3,5,0,16
2020-04-01,세종,전남,141,2,3,5,14,1,166,91,1,3,8,16,4,123
2020-04-01,세종,전북,549,18,22,18,35,33,675,518,11,19,22,40,23,633
2020-04-01,세종,충남,5280,159,178,142,173,292,6224,4069,136,137,135,175,224,4876
2020-04-01,세종,충북,370,14,20,25,19,27,475,327,20,25,18,18,21,429
2020-04-01,울산,강원,0,0,0,0,0,0,0,2,0,0,0,0,0,2
2020-04-01,울산,경기,39,2,7,30,74,4,156,40,1,7,17,15,2,82
2020-04-01,울산,경남,8082,603,655,462,641,500,10943,8467,656,660,485,692,527,11487
2020-04-01,울산,경북,4608,169,299,345,1269,256,6946,4784,163,296,405,1050,263,6961
2020-04-01,울산,광주,46,1,8,4,11,0,70,51,1,7,3,5,0,67
2020-04-01,울산,대구,838,51,70,98,196,31,1284,822,52,73,83,170,28,1228
2020-04-01,울산,대전,75,2,5,7,29,2,120,87,2,3,12,33,2,139
2020-04-01,울산,부산,14127,384,386,455,2359,1020,18731,14163,351,444,666,2443,1007,19074
2020-04-01,울산,서울,26,1,3,9,9,2,50,28,0,2,4,0,0,34
2020-04-01,울산,세종,8,0,0,3,5,0,16,9,0,0,1,5,0,15
2020-04-01,울산,울산,7687,321,499,278,676,672,10133,7687,321,499,278,676,672,10133
2020-04-01,울산,전남,183,10,24,17,22,6,262,155,13,24,6,43,9,250
2020-04-01,울산,전북,32,3,5,1,14,0,55,27,3,3,2,4,0,39
2020-04-01,울산,충남,103,7,17,52,126,4,309,100,8,7,39,107,5,266
2020-04-01,울산,충북,13,4,6,12,45,0,80,16,0,3,18,29,1,67
2020-04-01,전남,강원,47,1,5,11,20,1,85,34,3,1,2,13,3,56
2020-04-01,전남,경기,628,15,60,130,181,19,1033,640,18,73,185,150,24,1090
2020-04-01,전남,경남,5300,296,435,439,1434,245,8149,5194,275,404,540,1462,237,8112
2020-04-01,전남,경북,852,44,79,94,518,24,1611,839,45,84,105,424,24,1521
2020-04-01,전남,광주,31943,1034,991,657,1845,1247,37717,32910,1034,1093,785,1965,1244,39031
2020-04-01,전남,대구,360,19,39,24,57,6,505,382,13,43,23,47,8,516
2020-04-01,전남,대전,276,10,12,25,24,11,358,260,7,9,38,20,7,341
2020-04-01,전남,부산,1500,81,94,158,523,53,2409,1557,91,104,218,542,58,2570
2020-04-01,전남,서울,673,12,18,69,53,27,852,825,14,23,36,21,22,941
2020-04-01,전남,세종,91,1,3,8,16,4,123,141,2,3,5,14,1,166
2020-04-01,전남,울산,155,13,24,6,43,9,250,183,10,24,17,22,6,262
2020-04-01,전남,전남,43321,1436,1480,1778,5110,1701,54826,43321,1436,1480,1778,5110,1701,54826
2020-04-01,전남,전북,4488,305,530,525,1447,129,7424,4594,258,447,624,1326,130,7379
2020-04-01,전남,충남,3750,114,343,684,1193,111,6195,4028,96,360,532,857,101,5974
2020-04-01,전남,충북,286,21,40,89,232,7,675,315,23,26,109,243,4,720
2020-04-01,전북,강원,99,9,9,20,21,0,158,82,1,10,11,16,2,122
2020-04-01,전북,경기,1073,68,118,181,207,48,1695,1156,53,125,124,200,42,1700
2020-04-01,전북,경남,839,36,103,125,204,32,1339,864,51,100,119,200,38,1372
2020-04-01,전북,경북,1368,107,165,156,257,38,2091,1569,103,165,194,307,50,2388
2020-04-01,전북,광주,6981,442,423,311,477,261,8895,6933,433,498,380,466,246,8956
2020-04-01,전북,대구,232,12,27,23,18,4,316,241,8,34,17,22,9,331
2020-04-01,전북,대전,2764,116,104,68,57,125,3234,2817,110,87,75,50,121,3260
2020-04-01,전북,부산,183,3,20,47,60,6,319,208,9,31,47,121,6,422
2020-04-01,전북,서울,1001,20,30,36,31,34,1152,1161,16,33,27,21,42,1300
2020-04-01,전북,세종,518,11,19,22,40,23,633,549,18,22,18,35,33,675
2020-04-01,전북,울산,27,3,3,2,4,0,39,32,3,5,1,14,0,55
2020-04-01,전북,전남,4594,258,447,624,1326,130,7379,4488,305,530,525,1447,129,7424
2020-04-01,전북,전북,15674,748,868,854,937,601,19682,15674,748,868,854,937,601,19682
2020-04-01,전북,충남,11754,522,1279,1136,1534,405,16630,11988,513,1223,1014,1509,408,16655
2020-04-01,전북,충북,1468,135,177,272,263,48,2363,1508,147,212,314,295,60,2536
2020-04-01,충남,강원,345,13,17,45,72,4,496,223,4,26,22,49,5,329
2020-04-01,충남,경기,34801,1541,2506,2555,4444,1839,47686,35800,1564,2652,2565,4710,1920,49211
2020-04-01,충남,경남,1215,72,147,321,497,37,2289,897,46,103,264,268,33,1611
2020-04-01,충남,경북,2555,156,369,544,736,89,4449,2414,166,347,593,614,80,4214
2020-04-01,충남,광주,3569,138,389,671,358,81,5206,3382,128,390,459,256,73,4688
2020-04-01,충남,대구,675,61,105,168,251,27,1287,958,77,127,209,243,31,1645
2020-04-01,충남,대전,14389,469,461,278,305,1044,16946,15628,485,541,336,346,1182,18518
2020-04-01,충남,부산,105,9,22,89,193,3,421,118,12,25,51,142,3,351
2020-04-01,충남,서울,23903,625,1657,1345,1324,975,29829,24261,516,1663,857,773,923,28993
2020-04-01,충남,세종,4069,136,137,135,175,224,4876,5280,159,178,142,173,292,6224
2020-04-01,충남,울산,100,8,7,39,107,5,266,103,7,17,52,126,4,309
2020-04-01,충남,전남,4028,96,360,532,857,101,5974,3750,114,343,684,1193,111,6195
2020-04-01,충남,전북,11988,513,1223,1014,1509,408,16655,11754,522,1279,1136,1534,405,16630
2020-04-01,충남,충남,89936,3914,6893,7702,10793,4106,123344,89936,3914,6893,7702,10793,4106,123344
2020-04-01,충남,충북,12985,681,886,1042,1494,757,17845,12046,656,832,901,1471,657,16563
2020-04-01,충북,강원,4175,205,235,247,403,251,5516,4065,242,266,298,477,245,5593
2020-04-01,충북,경기,25190,2191,2746,2993,3961,1194,38275,25870,2281,2923,3449,3739,1262,39524
2020-04-01,충북,경남,1061,58,180,463,527,41,2330,823,48,97,280,235,27,1510
2020-04-01,충북,경북,3985,235,509,668,1191,126,6714,4063,228,490,752,1064,153,6750
2020-04-01,충북,광주,547,36,85,178,113,12,971,479,28,56,125,63,11,762
2020-04-01,충북,대구,777,74,140,218,150,18,1377,1092,88,148,259,373,31,1991
2020-04-01,충북,대전,9412,441,380,191,137,716,11277,10403,496,415,219,151,769,12453
2020-04-01,충북,부산,88,11,36,117,163,4,419,85,8,23,83,170,4,373
2020-04-01,충북,서울,12669,713,884,935,975,485,16661,12911,563,916,836,774,476,16476
2020-04-01,충북,세종,327,20,25,18,18,21,429,370,14,20,25,19,27,475
2020-04-01,충북,울산,16,0,3,18,29,1,67,13,4,6,12,45,0,80
2020-04-01,충북,전남,315,23,26,109,243,4,720,286,21,40,89,232,7,675
2020-04-01,충북,전북,1508,147,212,314,295,60,2536,1468,135,177,272,263,48,2363
2020-04-01,충북,충남,12046,656,832,901,1471,657,16563,12985,681,886,1042,1494,757,17845
2020-04-01,충북,충북,35034,2149,2297,2315,3336,1990,47121,35034,2149,2297,2315,3336,1990,47121
2020-04-02,강원,강원,61747,2557,2371,1412,3242,4127,75456,61747,2557,2371,1412,3242,4127,75456
2020-04-02,강원,경기,18953,621,882,641,819,822,22738,20803,676,861,765,1009,936,25050
2020-04-02,강원,경남,108,3,9,14,21,1,156,81,3,10,16,17,2,129
2020-04-02,강원,경북,311,19,24,14,20,8,396,312,19,21,34,27,9,422
2020-04-02,강원,광주,63,3,7,9,9,1,92,61,3,9,6,9,0,88
2020-04-02,강원,대구,128,4,6,12,9,2,161,149,5,10,23,15,8,210
2020-04-02,강원,대전,116,7,8,3,0,5,139,113,8,10,5,4,7,147
2020-04-02,강원,부산,2,0,0,2,4,0,8,2,1,0,2,2,0,7
2020-04-02,강원,서울,730,13,118,18,34,27,940,841,17,104,13,9,27,1011
2020-04-02,강원,세종,6,0,1,1,0,0,8,7,0,1,0,1,1,10
2020-04-02,강원,울산,2,0,1,0,1,0,4,0,0,0,1,1,0,2
2020-04-02,강원,전남,28,0,2,4,19,1,54,52,0,2,4,9,1,68
2020-04-02,강원,전북,107,5,10,14,14,3,153,101,7,16,19,22,3,168
2020-04-02,강원,충남,256,8,12,22,32,7,337,364,13,18,40,78,5,518
2020-04-02,강원,충북,4204,265,278,284,475,289,5795,4364,221,248,221,385,250,5689
2020-04-02,경기,강원,20803,676,861,765,1009,936,25050,18953,621,882,641,819,822,22738
2020-04-02,경기,경기,430364,23784,24374,20008,24665,31123,554318,430364,23784,24374,20008,24665,31123,554318
2020-04-02,경기,경남,2506,99,297,790,644,74,4410,1713,82,231,566,490,58,3140
2020-04-02,경기,경북,3192,209,421,784,622,91,5319,3202,213,370,967,616,106,5474
2020-04-02,경기,광주,701,37,114,338,152,15,1357,547,16,81,243,118,12,1017
2020-04-02,경기,대구,1320,97,161,407,235,38,2258,1948,114,139,449,445,57,3152
2020-04-02,경기,대전,1897,102,135,125,58,85,2402,1756,115,138,91,50,74,2224
2020-04-02,경기,부산,215,22,58,207,183,6,691,195,15,33,157,297,7,704
2020-04-02,경기,서울,148928,7496,8464,5419,4105,9660,184072,147305,7036,8857,5015,3701,9525,181439
2020-04-02,경기,세종,42,1,5,3,1,2,54,45,6,3,1,2,1,58
2020-04-02,경기,울산,25,3,4,9,14,0,55,34,1,8,35,91,0,169
2020-04-02,경기,전남,723,18,74,159,164,21,1159,629,28,55,161,160,11,1044
2020-04-02,경기,전북,1134,58,134,147,197,44,1714,1159,56,116,180,203,40,1754
2020-04-02,경기,충남,37190,1619,2639,2667,4775,1950,50840,36137,1570,2455,2502,4321,1883,48868
2020-04-02,경기,충북,26271,2280,2847,3364,3727,1267,39756,25624,2181,2687,2897,4032,1193,38614
2020-04-02,경남,강원,81,3,10,16,17,2,129,108,3,9,14,21,1,156
2020-04-02,경남,경기,1713,82,231,566,490,58,3140,2506,99,297,790,644,74,4410
2020-04-02,경남,경남,185464,10334,9771,7480,14022,13611,240682,185464,10334,9771,7480,14022,13611,240682
2020-04-02,경남,경북,8319,609,900,884,1929,366,13007,10245,852,1102,1197,2751,475,16622
2020-04-02,경남,광주,872,54,128,189,143,23,1409,845,47,134,160,90,25,1301
2020-04-02,경남,대구,10043,762,787,1053,1815,366,14826,7800,485,575,424,516,297,10097
2020-04-02,경남,대전,603,22,73,79,46,31,854,818,36,96,115,65,43,1173
2020-04-02,경남,부산,83715,2701,2541,1616,4671,6003,101247,83440,2843,2663,1725,4684,5947,101302
2020-04-02,경남,서울,1699,53,270,325,176,52,2575,2428,61,311,190,121,57,3168
2020-04-02,경남,세종,105,2,10,9,9,9,144,185,4,10,20,24,8,251
2020-04-02,경남,울산,8769,647,672,498,644,583,11813,8389,581,684,404,578,503,11139
2020-04-02,경남,전남,5551,279,393,494,1458,233,8408,5456,293,406,427,1391,242,8215
2020-04-02,경남,전북,1005,62,93,106,211,25,1502,950,42,93,106,210,21,1422
2020-04-02,경남,충남,961,52,119,255,247,30,1664,1434,67,168,368,588,53,2678
2020-04-02,경남,충북,911,54,121,294,283,27,1690,1191,92,188,495,629,37,2632
2020-04-02,경북,강원,312,19,21,34,27,9,422,311,19,24,14,20,8,396
2020-04-02,경북,경기,3202,213,370,967,616,106,5474,3192,209,421,784,622,91,5319
2020-04-02,경북,경남,10245,852,1102,1197,2751,475,16622,8319,609,900,884,1929,366,13007
2020-04-02,경북,경북,67913,3949,3902,3035,5835,3629,88263,67913,3949,3902,3035,5835,3629,88263
2020-04-02,경북,광주,706,64,121,226,165,20,1302,585,48,80,177,111,12,1013
2020-04-02,경북,대구,67164,2966,2330,1699,3346,3538,81043,70376,3174,2728,2046,4020,3579,85923
2020-04-02,경북,대전,1413,50,94,122,90,60,1829,1404,47,84,119,78,62,1794
2020-04-02,경북,부산,4162,129,206,195,710,217,5619,4188,119,191,221,819,223,5761
2020-04-02,경북,서울,2266,115,214,482,166,81,3324,2448,78,217,245,127,81,3196
2020-04-02,경북,세종,226,1,17,28,12,11,295,211,8,12,21,17,9,278
2020-04-02,경북,울산,5230,159,280,416,988,284,7357,5025,145,293,331,1279,277,7350
2020-04-02,경북,전남,940,47,67,127,411,23,1615,899,51,80,111,497,27,1665
2020-04-02,경북,전북,1701,92,193,222,352,57,2617,1465,123,194,162,344,43,2331
2020-04-02,경북,충남,2559,163,344,594,667,100,4427,2731,154,343,563,829,98,4718
2020-04-02,경북,충북,4331,270,507,715,1009,154,6986,4275,296,500,750,1147,166,7134
2020-04-02,광주,강원,61,3,9,6,9,0,88,63,3,7,9,9,1,92
2020-04-02,광주,경기,547,16,81,243,118,12,1017,701,37,114,338,152,15,1357
2020-04-02,광주,경남,845,47,134,160,90,25,1301,872,54,128,189,143,23,1409
2020-04-02,광주,경북,585,48,80,177,111,12,1013,706,64,121,226,165,20,1302
2020-04-02,광주,광주,13993,550,611,394,372,550,16470,13993,550,611,394,372,550,16470
2020-04-02,광주,대구,393,25,51,78,34,13,594,416,25,65,69,41,12,628
2020-04-02,광주,대전,366,19,11,31,14,13,454,413,21,13,27,20,13,507
2020-04-02,광주,부산,296,15,25,46,60,5,447,314,18,40,63,103,7,545
2020-04-02,광주,서울,558,11,17,81,23,13,703,727,21,23,65,28,16,880
2020-04-02,광주,세종,104,3,6,5,1,0,119,122,4,9,6,4,5,150
2020-04-02,광주,울산,43,2,5,4,8,0,62,42,2,7,8,14,2,75
2020-04-02,광주,전남,33466,1050,1114,934,1852,1307,39723,32025,1055,940,813,1824,1224,37881
2020-04-02,광주,전북,7212,475,506,360,421,271,9245,7263,474,456,344,436,278,9251
2020-04-02,광주,충남,3597,115,391,475,302,95,4975,3678,160,408,626,395,108,5375
2020-04-02,광주,충북,465,30,59,107,67,7,735,527,30,86,168,109,14,934
2020-04-02,대구,강원,149,5,10,23,15,8,210,128,4,6,12,9,2,161
2020-04-02,대구,경기,1948,114,139,449,445,57,3152,1320,97,161,407,235,38,2258
2020-04-02,대구,경남,7800,485,575,424,516,297,10097,10043,762,787,1053,1815,366,14826
2020-04-02,대구,경북,70376,3174,2728,2046,4020,3579,85923,67164,2966,2330,1699,3346,3538,81043
2020-04-02,대구,광주,416,25,65,69,41,12,628,393,25,51,78,34,13,594
2020-04-02,대구,대구,56145,2122,1619,887,1261,3758,65792,56145,2122,1619,887,1261,3758,65792
2020-04-02,대구,대전,578,45,40,81,46,18,808,406,24,18,54,16,21,539
2020-04-02,대구,부산,482,51,110,75,143,17,878,2160,88,163,105,265,86,2867
2020-04-02,대구,서울,1902,80,101,263,116,44,2506,1153,52,60,131,46,32,1474
2020-04-02,대구,세종,154,2,6,12,16,4,194,111,5,2,6,3,2,129
2020-04-02,대구,울산,892,50,70,82,148,39,1281,885,57,70,99,153,38,1302
2020-04-02,대구,전남,402,15,40,23,33,7,520,379,19,36,30,50,8,522
2020-04-02,대구,전북,237,10,26,16,17,4,310,257,13,24,12,17,5,328
2020-04-02,대구,충남,1127,76,137,189,266,29,1824,796,57,106,158,212,33,1362
2020-04-02,대구,충북,1247,98,149,253,403,32,2182,899,83,125,244,130,20,1501
2020-04-02,대전,강원,113,8,10,5,4,7,147,116,7,8,3,0,5,139
2020-04-02,대전,경기,1756,115,138,91,50,74,2224,1897,102,135,125,58,85,2402
2020-04-02,대전,경남,818,36,96,115,65,43,1173,603,22,73,79,46,31,854
2020-04-02,대전,경북,1404,47,84,119,78,62,1794,1413,50,94,122,90,60,1829
2020-04-02,대전,광주,413,21,13,27,20,13,507,366,19,11,31,14,13,454
2020-04-02,대전,대구,406,24,18,54,16,21,539,578,45,40,81,46,18,808
2020-04-02,대전,대전,14135,422,489,570,165,1022,16803,14135,422,489,570,165,1022,16803
2020-04-02,대전,부산,65,6,6,27,12,2,118,58,4,8,19,15,2,106
2020-04-02,대전,서울,1631,44,102,47,9,44,1877,1665,42,107,44,14,71,1943
2020-04-02,대전,세종,3261,108,70,34,73,269,3815,3415,102,79,42,76,267,3981
2020-04-02,대전,울산,82,2,5,22,32,2,145,78,4,6,19,27,1,135
2020-04-02,대전,전남,285,13,6,31,28,8,371,278,14,12,17,19,6,346
2020-04-02,대전,전북,2892,97,90,81,51,127,3338,2809,119,100,93,47,132,3300
2020-04-02,대전,충남,15893,506,554,257,267,1220,18697,14431,463,479,257,220,1095,16945
2020-04-02,대전,충북,11064,483,437,210,203,787,13184,9850,400,389,172,165,672,11648
2020-04-02,부산,강원,2,1,0,2,2,0,7,2,0,0,2,4,0,8
2020-04-02,부산,경기,195,15,33,157,297,7,704,215,22,58,207,183,6,691
2020-04-02,부산,경남,83440,2843,2663,1725,4684,5947,101302,83715,2701,2541,1616,4671,6003,101247
2020-04-02,부산,경북,4188,119,191,221,819,223,5761,4162,129,206,195,710,217,5619
2020-04-02,부산,광주,314,18,40,63,103,7,545,296,15,25,46,60,5,447
2020-04-02,부산,대구,2160,88,163,105,265,86,2867,482,51,110,75,143,17,878
2020-04-02,부산,대전,58,4,8,19,15,2,106,65,6,6,27,12,2,118
2020-04-02,부산,부산,42474,717,577,606,2096,3119,49589,42474,717,577,606,2096,3119,49589
2020-04-02,부산,서울,156,10,26,82,80,2,356,199,10,14,67,40,4,334
2020-04-02,부산,세종,14,1,0,1,3,0,19,16,0,0,2,3,0,21
2020-04-02,부산,울산,14896,382,424,593,2299,1110,19704,14980,421,423,458,2222,1160,19664
2020-04-02,부산,전남,1752,87,116,193,541,66,2755,1570,88,102,148,579,61,2548
2020-04-02,부산,전북,246,12,23,59,110,4,454,240,10,21,46,72,8,397
2020-04-02,부산,충남,116,16,31,62,150,6,381,116,17,24,79,177,5,418
2020-04-02,부산,충북,86,5,18,94,231,3,437,93,12,28,124,209,3,469
2020-04-02,서울,강원,841,17,104,13,9,27,1011,730,13,118,18,34,27,940
2020-04-02,서울,경기,147305,7036,8857,5015,3701,9525,181439,148928,7496,8464,5419,4105,9660,184072
2020-04-02,서울,경남,2428,61,311,190,121,57,3168,1699,53,270,325,176,52,2575
2020-04-02,서울,경북,2448,78,217,245,127,81,3196,2266,115,214,482,166,81,3324
2020-04-02,서울,광주,727,21,23,65,28,16,880,558,11,17,81,23,13,703
2020-04-02,서울,대구,1153,52,60,131,46,32,1474,1902,80,101,263,116,44,2506
2020-04-02,서울,대전,1665,42,107,44,14,71,1943,1631,44,102,47,9,44,1877
2020-04-02,서울,부산,199,10,14,67,40,4,334,156,10,26,82,80,2,356
2020-04-02,서울,서울,197,8,13,1,3,10,232,197,8,13,1,3,10,232
2020-04-02,서울,세종,32,2,4,2,0,0,40,30,0,1,1,1,2,35
2020-04-02,서울,울산,23,0,0,0,1,0,24,18,1,2,18,25,1,65
2020-04-02,서울,전남,856,15,22,36,24,26,979,750,11,20,81,57,25,944
2020-04-02,서울,전북,1216,21,44,28,31,33,1373,1128,24,49,40,22,37,1300
2020-04-02,서울,충남,25716,533,1663,803,785,1037,30537,25867,673,1730,1372,1354,1026,32022
2020-04-02,서울,충북,13289,526,832,801,808,493,16749,13195,634,850,879,953,480,16991
2020-04-02,세종,강원,7,0,1,0,1,1,10,6,0,1,1,0,0,8
2020-04-02,세종,경기,45,6,3,1,2,1,58,42,1,5,3,1,2,54
2020-04-02,세종,경남,185,4,10,20,24,8,251,105,2,10,9,9,9,144
2020-04-02,세종,경북,211,8,12,21,17,9,278,226,1,17,28,12,11,295
2020-04-02,세종,광주,122,4,9,6,4,5,150,104,3,6,5,1,0,119
2020-04-02,세종,대구,111,5,2,6,3,2,129,154,2,6,12,16,4,194
2020-04-02,세종,대전,3415,102,79,42,76,267,3981,3261,108,70,34,73,269,3815
2020-04-02,세종,부산,16,0,0,2,3,0,21,14,1,0,1,3,0,19
2020-04-02,세종,서울,30,0,1,1,1,2,35,32,2,4,2,0,0,40
2020-04-02,세종,세종,215,19,2,1,0,13,250,215,19,2,1,0,13,250
2020-04-02,세종,울산,5,0,0,0,2,0,7,10,1,0,0,5,1,17
2020-04-02,세종,전남,160,4,4,2,13,3,186,118,3,3,4,17,4,149
2020-04-02,세종,전북,536,17,24,14,21,20,632,503,12,19,16,32,25,607
2020-04-02,세종,충남,5574,151,162,129,202,287,6505,4205,137,153,129,182,201,5007
2020-04-02,세종,충북,373,15,16,16,16,26,462,327,17,14,17,18,27,420
2020-04-02,울산,강원,0,0,0,1,1,0,2,2,0,1,0,1,0,4
2020-04-02,울산,경기,34,1,8,35,91,0,169,25,3,4,9,14,0,55
2020-04-02,울산,경남,8389,581,684,404,578,503,11139,8769,647,672,498,644,583,11813
2020-04-02,울산,경북,5025,145,293,331,1279,277,7350,5230,159,280,416,988,284,7357
2020-04-02,울산,광주,42,2,7,8,14,2,75,43,2,5,4,8,0,62
2020-04-02,울산,대구,885,57,70,99,153,38,1302,892,50,70,82,148,39,1281
2020-04-02,울산,대전,78,4,6,19,27,1,135,82,2,5,22,32,2,145
2020-04-02,울산,부산,14980,421,423,458,2222,1160,19664,14896,382,424,593,2299,1110,19704
2020-04-02,울산,서울,18,1,2,18,25,1,65,23,0,0,0,1,0,24
2020-04-02,울산,세종,10,1,0,0,5,1,17,5,0,0,0,2,0,7
2020-04-02,울산,울산,8225,324,470,303,644,742,10708,8225,324,470,303,644,742,10708
2020-04-02,울산,전남,173,12,18,12,27,7,249,183,15,27,11,55,8,299
2020-04-02,울산,전북,37,1,3,2,10,0,53,24,0,4,3,7,1,39
2020-04-02,울산,충남,112,7,19,51,150,2,341,106,7,7,36,108,1,265
2020-04-02,울산,충북,16,0,5,21,52,1,95,18,1,4,18,32,1,74
2020-04-02,전남,강원,52,0,2,4,9,1,68,28,0,2,4,19,1,54
2020-04-02,전남,경기,629,28,55,161,160,11,1044,723,18,74,159,164,21,1159
2020-04-02,전남,경남,5456,293,406,427,1391,242,8215,5551,279,393,494,1458,233,8408
2020-04-02,전남,경북,899,51,80,111,497,27,1665,940,47,67,127,411,23,1615
2020-04-02,전남,광주,32025,1055,940,813,1824,1224,37881,33466,1050,1114,934,1852,1307,39723
2020-04-02,전남,대구,379,19,36,30,50,8,522,402,15,40,23,33,7,520
2020-04-02,전남,대전,278,14,12,17,19,6,346,285,13,6,31,28,8,371
2020-04-02,전남,부산,1570,88,102,148,579,61,2548,1752,87,116,193,541,66,2755
2020-04-02,전남,서울,750,11,20,81,57,25,944,856,15,22,36,24,26,979
2020-04-02,전남,세종,118,3,3,4,17,4,149,160,4,4,2,13,3,186
2020-04-02,전남,울산,183,15,27,11,55,8,299,173,12,18,12,27,7,249
2020-04-02,전남,전남,42227,1390,1548,1651,5039,1664,53519,42227,1390,1548,1651,5039,1664,53519
2020-04-02,전남,전북,4752,302,504,562,1471,151,7742,4625,271,413,599,1459,118,7485
2020-04-02,전남,충남,3930,116,358,716,1125,93,6338,4294,103,371,554,970,127,6419
2020-04-02,전남,충북,339,16,29,95,246,15,740,349,20,26,121,233,14,763
2020-04-02,전북,강원,101,7,16,19,22,3,168,107,5,10,14,14,3,153
2020-04-02,전북,경기,1159,56,116,180,203,40,1754,1134,58,134,147,197,44,1714
2020-04-02,전북,경남,950,42,93,106,210,21,1422,1005,62,93,106,211,25,1502
2020-04-02,전북,경북,1465,123,194,162,344,43,2331,1701,92,193,222,352,57,2617
2020-04-02,전북,광주,7263,474,456,344,436,278,9251,7212,475,506,360,421,271,9245
2020-04-02,전북,대구,257,13,24,12,17,5,328,237,10,26,16,17,4,310
2020-04-02,전북,대전,2809,119,100,93,47,132,3300,2892,97,90,81,51,127,3338
2020-04-02,전북,부산,240,10,21,46,72,8,397,246,12,23,59,110,4,454
2020-04-02,전북,서울,1128,24,49,40,22,37,1300,1216,21,44,28,31,33,1373
2020-04-02,전북,세종,503,12,19,16,32,25,607,536,17,24,14,21,20,632
2020-04-02,전북,울산,24,0,4,3,7,1,39,37,1,3,2,10,0,53
2020-04-02,전북,전남,4625,271,413,599,1459,118,7485,4752,302,504,562,1471,151,7742
2020-04-02,전북,전북,16351,793,962,670,994,607,20377,16351,793,962,670,994,607,20377
2020-04-02,전북,충남,12395,608,1353,1185,1546,373,17460,12637,561,1296,969,1502,389,17354
2020-04-02,전북,충북,1614,119,170,315,290,52,2560,1514,130,230,293,329,49,2545
2020-04-02,충남,강원,364,13,18,40,78,5,518,256,8,12,22,32,7,337
2020-04-02,충남,경기,36137,1570,2455,2502,4321,1883,48868,37190,1619,2639,2667,4775,1950,50840
2020-04-02,충남,경남,1434,67,168,368,588,53,2678,961,52,119,255,247,30,1664
2020-04-02,충남,경북,2731,154,343,563,829,98,4718,2559,163,344,594,667,100,4427
2020-04-02,충남,광주,3678,160,408,626,395,108,5375,3597,115,391,475,302,95,4975
2020-04-02,충남,대구,796,57,106,158,212,33,1362,1127,76,137,189,266,29,1824
2020-04-02,충남,대전,14431,463,479,257,220,1095,16945,15893,506,554,257,267,1220,18697
2020-04-02,충남,부산,116,17,24,79,177,5,418,116,16,31,62,150,6,381
2020-04-02,충남,서울,25867,673,1730,1372,1354,1026,32022,25716,533,1663,803,785,1037,30537
2020-04-02,충남,세종,4205,137,153,129,182,201,5007,5574,151,162,129,202,287,6505
2020-04-02,충남,울산,106,7,7,36,108,1,265,112,7,19,51,150,2,341
2020-04-02,충남,전남,4294,103,371,554,970,127,6419,3930,116,358,716,1125,93,6338
2020-04-02,충남,전북,12637,561,1296,969,1502,389,17354,12395,608,1353,1185,1546,373,17460
2020-04-02,충남,충남,94828,4139,6900,7397,10942,4282,128488,94828,4139,6900,7397,10942,4282,128488
2020-04-02,충남,충북,13620,716,833,983,1585,750,18487,12302,673,776,868,1541,699,16859
2020-04-02,충북,강원,4364,221,248,221,385,250,5689,4204,265,278,284,475,289,5795
2020-04-02,충북,경기,25624,2181,2687,2897,4032,1193,38614,26271,2280,2847,3364,3727,1267,39756
2020-04-02,충북,경남,1191,92,188,495,629,37,2632,911,54,121,294,283,27,1690
2020-04-02,충북,경북,4275,296,500,750,1147,166,7134,4331,270,507,715,1009,154,6986
2020-04-02,충북,광주,527,30,86,168,109,14,934,465,30,59,107,67,7,735
2020-04-02,충북,대구,899,83,125,244,130,20,1501,1247,98,149,253,403,32,2182
2020-04-02,충북,대전,9850,400,389,172,165,672,11648,11064,483,437,210,203,787,13184
2020-04-02,충북,부산,93,12,28,124,209,3,469,86,5,18,94,231,3,437
2020-04-02,충북,서울,13195,634,850,879,953,480,16991,13289,526,832,801,808,493,16749
2020-04-02,충북,세종,327,17,14,17,18,27,420,373,15,16,16,16,26,462
2020-04-02,충북,울산,18,1,4,18,32,1,74,16,0,5,21,52,1,95
2020-04-02,충북,전남,349,20,26,121,233,14,763,339,16,29,95,246,15,740
2020-04-02,충북,전북,1514,130,230,293,329,49,2545,1614,119,170,315,290,52,2560
2020-04-02,충북,충남,12302,673,776,868,1541,699,16859,13620,716,833,983,1585,750,18487
2020-04-02,충북,충북,35966,2079,2421,2327,3455,1959,48207,35966,2079,2421,2327,3455,1959,48207
2020-04-03,강원,강원,77952,2580,2525,1582,2991,4677,92307,77952,2580,2525,1582,2991,4677,92307
2020-04-03,강원,경기,23056,663,871,660,790,1082,27122,32293,712,855,724,996,1406,36986
2020-04-03,강원,경남,160,1,4,11,11,6,193,109,3,3,14,11,4,144
2020-04-03,강원,경북,446,24,25,19,24,16,554,451,19,21,32,38,18,579
2020-04-03,강원,광주,86,2,6,7,11,1,113,69,2,5,18,4,1,99
2020-04-03,강원,대구,169,4,10,8,16,7,214,260,6,14,27,12,9,328
2020-04-03,강원,대전,179,3,14,5,1,5,207,214,6,9,9,5,8,251
2020-04-03,강원,부산,4,0,0,0,0,0,4,8,0,0,4,3,1,16
2020-04-03,강원,서울,853,13,143,13,36,36,1094,1084,20,126,13,15,37,1295
2020-04-03,강원,세종,4,0,0,0,0,0,4,9,0,0,0,0,2,11
2020-04-03,강원,울산,2,0,0,0,0,0,2,2,0,0,0,1,0,3
2020-04-03,강원,전남,58,0,5,2,9,2,76,59,2,3,19,14,3,100
2020-04-03,강원,전북,124,6,17,11,16,5,179,140,2,18,21,18,6,205
2020-04-03,강원,충남,317,8,24,24,30,19,422,599,14,25,45,53,28,764
2020-04-03,강원,충북,5048,251,280,294,399,281,6553,5533,229,235,227,409,319,6952
2020-04-03,경기,강원,32293,712,855,724,996,1406,36986,23056,663,871,660,790,1082,27122
2020-04-03,경기,경기,460756,23675,24221,19947,24775,32630,586004,460756,23675,24221,19947,24775,32630,586004
2020-04-03,경기,경남,3722,93,284,745,619,154,5617,2531,76,250,538,422,100,3917
2020-04-03,경기,경북,4924,171,425,750,636,166,7072,4537,176,437,946,614,164,6874
2020-04-03,경기,광주,1375,37,120,327,186,43,2088,759,27,77,267,108,25,1263
2020-04-03,경기,대구,1908,99,172,383,234,53,2849,2828,123,142,457,437,99,4086
2020-04-03,경기,대전,3064,99,136,139,58,140,3636,2284,92,148,109,60,117,2810
2020-04-03,경기,부산,301,19,52,209,169,9,759,305,18,35,137,285,9,789
2020-04-03,경기,서울,155077,7429,8563,5237,4061,10261,190628,148879,7098,8762,4787,3531,9655,182712
2020-04-03,경기,세종,81,1,5,3,3,4,97,55,3,7,6,2,4,77
2020-04-03,경기,울산,42,2,5,9,18,0,76,53,3,8,41,76,2,183
2020-04-03,경기,전남,1468,19,81,156,155,36,1915,920,16,46,127,160,26,1295
2020-04-03,경기,전북,2348,51,128,133,214,84,2958,1516,52,111,179,206,61,2125
2020-04-03,경기,충남,47940,1618,2641,2596,4769,2416,61980,46153,1573,2439,2514,4428,2331,59438
2020-04-03,경기,충북,33685,2256,2920,3426,3676,1639,47602,31870,2198,2758,2862,4017,1481,45186
2020-04-03,경남,강원,109,3,3,14,11,4,144,160,1,4,11,11,6,193
2020-04-03,경남,경기,2531,76,250,538,422,100,3917,3722,93,284,745,619,154,5617
2020-04-03,경남,경남,203198,10188,9438,7228,14181,14714,258947,203198,10188,9438,7228,14181,14714,258947
2020-04-03,경남,경북,10307,584,898,909,2013,480,15191,13421,860,1094,1255,2788,685,20103
2020-04-03,경남,광주,1385,53,110,188,146,41,1923,1143,52,131,169,101,45,1641
2020-04-03,경남,대구,12169,769,771,1031,1575,473,16788,9477,489,566,433,522,380,11867
2020-04-03,경남,대전,935,22,74,78,33,33,1175,1202,34,80,112,57,54,1539
2020-04-03,경남,부산,92293,2789,2631,1670,4702,6433,110518,90188,2815,2721,1734,4721,6379,108558
2020-04-03,경남,서울,2331,36,307,270,127,61,3132,3115,35,324,201,110,95,3880
2020-04-03,경남,세종,234,4,10,22,8,8,286,377,0,5,12,16,9,419
2020-04-03,경남,울산,10109,668,619,465,676,644,13181,9832,593,659,417,675,630,12806
2020-04-03,경남,전남,6602,274,412,542,1404,292,9526,7088,325,450,466,1376,330,10035
2020-04-03,경남,전북,1367,49,107,102,181,54,1860,1337,43,106,124,177,44,1831
2020-04-03,경남,충남,1334,48,116,279,256,37,2070,2487,59,198,361,513,108,3726
2020-04-03,경남,충북,1197,53,114,265,285,45,1959,1875,72,196,495,631,88,3357
2020-04-03,경북,강원,451,19,21,32,38,18,579,446,24,25,19,24,16,554
2020-04-03,경북,경기,4537,176,437,946,614,164,6874,4924,171,425,750,636,166,7072
2020-04-03,경북,경남,13421,860,1094,1255,2788,685,20103,10307,584,898,909,2013,480,15191
2020-04-03,경북,경북,76191,3987,3897,2926,5839,3935,96775,76191,3987,3897,2926,5839,3935,96775
2020-04-03,경북,광주,996,63,125,192,141,22,1539,666,47,99,170,89,15,1086
2020-04-03,경북,대구,73465,3012,2325,1751,3602,3869,88024,75929,3179,2663,2045,3990,3925,91731
2020-04-03,경북,대전,2040,65,89,108,89,70,2461,1781,61,65,131,62,78,2178
2020-04-03,경북,부산,5158,123,224,207,672,238,6622,5072,116,213,190,786,221,6598
2020-04-03,경북,서울,2990,103,257,417,160,105,4032,3477,86,233,241,130,101,4268
2020-04-03,경북,세종,327,8,19,23,17,17,411,300,15,21,19,15,15,385
2020-04-03,경북,울산,5952,162,302,414,1033,378,8241,5944,145,290,352,1304,350,8385
2020-04-03,경북,전남,1211,47,78,103,415,35,1889,1041,63,77,120,493,26,1820
2020-04-03,경북,전북,2005,107,185,199,325,68,2889,1700,104,165,139,322,48,2478
2020-04-03,경북,충남,3215,151,362,547,631,124,5030,3859,133,389,501,815,136,5833
2020-04-03,경북,충북,5570,222,467,717,1018,208,8202,5406,265,540,669,1165,192,8237
2020-04-03,광주,강원,69,2,5,18,4,1,99,86,2,6,7,11,1,113
2020-04-03,광주,경기,759,27,77,267,108,25,1263,1375,37,120,327,186,43,2088
2020-04-03,광주,경남,1143,52,131,169,101,45,1641,1385,53,110,188,146,41,1923
2020-04-03,광주,경북,666,47,99,170,89,15,1086,996,63,125,192,141,22,1539
2020-04-03,광주,광주,14993,526,604,459,424,621,17627,14993,526,604,459,424,621,17627
2020-04-03,광주,대구,508,32,66,79,32,15,732,542,30,68,70,29,16,755
2020-04-03,광주,대전,478,20,17,22,18,19,574,583,23,27,37,15,24,709
2020-04-03,광주,부산,412,10,30,47,64,12,575,502,11,38,86,116,15,768
2020-04-03,광주,서울,726,17,20,65,28,21,877,1278,18,18,56,27,24,1421
2020-04-03,광주,세종,162,2,7,3,2,7,183,284,6,9,3,1,9,312
2020-04-03,광주,울산,53,2,9,3,3,1,71,74,0,7,6,6,2,95
2020-04-03,광주,전남,36819,1026,1116,816,1807,1439,43023,36700,1032,1029,662,1811,1416,42650
2020-04-03,광주,전북,8189,441,505,349,439,291,10214,8591,480,442,359,467,326,10665
2020-04-03,광주,충남,4594,112,407,456,260,134,5963,6254,118,429,608,335,170,7914
2020-04-03,광주,충북,576,33,69,104,55,15,852,876,33,88,194,117,21,1329
2020-04-03,대구,강원,260,6,14,27,12,9,328,169,4,10,8,16,7,214
2020-04-03,대구,경기,2828,123,142,457,437,99,4086,1908,99,172,383,234,53,2849
2020-04-03,대구,경남,9477,489,566,433,522,380,11867,12169,769,771,1031,1575,473,16788
2020-04-03,대구,경북,75929,3179,2663,2045,3990,3925,91731,73465,3012,2325,1751,3602,3869,88024
2020-04-03,대구,광주,542,30,68,70,29,16,755,508,32,66,79,32,15,732
2020-04-03,대구,대구,58859,2139,1573,1156,1268,3996,68991,58859,2139,1573,1156,1268,3996,68991
2020-04-03,대구,대전,921,30,32,79,41,43,1146,609,24,27,49,27,32,768
2020-04-03,대구,부산,600,57,102,74,152,18,1003,2520,98,173,91,244,86,3212
2020-04-03,대구,서울,2513,82,77,225,127,79,3103,1519,45,61,103,53,42,1823
2020-04-03,대구,세종,259,6,3,15,8,6,297,189,3,2,3,5,5,207
2020-04-03,대구,울산,1096,63,57,63,154,48,1481,1204,51,60,67,177,52,1611
2020-04-03,대구,전남,461,18,29,34,31,10,583,481,23,35,33,53,11,636
2020-04-03,대구,전북,322,10,21,14,22,7,396,342,8,23,20,19,18,430
2020-04-03,대구,충남,1253,80,132,227,233,34,1959,1152,50,110,156,197,35,1700
2020-04-03,대구,충북,1516,122,161,267,414,66,2546,1179,84,120,224,184,47,1838
2020-04-03,대전,강원,214,6,9,9,5,8,251,179,3,14,5,1,5,207
2020-04-03,대전,경기,2284,92,148,109,60,117,2810,3064,99,136,139,58,140,3636
2020-04-03,대전,경남,1202,34,80,112,57,54,1539,935,22,74,78,33,33,1175
2020-04-03,대전,경북,1781,61,65,131,62,78,2178,2040,65,89,108,89,70,2461
2020-04-03,대전,광주,583,23,27,37,15,24,709,478,20,17,22,18,19,574
2020-04-03,대전,대구,609,24,27,49,27,32,768,921,30,32,79,41,43,1146
2020-04-03,대전,대전,14797,436,414,373,190,1133,17343,14797,436,414,373,190,1133,17343
2020-04-03,대전,부산,86,1,6,14,16,2,125,120,3,8,13,20,6,170
2020-04-03,대전,서울,1839,48,115,40,6,84,2132,2276,41,118,33,19,108,2595
2020-04-03,대전,세종,3531,95,60,34,69,265,4054,3640,90,78,34,80,242,4164
2020-04-03,대전,울산,103,4,4,16,30,2,159,157,2,6,12,26,6,209
2020-04-03,대전,전남,411,14,5,27,19,14,490,388,9,12,23,21,13,466
2020-04-03,대전,전북,3393,90,98,67,44,149,3841,3313,105,85,76,45,135,3759
2020-04-03,대전,충남,17143,501,540,391,307,1248,20130,16105,477,485,352,283,1177,18879
2020-04-03,대전,충북,11623,493,408,214,203,832,13773,11038,421,386,178,158,788,12969
2020-04-03,부산,강원,8,0,0,4,3,1,16,4,0,0,0,0,0,4
2020-04-03,부산,경기,305,18,35,137,285,9,789,301,19,52,209,169,9,759
2020-04-03,부산,경남,90188,2815,2721,1734,4721,6379,108558,92293,2789,2631,1670,4702,6433,110518
2020-04-03,부산,경북,5072,116,213,190,786,221,6598,5158,123,224,207,672,238,6622
2020-04-03,부산,광주,502,11,38,86,116,15,768,412,10,30,47,64,12,575
2020-04-03,부산,대구,2520,98,173,91,244,86,3212,600,57,102,74,152,18,1003
2020-04-03,부산,대전,120,3,8,13,20,6,170,86,1,6,14,16,2,125
2020-04-03,부산,부산,46260,710,601,770,2060,3331,53732,46260,710,601,770,2060,3331,53732
2020-04-03,부산,서울,263,11,13,75,86,10,458,213,5,26,66,21,8,339
2020-04-03,부산,세종,22,0,3,3,0,0,28,36,0,2,1,1,1,41
2020-04-03,부산,울산,16309,378,444,585,2410,1177,21303,18062,404,431,430,2179,1324,22830
2020-04-03,부산,전남,2252,78,100,207,551,75,3263,1940,76,103,138,629,81,2967
2020-04-03,부산,전북,377,12,31,24,92,8,544,256,7,20,44,72,6,405
2020-04-03,부산,충남,173,10,31,56,130,4,404,214,15,24,87,170,9,519
2020-04-03,부산,충북,131,11,27,83,214,5,471,139,11,31,137,175,5,498
2020-04-03,서울,강원,1084,20,126,13,15,37,1295,853,13,143,13,36,36,1094
2020-04-03,서울,경기,148879,7098,8762,4787,3531,9655,182712,155077,7429,8563,5237,4061,10261,190628
2020-04-03,서울,경남,3115,35,324,201,110,95,3880,2331,36,307,270,127,61,3132
2020-04-03,서울,경북,3477,86,233,241,130,101,4268,2990,103,257,417,160,105,4032
2020-04-03,서울,광주,1278,18,18,56,27,24,1421,726,17,20,65,28,21,877
2020-04-03,서울,대구,1519,45,61,103,53,42,1823,2513,82,77,225,127,79,3103
2020-04-03,서울,대전,2276,41,118,33,19,108,2595,1839,48,115,40,6,84,2132
2020-04-03,서울,부산,213,5,26,66,21,8,339,263,11,13,75,86,10,458
2020-04-03,서울,서울,185,5,10,1,1,9,211,185,5,10,1,1,9,211
2020-04-03,서울,세종,51,1,0,0,1,2,55,56,0,0,0,0,5,61
2020-04-03,서울,울산,29,1,0,2,1,2,35,30,1,6,7,12,2,58
2020-04-03,서울,전남,1478,11,16,39,18,35,1597,928,11,19,63,36,29,1086
2020-04-03,서울,전북,2390,21,40,22,30,102,2605,1347,30,42,29,24,51,1523
2020-04-03,서울,충남,33524,478,1739,838,771,1248,38598,30325,593,1759,1322,1312,1163,36474
2020-04-03,서울,충북,16558,506,892,834,785,709,20284,15815,624,901,861,945,672,19818
2020-04-03,세종,강원,9,0,0,0,0,2,11,4,0,0,0,0,0,4
2020-04-03,세종,경기,55,3,7,6,2,4,77,81,1,5,3,3,4,97
2020-04-03,세종,경남,377,0,5,12,16,9,419,234,4,10,22,8,8,286
2020-04-03,세종,경북,300,15,21,19,15,15,385,327,8,19,23,17,17,411
2020-04-03,세종,광주,284,6,9,3,1,9,312,162,2,7,3,2,7,183
2020-04-03,세종,대구,189,3,2,3,5,5,207,259,6,3,15,8,6,297
2020-04-03,세종,대전,3640,90,78,34,80,242,4164,3531,95,60,34,69,265,4054
2020-04-03,세종,부산,36,0,2,1,1,1,41,22,0,3,3,0,0,28
2020-04-03,세종,서울,56,0,0,0,0,5,61,51,1,0,0,1,2,55
2020-04-03,세종,세종,302,27,1,0,1,20,351,302,27,1,0,1,20,351
2020-04-03,세종,울산,6,0,0,1,2,0,9,15,1,1,1,6,1,25
2020-04-03,세종,전남,245,0,4,4,16,7,276,208,3,2,5,18,8,244
2020-04-03,세종,전북,876,19,26,20,29,39,1009,777,13,20,18,24,43,895
2020-04-03,세종,충남,6619,168,146,138,226,352,7649,5307,148,138,137,164,243,6137
2020-04-03,세종,충북,415,17,24,13,21,29,519,347,15,28,9,25,30,454
2020-04-03,울산,강원,2,0,0,0,1,0,3,2,0,0,0,0,0,2
2020-04-03,울산,경기,53,3,8,41,76,2,183,42,2,5,9,18,0,76
2020-04-03,울산,경남,9832,593,659,417,675,630,12806,10109,668,619,465,676,644,13181
2020-04-03,울산,경북,5944,145,290,352,1304,350,8385,5952,162,302,414,1033,378,8241
2020-04-03,울산,광주,74,0,7,6,6,2,95,53,2,9,3,3,1,71
2020-04-03,울산,대구,1204,51,60,67,177,52,1611,1096,63,57,63,154,48,1481
2020-04-03,울산,대전,157,2,6,12,26,6,209,103,4,4,16,30,2,159
2020-04-03,울산,부산,18062,404,431,430,2179,1324,22830,16309,378,444,585,2410,1177,21303
2020-04-03,울산,서울,30,1,6,7,12,2,58,29,1,0,2,1,2,35
2020-04-03,울산,세종,15,1,1,1,6,1,25,6,0,0,1,2,0,9
2020-04-03,울산,울산,8311,331,472,236,587,764,10701,8311,331,472,236,587,764,10701
2020-04-03,울산,전남,223,20,23,8,16,7,297,251,21,23,6,51,9,361
2020-04-03,울산,전북,68,1,6,5,13,3,96,37,0,7,5,7,0,56
2020-04-03,울산,충남,145,4,13,58,116,4,340,195,4,11,34,116,6,366
2020-04-03,울산,충북,31,5,3,15,57,1,112,22,2,1,14,25,1,65
2020-04-03,전남,강원,59,2,3,19,14,3,100,58,0,5,2,9,2,76
2020-04-03,전남,경기,920,16,46,127,160,26,1295,1468,19,81,156,155,36,1915
2020-04-03,전남,경남,7088,325,450,466,1376,330,10035,6602,274,412,542,1404,292,9526
2020-04-03,전남,경북,1041,63,77,120,493,26,1820,1211,47,78,103,415,35,1889
2020-04-03,전남,광주,36700,1032,1029,662,1811,1416,42650,36819,1026,1116,816,1807,1439,43023
2020-04-03,전남,대구,481,23,35,33,53,11,636,461,18,29,34,31,10,583
2020-04-03,전남,대전,388,9,12,23,21,13,466,411,14,5,27,19,14,490
2020-04-03,전남,부산,1940,76,103,138,629,81,2967,2252,78,100,207,551,75,3263
2020-04-03,전남,서울,928,11,19,63,36,29,1086,1478,11,16,39,18,35,1597
2020-04-03,전남,세종,208,3,2,5,18,8,244,245,0,4,4,16,7,276
2020-04-03,전남,울산,251,21,23,6,51,9,361,223,20,23,8,16,7,297
2020-04-03,전남,전남,51351,1508,1495,1786,5057,1927,63124,51351,1508,1495,1786,5057,1927,63124
2020-04-03,전남,전북,5961,277,451,497,1402,169,8757,5845,237,399,570,1397,174,8622
2020-04-03,전남,충남,5558,98,373,645,1022,176,7872,7320,81,382,520,972,174,9449
2020-04-03,전남,충북,486,22,35,105,235,23,906,532,14,36,86,251,17,936
2020-04-03,전북,강원,140,2,18,21,18,6,205,124,6,17,11,16,5,179
2020-04-03,전북,경기,1516,52,111,179,206,61,2125,2348,51,128,133,214,84,2958
2020-04-03,전북,경남,1337,43,106,124,177,44,1831,1367,49,107,102,181,54,1860
2020-04-03,전북,경북,1700,104,165,139,322,48,2478,2005,107,185,199,325,68,2889
2020-04-03,전북,광주,8591,480,442,359,467,326,10665,8189,441,505,349,439,291,10214
2020-04-03,전북,대구,342,8,23,20,19,18,430,322,10,21,14,22,7,396
2020-04-03,전북,대전,3313,105,85,76,45,135,3759,3393,90,98,67,44,149,3841
2020-04-03,전북,부산,256,7,20,44,72,6,405,377,12,31,24,92,8,544
2020-04-03,전북,서울,1347,30,42,29,24,51,1523,2390,21,40,22,30,102,2605
2020-04-03,전북,세종,777,13,20,18,24,43,895,876,19,26,20,29,39,1009
2020-04-03,전북,울산,37,0,7,5,7,0,56,68,1,6,5,13,3,96
2020-04-03,전북,전남,5845,237,399,570,1397,174,8622,5961,277,451,497,1402,169,8757
2020-04-03,전북,전북,17853,785,928,841,1023,683,22113,17853,785,928,841,1023,683,22113
2020-04-03,전북,충남,15234,525,1284,1115,1361,546,20065,18411,507,1236,986,1406,651,23197
2020-04-03,전북,충북,2004,123,184,266,310,78,2965,2248,122,208,284,296,91,3249
2020-04-03,충남,강원,599,14,25,45,53,28,764,317,8,24,24,30,19,422
2020-04-03,충남,경기,46153,1573,2439,2514,4428,2331,59438,47940,1618,2641,2596,4769,2416,61980
2020-04-03,충남,경남,2487,59,198,361,513,108,3726,1334,48,116,279,256,37,2070
2020-04-03,충남,경북,3859,133,389,501,815,136,5833,3215,151,362,547,631,124,5030
2020-04-03,충남,광주,6254,118,429,608,335,170,7914,4594,112,407,456,260,134,5963
2020-04-03,충남,대구,1152,50,110,156,197,35,1700,1253,80,132,227,233,34,1959
2020-04-03,충남,대전,16105,477,485,352,283,1177,18879,17143,501,540,391,307,1248,20130
2020-04-03,충남,부산,214,15,24,87,170,9,519,173,10,31,56,130,4,404
2020-04-03,충남,서울,30325,593,1759,1322,1312,1163,36474,33524,478,1739,838,771,1248,38598
2020-04-03,충남,세종,5307,148,138,137,164,243,6137,6619,168,146,138,226,352,7649
2020-04-03,충남,울산,195,4,11,34,116,6,366,145,4,13,58,116,4,340
2020-04-03,충남,전남,7320,81,382,520,972,174,9449,5558,98,373,645,1022,176,7872
2020-04-03,충남,전북,18411,507,1236,986,1406,651,23197,15234,525,1284,1115,1361,546,20065
2020-04-03,충남,충남,113790,3718,6931,7057,10544,5020,147060,113790,3718,6931,7057,10544,5020,147060
2020-04-03,충남,충북,15054,707,805,1054,1585,871,20076,13196,664,820,923,1525,756,17884
2020-04-03,충북,강원,5533,229,235,227,409,319,6952,5048,251,280,294,399,281,6553
2020-04-03,충북,경기,31870,2198,2758,2862,4017,1481,45186,33685,2256,2920,3426,3676,1639,47602
2020-04-03,충북,경남,1875,72,196,495,631,88,3357,1197,53,114,265,285,45,1959
2020-04-03,충북,경북,5406,265,540,669,1165,192,8237,5570,222,467,717,1018,208,8202
2020-04-03,충북,광주,876,33,88,194,117,21,1329,576,33,69,104,55,15,852
2020-04-03,충북,대구,1179,84,120,224,184,47,1838,1516,122,161,267,414,66,2546
2020-04-03,충북,대전,11038,421,386,178,158,788,12969,11623,493,408,214,203,832,13773
2020-04-03,충북,부산,139,11,31,137,175,5,498,131,11,27,83,214,5,471
2020-04-03,충북,서울,15815,624,901,861,945,672,19818,16558,506,892,834,785,709,20284
2020-04-03,충북,세종,347,15,28,9,25,30,454,415,17,24,13,21,29,519
2020-04-03,충북,울산,22,2,1,14,25,1,65,31,5,3,15,57,1,112
2020-04-03,충북,전남,532,14,36,86,251,17,936,486,22,35,105,235,23,906
2020-04-03,충북,전북,2248,122,208,284,296,91,3249,2004,123,184,266,310,78,2965
2020-04-03,충북,충남,13196,664,820,923,1525,756,17884,15054,707,805,1054,1585,871,20076
2020-04-03,충북,충북,40399,2057,2337,2488,3523,2274,53078,40399,2057,2337,2488,3523,2274,53078
2020-04-04,강원,강원,88947,1721,1717,906,2434,4418,100143,88947,1721,1717,906,2434,4418,100143
2020-04-04,강원,경기,32986,352,587,364,438,1367,36094,44075,376,574,414,580,1764,47783
2020-04-04,강원,경남,128,1,9,4,10,4,156,107,1,5,9,3,4,129
2020-04-04,강원,경북,524,18,17,8,21,35,623,518,15,10,15,29,21,608
2020-04-04,강원,광주,80,2,11,1,3,2,99,93,0,7,5,2,3,110
2020-04-04,강원,대구,165,2,7,7,2,8,191,257,7,2,11,3,6,286
2020-04-04,강원,대전,187,2,4,2,0,6,201,225,4,4,3,5,9,250
2020-04-04,강원,부산,3,0,0,0,0,2,5,6,0,0,0,1,1,8
2020-04-04,강원,서울,1036,7,115,10,21,48,1237,1656,9,116,12,7,49,1849
2020-04-04,강원,세종,4,0,0,0,0,0,4,6,0,0,0,0,1,7
2020-04-04,강원,울산,1,0,0,0,2,0,3,2,0,0,0,0,0,2
2020-04-04,강원,전남,51,1,2,2,8,0,64,49,4,0,10,9,1,73
2020-04-04,강원,전북,152,2,8,5,12,3,182,149,3,9,6,14,6,187
2020-04-04,강원,충남,318,5,10,11,9,10,363,626,7,17,32,42,20,744
2020-04-04,강원,충북,5391,148,155,129,268,239,6330,5918,131,139,131,247,263,6829
2020-04-04,경기,강원,44075,376,574,414,580,1764,47783,32986,352,587,364,438,1367,36094
2020-04-04,경기,경기,396794,10639,11260,8649,12737,23188,463267,396794,10639,11260,8649,12737,23188,463267
2020-04-04,경기,경남,3191,56,198,459,371,138,4413,1930,27,123,263,217,78,2638
2020-04-04,경기,경북,5716,80,206,427,370,215,7014,4227,75,181,436,317,164,5400
2020-04-04,경기,광주,1080,14,67,165,91,30,1447,683,5,36,104,47,20,895
2020-04-04,경기,대구,1518,31,80,265,131,55,2080,2100,45,72,220,176,77,2690
2020-04-04,경기,대전,3331,57,102,88,51,177,3806,2578,46,107,56,36,133,2956
2020-04-04,경기,부산,256,9,34,122,84,7,512,213,2,13,80,116,7,431
2020-04-04,경기,서울,136538,4108,4744,2751,2670,7688,158499,131773,3635,4771,2217,2409,7281,152086
2020-04-04,경기,세종,55,1,2,1,0,0,59,65,2,2,1,2,5,77
2020-04-04,경기,울산,29,0,5,12,12,3,61,31,0,6,11,40,2,90
2020-04-04,경기,전남,1549,7,50,80,99,37,1822,1006,7,24,71,63,31,1202
2020-04-04,경기,전북,2797,27,79,78,124,95,3200,1949,20,72,85,90,66,2282
2020-04-04,경기,충남,51069,690,1355,1153,1929,2261,58457,46255,695,1295,1208,1997,2083,53533
2020-04-04,경기,충북,37498,947,1273,1429,1970,1653,44770,32939,897,1085,1361,2061,1517,39860
2020-04-04,경남,강원,107,1,5,9,3,4,129,128,1,9,4,10,4,156
2020-04-04,경남,경기,1930,27,123,263,217,78,2638,3191,56,198,459,371,138,4413
2020-04-04,경남,경남,191987,5652,5011,4186,9061,12441,228338,191987,5652,5011,4186,9061,12441,228338
2020-04-04,경남,경북,12562,283,463,434,975,544,15261,15063,430,567,610,1247,643,18560
2020-04-04,경남,광주,1441,25,87,104,75,52,1784,1438,26,77,103,51,50,1745
2020-04-04,경남,대구,12490,347,469,453,598,518,14875,11611,214,360,220,213,444,13062
2020-04-04,경남,대전,903,6,55,25,19,47,1055,1322,14,67,70,38,64,1575
2020-04-04,경남,부산,89452,1488,1586,1241,2118,5570,101455,88566,1457,1608,1135,2115,5458,100339
2020-04-04,경남,서울,1899,17,266,133,78,70,2463,2996,20,312,158,80,89,3655
2020-04-04,경남,세종,171,0,3,5,8,7,194,348,3,7,5,5,16,384
2020-04-04,경남,울산,10657,325,307,233,286,588,12396,10673,321,353,206,315,571,12439
2020-04-04,경남,전남,7834,145,200,252,809,361,9601,7434,163,209,222,762,351,9141
2020-04-04,경남,전북,1648,30,85,41,113,55,1972,1459,23,66,54,121,54,1777
2020-04-04,경남,충남,1280,22,49,89,95,45,1580,2045,25,74,188,272,77,2681
2020-04-04,경남,충북,1233,18,56,116,113,46,1582,1709,33,108,277,347,66,2540
2020-04-04,경북,강원,518,15,10,15,29,21,608,524,18,17,8,21,35,623
2020-04-04,경북,경기,4227,75,181,436,317,164,5400,5716,80,206,427,370,215,7014
2020-04-04,경북,경남,15063,430,567,610,1247,643,18560,12562,283,463,434,975,544,15261
2020-04-04,경북,경북,82571,2379,2139,1655,3443,3848,96035,82571,2379,2139,1655,3443,3848,96035
2020-04-04,경북,광주,799,22,54,98,67,30,1070,722,17,38,86,48,22,933
2020-04-04,경북,대구,70716,1696,1324,965,2978,3239,80918,78748,1697,1435,1078,3020,3457,89435
2020-04-04,경북,대전,2221,42,56,65,43,102,2529,2211,28,51,89,40,96,2515
2020-04-04,경북,부산,6812,63,162,103,254,288,7682,7610,64,158,68,283,314,8497
2020-04-04,경북,서울,3032,40,152,160,73,107,3564,4182,35,161,137,87,147,4749
2020-04-04,경북,세종,305,1,12,8,15,12,353,407,4,10,8,11,19,459
2020-04-04,경북,울산,7048,82,138,202,620,331,8421,7256,76,137,165,730,370,8734
2020-04-04,경북,전남,1426,29,41,44,205,41,1786,1248,33,40,54,307,53,1735
2020-04-04,경북,전북,2262,55,92,112,184,64,2769,1757,66,83,63,143,55,2167
2020-04-04,경북,충남,3367,68,116,220,285,120,4176,4045,73,159,227,352,130,4986
2020-04-04,경북,충북,6135,114,253,300,607,261,7670,6477,131,244,358,710,257,8177
2020-04-04,광주,강원,93,0,7,5,2,3,110,80,2,11,1,3,2,99
2020-04-04,광주,경기,683,5,36,104,47,20,895,1080,14,67,165,91,30,1447
2020-04-04,광주,경남,1438,26,77,103,51,50,1745,1441,25,87,104,75,52,1784
2020-04-04,광주,경북,722,17,38,86,48,22,933,799,22,54,98,67,30,1070
2020-04-04,광주,광주,15200,356,430,232,249,529,16996,15200,356,430,232,249,529,16996
2020-04-04,광주,대구,429,16,43,59,12,12,571,486,16,46,37,11,18,614
2020-04-04,광주,대전,559,9,6,12,6,15,607,587,4,9,19,11,20,650
2020-04-04,광주,부산,401,4,30,20,32,13,500,448,6,35,25,42,15,571
2020-04-04,광주,서울,686,10,7,40,14,17,774,1172,5,13,35,11,31,1267
2020-04-04,광주,세종,170,0,3,3,1,5,182,277,0,2,2,1,5,287
2020-04-04,광주,울산,50,0,4,1,0,3,58,55,1,5,3,2,2,68
2020-04-04,광주,전남,44745,681,799,564,1113,1548,49450,41397,705,741,509,1250,1399,46001
2020-04-04,광주,전북,9885,253,258,184,211,301,11092,9475,289,273,182,294,272,10785
2020-04-04,광주,충남,4683,34,311,203,150,110,5491,6066,61,337,355,221,157,7197
2020-04-04,광주,충북,574,20,35,49,27,17,722,795,16,44,83,71,27,1036
2020-04-04,대구,강원,257,7,2,11,3,6,286,165,2,7,7,2,8,191
2020-04-04,대구,경기,2100,45,72,220,176,77,2690,1518,31,80,265,131,55,2080
2020-04-04,대구,경남,11611,214,360,220,213,444,13062,12490,347,469,453,598,518,14875
2020-04-04,대구,경북,78748,1697,1435,1078,3020,3457,89435,70716,1696,1324,965,2978,3239,80918
2020-04-04,대구,광주,486,16,46,37,11,18,614,429,16,43,59,12,12,571
2020-04-04,대구,대구,47172,1060,858,585,808,2765,53248,47172,1060,858,585,808,2765,53248
2020-04-04,대구,대전,869,10,22,40,23,32,996,476,8,12,38,17,16,567
2020-04-04,대구,부산,730,18,75,40,46,30,939,3220,34,135,46,85,121,3641
2020-04-04,대구,서울,2014,27,80,113,62,66,2362,1295,19,58,97,28,34,1531
2020-04-04,대구,세종,202,3,2,1,6,7,221,148,0,0,2,2,3,155
2020-04-04,대구,울산,1131,25,38,37,79,64,1374,1179,20,37,28,97,61,1422
2020-04-04,대구,전남,775,9,28,10,17,25,864,640,11,30,20,21,17,739
2020-04-04,대구,전북,380,1,13,13,6,12,425,319,4,17,6,4,10,360
2020-04-04,대구,충남,1269,23,43,65,85,54,1539,967,20,39,92,74,25,1217
2020-04-04,대구,충북,1601,44,69,122,157,56,2049,1077,36,78,157,101,47,1496
2020-04-04,대전,강원,225,4,4,3,5,9,250,187,2,4,2,0,6,201
2020-04-04,대전,경기,2578,46,107,56,36,133,2956,3331,57,102,88,51,177,3806
2020-04-04,대전,경남,1322,14,67,70,38,64,1575,903,6,55,25,19,47,1055
2020-04-04,대전,경북,2211,28,51,89,40,96,2515,2221,42,56,65,43,102,2529
2020-04-04,대전,광주,587,4,9,19,11,20,650,559,9,6,12,6,15,607
2020-04-04,대전,대구,476,8,12,38,17,16,567,869,10,22,40,23,32,996
2020-04-04,대전,대전,14129,249,275,129,215,949,15946,14129,249,275,129,215,949,15946
2020-04-04,대전,부산,87,2,3,9,17,3,121,92,1,9,11,15,4,132
2020-04-04,대전,서울,2064,30,132,25,7,103,2361,2640,15,123,31,10,108,2927
2020-04-04,대전,세종,3106,82,26,17,69,190,3490,3287,80,29,21,68,188,3673
2020-04-04,대전,울산,98,1,1,11,14,2,127,116,1,2,4,13,5,141
2020-04-04,대전,전남,547,7,5,18,13,14,604,476,5,4,0,13,12,510
2020-04-04,대전,전북,4580,48,55,53,27,232,4995,4022,62,57,29,29,187,4386
2020-04-04,대전,충남,17502,286,318,164,311,1010,19591,16143,258,300,115,257,943,18016
2020-04-04,대전,충북,11257,287,266,125,117,655,12707,10487,254,274,110,101,650,11876
2020-04-04,부산,강원,6,0,0,0,1,1,8,3,0,0,0,0,2,5
2020-04-04,부산,경기,213,2,13,80,116,7,431,256,9,34,122,84,7,512
2020-04-04,부산,경남,88566,1457,1608,1135,2115,5458,100339,89452,1488,1586,1241,2118,5570,101455
2020-04-04,부산,경북,7610,64,158,68,283,314,8497,6812,63,162,103,254,288,7682
2020-04-04,부산,광주,448,6,35,25,42,15,571,401,4,30,20,32,13,500
2020-04-04,부산,대구,3220,34,135,46,85,121,3641,730,18,75,40,46,30,939
2020-04-04,부산,대전,92,1,9,11,15,4,132,87,2,3,9,17,3,121
2020-04-04,부산,부산,52872,396,299,428,982,3083,58060,52872,396,299,428,982,3083,58060
2020-04-04,부산,서울,205,7,7,50,29,6,304,221,4,14,44,26,9,318
2020-04-04,부산,세종,24,0,0,1,1,2,28,23,0,0,2,1,0,26
2020-04-04,부산,울산,17608,181,179,245,931,1065,20209,19055,186,170,160,946,1166,21683
2020-04-04,부산,전남,2398,26,71,86,282,74,2937,1992,30,58,53,270,80,2483
2020-04-04,부산,전북,389,8,19,14,32,8,470,301,8,19,14,37,9,388
2020-04-04,부산,충남,147,4,10,15,47,4,227,200,3,18,40,83,6,350
2020-04-04,부산,충북,128,4,11,35,90,4,272,141,4,17,73,91,1,327
2020-04-04,서울,강원,1656,9,116,12,7,49,1849,1036,7,115,10,21,48,1237
2020-04-04,서울,경기,131773,3635,4771,2217,2409,7281,152086,136538,4108,4744,2751,2670,7688,158499
2020-04-04,서울,경남,2996,20,312,158,80,89,3655,1899,17,266,133,78,70,2463
2020-04-04,서울,경북,4182,35,161,137,87,147,4749,3032,40,152,160,73,107,3564
2020-04-04,서울,광주,1172,5,13,35,11,31,1267,686,10,7,40,14,17,774
2020-04-04,서울,대구,1295,19,58,97,28,34,1531,2014,27,80,113,62,66,2362
2020-04-04,서울,대전,2640,15,123,31,10,108,2927,2064,30,132,25,7,103,2361
2020-04-04,서울,부산,221,4,14,44,26,9,318,205,7,7,50,29,6,304
2020-04-04,서울,서울,215,4,8,1,2,9,239,215,4,8,1,2,9,239
2020-04-04,서울,세종,38,0,0,0,0,1,39,45,0,1,1,1,1,49
2020-04-04,서울,울산,28,1,5,2,2,2,40,23,0,2,6,6,1,38
2020-04-04,서울,전남,1989,8,26,29,21,57,2130,1112,8,14,33,17,27,1211
2020-04-04,서울,전북,3083,12,41,18,17,101,3272,1879,12,25,18,14,61,2009
2020-04-04,서울,충남,40329,263,1387,436,396,1513,44324,36328,296,1381,581,669,1370,40625
2020-04-04,서울,충북,20297,217,599,411,476,807,22807,17509,242,587,485,562,713,20098
2020-04-04,세종,강원,6,0,0,0,0,1,7,4,0,0,0,0,0,4
2020-04-04,세종,경기,65,2,2,1,2,5,77,55,1,2,1,0,0,59
2020-04-04,세종,경남,348,3,7,5,5,16,384,171,0,3,5,8,7,194
2020-04-04,세종,경북,407,4,10,8,11,19,459,305,1,12,8,15,12,353
2020-04-04,세종,광주,277,0,2,2,1,5,287,170,0,3,3,1,5,182
2020-04-04,세종,대구,148,0,0,2,2,3,155,202,3,2,1,6,7,221
2020-04-04,세종,대전,3287,80,29,21,68,188,3673,3106,82,26,17,69,190,3490
2020-04-04,세종,부산,23,0,0,2,1,0,26,24,0,0,1,1,2,28
2020-04-04,세종,서울,45,0,1,1,1,1,49,38,0,0,0,0,1,39
2020-04-04,세종,세종,276,20,1,0,1,15,313,276,20,1,0,1,15,313
2020-04-04,세종,울산,10,0,1,1,1,2,15,10,0,0,0,4,2,16
2020-04-04,세종,전남,298,1,2,3,6,8,318,190,2,0,2,6,3,203
2020-04-04,세종,전북,1331,6,9,5,23,42,1416,1002,5,11,6,19,34,1077
2020-04-04,세종,충남,7545,110,94,81,117,316,8263,5644,90,75,75,118,228,6230
2020-04-04,세종,충북,476,5,14,6,15,31,547,374,11,14,11,10,20,440
2020-04-04,울산,강원,2,0,0,0,0,0,2,1,0,0,0,2,0,3
2020-04-04,울산,경기,31,0,6,11,40,2,90,29,0,5,12,12,3,61
2020-04-04,울산,경남,10673,321,353,206,315,571,12439,10657,325,307,233,286,588,12396
2020-04-04,울산,경북,7256,76,137,165,730,370,8734,7048,82,138,202,620,331,8421
2020-04-04,울산,광주,55,1,5,3,2,2,68,50,0,4,1,0,3,58
2020-04-04,울산,대구,1179,20,37,28,97,61,1422,1131,25,38,37,79,64,1374
2020-04-04,울산,대전,116,1,2,4,13,5,141,98,1,1,11,14,2,127
2020-04-04,울산,부산,19055,186,170,160,946,1166,21683,17608,181,179,245,931,1065,20209
2020-04-04,울산,서울,23,0,2,6,6,1,38,28,1,5,2,2,2,40
2020-04-04,울산,세종,10,0,0,0,4,2,16,10,0,1,1,1,2,15
2020-04-04,울산,울산,6543,126,158,88,379,465,7759,6543,126,158,88,379,465,7759
2020-04-04,울산,전남,271,6,11,1,8,16,313,212,8,7,10,11,10,258
2020-04-04,울산,전북,62,1,6,2,11,2,84,46,0,5,4,2,1,58
2020-04-04,울산,충남,131,1,6,14,47,3,202,121,3,4,14,59,2,203
2020-04-04,울산,충북,31,1,3,8,23,1,67,28,1,2,12,22,1,66
2020-04-04,전남,강원,49,4,0,10,9,1,73,51,1,2,2,8,0,64
2020-04-04,전남,경기,1006,7,24,71,63,31,1202,1549,7,50,80,99,37,1822
2020-04-04,전남,경남,7434,163,209,222,762,351,9141,7834,145,200,252,809,361,9601
2020-04-04,전남,경북,1248,33,40,54,307,53,1735,1426,29,41,44,205,41,1786
2020-04-04,전남,광주,41397,705,741,509,1250,1399,46001,44745,681,799,564,1113,1548,49450
2020-04-04,전남,대구,640,11,30,20,21,17,739,775,9,28,10,17,25,864
2020-04-04,전남,대전,476,5,4,0,13,12,510,547,7,5,18,13,14,604
2020-04-04,전남,부산,1992,30,58,53,270,80,2483,2398,26,71,86,282,74,2937
2020-04-04,전남,서울,1112,8,14,33,17,27,1211,1989,8,26,29,21,57,2130
2020-04-04,전남,세종,190,2,0,2,6,3,203,298,1,2,3,6,8,318
2020-04-04,전남,울산,212,8,7,10,11,10,258,271,6,11,1,8,16,313
2020-04-04,전남,전남,57912,823,1003,1002,3730,1910,66380,57912,823,1003,1002,3730,1910,66380
2020-04-04,전남,전북,7605,175,371,321,769,224,9465,7712,160,289,394,832,220,9607
2020-04-04,전남,충남,5838,34,234,218,401,163,6888,8235,39,279,288,420,226,9487
2020-04-04,전남,충북,465,9,15,47,98,13,647,614,13,24,54,135,23,863
2020-04-04,전북,강원,149,3,9,6,14,6,187,152,2,8,5,12,3,182
2020-04-04,전북,경기,1949,20,72,85,90,66,2282,2797,27,79,78,124,95,3200
2020-04-04,전북,경남,1459,23,66,54,121,54,1777,1648,30,85,41,113,55,1972
2020-04-04,전북,경북,1757,66,83,63,143,55,2167,2262,55,92,112,184,64,2769
2020-04-04,전북,광주,9475,289,273,182,294,272,10785,9885,253,258,184,211,301,11092
2020-04-04,전북,대구,319,4,17,6,4,10,360,380,1,13,13,6,12,425
2020-04-04,전북,대전,4022,62,57,29,29,187,4386,4580,48,55,53,27,232,4995
2020-04-04,전북,부산,301,8,19,14,37,9,388,389,8,19,14,32,8,470
2020-04-04,전북,서울,1879,12,25,18,14,61,2009,3083,12,41,18,17,101,3272
2020-04-04,전북,세종,1002,5,11,6,19,34,1077,1331,6,9,5,23,42,1416
2020-04-04,전북,울산,46,0,5,4,2,1,58,62,1,6,2,11,2,84
2020-04-04,전북,전남,7712,160,289,394,832,220,9607,7605,175,371,321,769,224,9465
2020-04-04,전북,전북,19302,439,594,374,684,655,22048,19302,439,594,374,684,655,22048
2020-04-04,전북,충남,18331,270,863,470,687,624,21245,22988,280,951,542,761,789,26311
2020-04-04,전북,충북,2208,59,90,119,128,89,2693,2615,68,104,140,165,99,3191
2020-04-04,충남,강원,626,7,17,32,42,20,744,318,5,10,11,9,10,363
2020-04-04,충남,경기,46255,695,1295,1208,1997,2083,53533,51069,690,1355,1153,1929,2261,58457
2020-04-04,충남,경남,2045,25,74,188,272,77,2681,1280,22,49,89,95,45,1580
2020-04-04,충남,경북,4045,73,159,227,352,130,4986,3367,68,116,220,285,120,4176
2020-04-04,충남,광주,6066,61,337,355,221,157,7197,4683,34,311,203,150,110,5491
2020-04-04,충남,대구,967,20,39,92,74,25,1217,1269,23,43,65,85,54,1539
2020-04-04,충남,대전,16143,258,300,115,257,943,18016,17502,286,318,164,311,1010,19591
2020-04-04,충남,부산,200,3,18,40,83,6,350,147,4,10,15,47,4,227
2020-04-04,충남,서울,36328,296,1381,581,669,1370,40625,40329,263,1387,436,396,1513,44324
2020-04-04,충남,세종,5644,90,75,75,118,228,6230,7545,110,94,81,117,316,8263
2020-04-04,충남,울산,121,3,4,14,59,2,203,131,1,6,14,47,3,202
2020-04-04,충남,전남,8235,39,279,288,420,226,9487,5838,34,234,218,401,163,6888
2020-04-04,충남,전북,22988,280,951,542,761,789,26311,18331,270,863,470,687,624,21245
2020-04-04,충남,충남,120745,1883,4132,3226,5257,4741,139984,120745,1883,4132,3226,5257,4741,139984
2020-04-04,충남,충북,13360,329,397,467,814,675,16042,12241,348,383,379,781,619,14751
2020-04-04,충북,강원,5918,131,139,131,247,263,6829,5391,148,155,129,268,239,6330
2020-04-04,충북,경기,32939,897,1085,1361,2061,1517,39860,37498,947,1273,1429,1970,1653,44770
2020-04-04,충북,경남,1709,33,108,277,347,66,2540,1233,18,56,116,113,46,1582
2020-04-04,충북,경북,6477,131,244,358,710,257,8177,6135,114,253,300,607,261,7670
2020-04-04,충북,광주,795,16,44,83,71,27,1036,574,20,35,49,27,17,722
2020-04-04,충북,대구,1077,36,78,157,101,47,1496,1601,44,69,122,157,56,2049
2020-04-04,충북,대전,10487,254,274,110,101,650,11876,11257,287,266,125,117,655,12707
2020-04-04,충북,부산,141,4,17,73,91,1,327,128,4,11,35,90,4,272
2020-04-04,충북,서울,17509,242,587,485,562,713,20098,20297,217,599,411,476,807,22807
2020-04-04,충북,세종,374,11,14,11,10,20,440,476,5,14,6,15,31,547
2020-04-04,충북,울산,28,1,2,12,22,1,66,31,1,3,8,23,1,67
2020-04-04,충북,전남,614,13,24,54,135,23,863,465,9,15,47,98,13,647
2020-04-04,충북,전북,2615,68,104,140,165,99,3191,2208,59,90,119,128,89,2693
2020-04-04,충북,충남,12241,348,383,379,781,619,14751,13360,329,397,467,814,675,16042
2020-04-04,충북,충북,39713,1081,1071,1065,2134,1915,46979,39713,1081,1071,1065,2134,1915,46979
2020-04-05,강원,강원,74258,734,1179,312,542,3861,80886,74258,734,1179,312,542,3861,80886
2020-04-05,강원,경기,43226,215,416,191,159,1657,45864,26383,164,398,134,230,1133,28442
2020-04-05,강원,경남,198,0,7,4,9,6,224,100,1,5,6,3,4,119
2020-04-05,강원,경북,546,13,8,8,9,23,607,514,10,7,13,4,25,573
2020-04-05,강원,광주,81,0,6,3,0,1,91,88,0,4,7,1,2,102
2020-04-05,강원,대구,196,2,5,5,0,6,214,212,6,2,5,2,11,238
2020-04-05,강원,대전,243,1,5,0,0,11,260,194,1,4,1,1,8,209
2020-04-05,강원,부산,8,0,0,0,0,1,9,2,0,0,0,0,1,3
2020-04-05,강원,서울,2203,11,136,6,5,68,2429,1030,6,108,1,3,31,1179
2020-04-05,강원,세종,8,0,0,0,0,0,8,7,0,0,0,0,0,7
2020-04-05,강원,울산,1,0,0,0,1,0,2,0,0,0,0,0,0,0
2020-04-05,강원,전남,48,0,2,0,5,0,55,70,0,1,6,2,4,83
2020-04-05,강원,전북,152,0,4,0,3,5,164,180,2,8,5,5,8,208
2020-04-05,강원,충남,495,2,1,7,7,14,526,389,2,4,4,11,22,432
2020-04-05,강원,충북,5739,74,91,37,59,257,6257,5001,59,79,39,50,245,5473
2020-04-05,경기,강원,26383,164,398,134,230,1133,28442,43226,215,416,191,159,1657,45864
2020-04-05,경기,경기,329361,4856,5674,3172,3720,18174,364957,329361,4856,5674,3172,3720,18174,364957
2020-04-05,경기,경남,2595,26,121,117,79,111,3049,3198,9,101,110,69,130,3617
2020-04-05,경기,경북,4260,30,88,142,61,174,4755,6326,41,83,180,78,221,6929
2020-04-05,경기,광주,677,6,24,37,7,25,776,1095,5,28,30,21,35,1214
2020-04-05,경기,대구,1464,10,35,76,20,52,1657,2488,14,36,75,44,94,2751
2020-04-05,경기,대전,2226,17,76,14,6,113,2452,3308,26,82,21,7,162,3606
2020-04-05,경기,부산,204,4,14,32,17,7,278,515,3,10,23,19,18,588
2020-04-05,경기,서울,108522,1561,3230,1289,548,5946,121096,118210,1784,3334,1202,557,6564,131651
2020-04-05,경기,세종,30,0,0,1,1,1,33,50,0,3,0,0,3,56
2020-04-05,경기,울산,27,1,3,3,2,0,36,35,0,1,4,4,0,44
2020-04-05,경기,전남,837,8,32,28,24,30,959,1753,10,28,61,20,44,1916
2020-04-05,경기,전북,1514,11,50,31,31,63,1700,3175,10,41,41,31,114,3412
2020-04-05,경기,충남,41533,298,888,515,606,1965,45805,47957,311,758,425,555,2020,52026
2020-04-05,경기,충북,29447,458,613,502,487,1396,32903,36677,481,604,475,407,1622,40266
2020-04-05,경남,강원,100,1,5,6,3,4,119,198,0,7,4,9,6,224
2020-04-05,경남,경기,3198,9,101,110,69,130,3617,2595,26,121,117,79,111,3049
2020-04-05,경남,경남,170650,2122,2342,949,1795,10269,188127,170650,2122,2342,949,1795,10269,188127
2020-04-05,경남,경북,12544,132,211,164,182,631,13864,15660,192,294,196,238,699,17279
2020-04-05,경남,광주,1316,8,46,34,14,39,1457,1569,8,65,34,8,53,1737
2020-04-05,경남,대구,14059,161,254,257,349,621,15701,9648,116,201,92,50,411,10518
2020-04-05,경남,대전,1105,7,49,24,8,51,1244,1338,6,47,14,2,55,1462
2020-04-05,경남,부산,81434,540,1028,286,497,4518,88303,74759,582,1002,264,545,4432,81584
2020-04-05,경남,서울,2473,16,261,128,52,64,2994,2642,14,287,42,8,89,3082
2020-04-05,경남,세종,402,1,6,0,1,14,424,289,1,5,0,2,17,314
2020-04-05,경남,울산,10473,116,173,64,62,585,11473,9827,98,180,56,75,502,10738
2020-04-05,경남,전남,7067,77,119,106,173,320,7862,8249,100,114,101,165,327,9056
2020-04-05,경남,전북,1498,14,37,31,20,52,1652,1801,13,45,19,21,62,1961
2020-04-05,경남,충남,1809,13,29,42,26,74,1993,1665,14,31,70,56,73,1909
2020-04-05,경남,충북,1909,10,26,57,45,59,2106,1670,19,50,100,54,63,1956
2020-04-05,경북,강원,514,10,7,13,4,25,573,546,13,8,8,9,23,607
2020-04-05,경북,경기,6326,41,83,180,78,221,6929,4260,30,88,142,61,174,4755
2020-04-05,경북,경남,15660,192,294,196,238,699,17279,12544,132,211,164,182,631,13864
2020-04-05,경북,경북,82570,911,872,516,750,3673,89292,82570,911,872,516,750,3673,89292
2020-04-05,경북,광주,730,12,34,52,21,22,871,1032,17,29,42,19,37,1176
2020-04-05,경북,대구,70015,573,467,316,594,3039,75004,68758,589,595,313,653,2956,73864
2020-04-05,경북,대전,2270,12,20,31,23,111,2467,2334,6,30,17,6,86,2479
2020-04-05,경북,부산,7363,29,88,27,97,323,7927,7951,35,105,39,90,359,8579
2020-04-05,경북,서울,4221,18,167,158,36,135,4735,3287,15,148,53,14,104,3621
2020-04-05,경북,세종,434,3,5,3,2,16,463,316,0,8,5,2,16,347
2020-04-05,경북,울산,7768,34,54,67,182,379,8484,6636,23,47,41,190,297,7234
2020-04-05,경북,전남,1233,17,43,25,75,34,1427,1511,17,26,41,114,50,1759
2020-04-05,경북,전북,2013,33,60,37,73,53,2269,2177,33,43,35,61,58,2407
2020-04-05,경북,충남,4099,37,43,85,90,155,4509,3591,21,77,78,107,143,4017
2020-04-05,경북,충북,7414,68,102,123,137,273,8117,6386,75,105,113,109,265,7053
2020-04-05,광주,강원,88,0,4,7,1,2,102,81,0,6,3,0,1,91
2020-04-05,광주,경기,1095,5,28,30,21,35,1214,677,6,24,37,7,25,776
2020-04-05,광주,경남,1569,8,65,34,8,53,1737,1316,8,46,34,14,39,1457
2020-04-05,광주,경북,1032,17,29,42,19,37,1176,730,12,34,52,21,22,871
2020-04-05,광주,광주,14142,141,390,87,66,473,15299,14142,141,390,87,66,473,15299
2020-04-05,광주,대구,527,7,33,40,7,16,630,430,5,46,29,7,13,530
2020-04-05,광주,대전,532,2,4,2,6,17,563,542,3,5,2,5,20,577
2020-04-05,광주,부산,437,0,24,8,5,8,482,480,1,34,5,5,19,544
2020-04-05,광주,서울,1100,7,20,6,8,20,1161,755,7,9,7,2,14,794
2020-04-05,광주,세종,340,0,2,0,1,8,351,182,0,3,0,0,9,194
2020-04-05,광주,울산,62,0,5,0,1,2,70,46,0,4,1,0,2,53
2020-04-05,광주,전남,38540,293,573,162,223,1215,41006,40142,299,517,246,225,1316,42745
2020-04-05,광주,전북,8997,86,168,57,47,285,9640,8750,82,155,74,43,310,9414
2020-04-05,광주,충남,6981,43,257,111,75,214,7681,4467,34,304,104,52,147,5108
2020-04-05,광주,충북,776,7,16,22,8,22,851,606,9,19,31,15,23,703
2020-04-05,대구,강원,212,6,2,5,2,11,238,196,2,5,5,0,6,214
2020-04-05,대구,경기,2488,14,36,75,44,94,2751,1464,10,35,76,20,52,1657
2020-04-05,대구,경남,9648,116,201,92,50,411,10518,14059,161,254,257,349,621,15701
2020-04-05,대구,경북,68758,589,595,313,653,2956,73864,70015,573,467,316,594,3039,75004
2020-04-05,대구,광주,430,5,46,29,7,13,530,527,7,33,40,7,16,630
2020-04-05,대구,대구,35847,334,359,164,246,2002,38952,35847,334,359,164,246,2002,38952
2020-04-05,대구,대전,841,4,10,14,7,38,914,605,3,9,7,3,25,652
2020-04-05,대구,부산,560,6,45,18,9,33,671,4076,19,90,26,32,176,4419
2020-04-05,대구,서울,1714,12,53,61,24,63,1927,1509,9,30,19,3,42,1612
2020-04-05,대구,세종,299,1,4,2,0,9,315,162,0,2,0,0,4,168
2020-04-05,대구,울산,1144,10,28,13,43,47,1285,1159,5,27,11,28,58,1288
2020-04-05,대구,전남,693,9,19,9,12,28,770,815,10,19,18,10,39,911
2020-04-05,대구,전북,359,2,8,2,3,11,385,424,2,8,5,3,9,451
2020-04-05,대구,충남,1457,9,14,25,20,63,1588,898,11,9,42,13,42,1015
2020-04-05,대구,충북,1866,11,40,57,69,71,2114,1303,11,25,43,18,57,1457
2020-04-05,대전,강원,194,1,4,1,1,8,209,243,1,5,0,0,11,260
2020-04-05,대전,경기,3308,26,82,21,7,162,3606,2226,17,76,14,6,113,2452
2020-04-05,대전,경남,1338,6,47,14,2,55,1462,1105,7,49,24,8,51,1244
2020-04-05,대전,경북,2334,6,30,17,6,86,2479,2270,12,20,31,23,111,2467
2020-04-05,대전,광주,542,3,5,2,5,20,577,532,2,4,2,6,17,563
2020-04-05,대전,대구,605,3,9,7,3,25,652,841,4,10,14,7,38,914
2020-04-05,대전,대전,12635,76,107,33,34,787,13672,12635,76,107,33,34,787,13672
2020-04-05,대전,부산,92,0,0,1,1,1,95,131,1,2,2,2,3,141
2020-04-05,대전,서울,2602,8,117,9,0,110,2846,1968,6,122,6,1,90,2193
2020-04-05,대전,세종,2774,33,18,5,7,166,3003,2302,32,13,9,6,133,2495
2020-04-05,대전,울산,143,0,1,2,13,4,163,120,0,1,2,10,2,135
2020-04-05,대전,전남,440,2,3,4,2,12,463,628,3,2,2,5,25,665
2020-04-05,대전,전북,3856,25,35,5,9,151,4081,4552,28,33,17,16,195,4841
2020-04-05,대전,충남,15383,102,166,48,56,816,16571,15143,106,181,61,58,809,16358
2020-04-05,대전,충북,10384,110,170,37,19,567,11287,9315,88,171,27,22,535,10158
2020-04-05,부산,강원,2,0,0,0,0,1,3,8,0,0,0,0,1,9
2020-04-05,부산,경기,515,3,10,23,19,18,588,204,4,14,32,17,7,278
2020-04-05,부산,경남,74759,582,1002,264,545,4432,81584,81434,540,1028,286,497,4518,88303
2020-04-05,부산,경북,7951,35,105,39,90,359,8579,7363,29,88,27,97,323,7927
2020-04-05,부산,광주,480,1,34,5,5,19,544,437,0,24,8,5,8,482
2020-04-05,부산,대구,4076,19,90,26,32,176,4419,560,6,45,18,9,33,671
2020-04-05,부산,대전,131,1,2,2,2,3,141,92,0,0,1,1,1,95
2020-04-05,부산,부산,51382,122,122,90,239,2713,54668,51382,122,122,90,239,2713,54668
2020-04-05,부산,서울,285,1,6,20,6,16,334,193,0,5,7,8,7,220
2020-04-05,부산,세종,57,1,0,2,0,2,62,28,0,1,0,0,0,29
2020-04-05,부산,울산,18274,49,94,77,248,1089,19831,16995,60,44,36,285,1027,18447
2020-04-05,부산,전남,2520,18,56,29,103,119,2845,2289,16,42,47,108,76,2578
2020-04-05,부산,전북,376,2,17,2,9,18,424,354,1,13,9,7,17,401
2020-04-05,부산,충남,267,3,4,4,20,7,305,124,1,5,10,19,5,164
2020-04-05,부산,충북,287,1,6,4,18,7,323,117,3,6,20,8,3,157
2020-04-05,서울,강원,1030,6,108,1,3,31,1179,2203,11,136,6,5,68,2429
2020-04-05,서울,경기,118210,1784,3334,1202,557,6564,131651,108522,1561,3230,1289,548,5946,121096
2020-04-05,서울,경남,2642,14,287,42,8,89,3082,2473,16,261,128,52,64,2994
2020-04-05,서울,경북,3287,15,148,53,14,104,3621,4221,18,167,158,36,135,4735
2020-04-05,서울,광주,755,7,9,7,2,14,794,1100,7,20,6,8,20,1161
2020-04-05,서울,대구,1509,9,30,19,3,42,1612,1714,12,53,61,24,63,1927
2020-04-05,서울,대전,1968,6,122,6,1,90,2193,2602,8,117,9,0,110,2846
2020-04-05,서울,부산,193,0,5,7,8,7,220,285,1,6,20,6,16,334
2020-04-05,서울,서울,198,2,2,1,0,7,210,198,2,2,1,0,7,210
2020-04-05,서울,세종,32,0,0,0,0,3,35,28,0,0,0,0,0,28
2020-04-05,서울,울산,28,1,1,0,0,2,32,20,0,3,0,3,1,27
2020-04-05,서울,전남,992,10,11,9,6,30,1058,2074,2,23,53,24,51,2227
2020-04-05,서울,전북,1645,8,16,1,4,49,1723,3229,7,43,15,10,105,3409
2020-04-05,서울,충남,37211,130,1304,220,183,1481,40529,44608,171,1175,545,291,1670,48460
2020-04-05,서울,충북,17449,99,485,210,101,711,19055,19041,103,483,236,105,723,20691
2020-04-05,세종,강원,7,0,0,0,0,0,7,8,0,0,0,0,0,8
2020-04-05,세종,경기,50,0,3,0,0,3,56,30,0,0,1,1,1,33
2020-04-05,세종,경남,289,1,5,0,2,17,314,402,1,6,0,1,14,424
2020-04-05,세종,경북,316,0,8,5,2,16,347,434,3,5,3,2,16,463
2020-04-05,세종,광주,182,0,3,0,0,9,194,340,0,2,0,1,8,351
2020-04-05,세종,대구,162,0,2,0,0,4,168,299,1,4,2,0,9,315
2020-04-05,세종,대전,2302,32,13,9,6,133,2495,2774,33,18,5,7,166,3003
2020-04-05,세종,부산,28,0,1,0,0,0,29,57,1,0,2,0,2,62
2020-04-05,세종,서울,28,0,0,0,0,0,28,32,0,0,0,0,3,35
2020-04-05,세종,세종,286,4,1,0,0,5,296,286,4,1,0,0,5,296
2020-04-05,세종,울산,18,0,0,0,1,1,20,11,0,1,0,0,0,12
2020-04-05,세종,전남,204,2,5,1,0,8,220,420,3,2,18,0,13,456
2020-04-05,세종,전북,856,3,9,1,4,32,905,1401,4,7,5,6,56,1479
2020-04-05,세종,충남,6150,48,67,30,36,243,6574,6292,43,76,40,33,256,6740
2020-04-05,세종,충북,419,3,5,4,3,19,453,465,5,2,3,1,29,505
2020-04-05,울산,강원,0,0,0,0,0,0,0,1,0,0,0,1,0,2
2020-04-05,울산,경기,35,0,1,4,4,0,44,27,1,3,3,2,0,36
2020-04-05,울산,경남,9827,98,180,56,75,502,10738,10473,116,173,64,62,585,11473
2020-04-05,울산,경북,6636,23,47,41,190,297,7234,7768,34,54,67,182,379,8484
2020-04-05,울산,광주,46,0,4,1,0,2,53,62,0,5,0,1,2,70
2020-04-05,울산,대구,1159,5,27,11,28,58,1288,1144,10,28,13,43,47,1285
2020-04-05,울산,대전,120,0,1,2,10,2,135,143,0,1,2,13,4,163
2020-04-05,울산,부산,16995,60,44,36,285,1027,18447,18274,49,94,77,248,1089,19831
2020-04-05,울산,서울,20,0,3,0,3,1,27,28,1,1,0,0,2,32
2020-04-05,울산,세종,11,0,1,0,0,0,12,18,0,0,0,1,1,20
2020-04-05,울산,울산,5587,28,72,11,62,393,6153,5587,28,72,11,62,393,6153
2020-04-05,울산,전남,302,2,2,3,4,12,325,291,2,4,2,7,9,315
2020-04-05,울산,전북,59,1,6,2,10,0,78,71,0,4,5,0,2,82
2020-04-05,울산,충남,216,2,5,7,23,7,260,147,3,1,4,27,4,186
2020-04-05,울산,충북,23,1,1,1,4,2,32,19,0,0,1,17,1,38
2020-04-05,전남,강원,70,0,1,6,2,4,83,48,0,2,0,5,0,55
2020-04-05,전남,경기,1753,10,28,61,20,44,1916,837,8,32,28,24,30,959
2020-04-05,전남,경남,8249,100,114,101,165,327,9056,7067,77,119,106,173,320,7862
2020-04-05,전남,경북,1511,17,26,41,114,50,1759,1233,17,43,25,75,34,1427
2020-04-05,전남,광주,40142,299,517,246,225,1316,42745,38540,293,573,162,223,1215,41006
2020-04-05,전남,대구,815,10,19,18,10,39,911,693,9,19,9,12,28,770
2020-04-05,전남,대전,628,3,2,2,5,25,665,440,2,3,4,2,12,463
2020-04-05,전남,부산,2289,16,42,47,108,76,2578,2520,18,56,29,103,119,2845
2020-04-05,전남,서울,2074,2,23,53,24,51,2227,992,10,11,9,6,30,1058
2020-04-05,전남,세종,420,3,2,18,0,13,456,204,2,5,1,0,8,220
2020-04-05,전남,울산,291,2,4,2,7,9,315,302,2,2,3,4,12,325
2020-04-05,전남,전남,54883,504,574,472,790,1784,59007,54883,504,574,472,790,1784,59007
2020-04-05,전남,전북,8075,95,145,177,198,212,8902,7001,82,147,111,199,197,7737
2020-04-05,전남,충남,10713,46,228,432,347,262,12028,5390,44,249,96,145,167,6091
2020-04-05,전남,충북,779,4,6,32,26,19,866,473,2,13,23,36,22,569
2020-04-05,전북,강원,180,2,8,5,5,8,208,152,0,4,0,3,5,164
2020-04-05,전북,경기,3175,10,41,41,31,114,3412,1514,11,50,31,31,63,1700
2020-04-05,전북,경남,1801,13,45,19,21,62,1961,1498,14,37,31,20,52,1652
2020-04-05,전북,경북,2177,33,43,35,61,58,2407,2013,33,60,37,73,53,2269
2020-04-05,전북,광주,8750,82,155,74,43,310,9414,8997,86,168,57,47,285,9640
2020-04-05,전북,대구,424,2,8,5,3,9,451,359,2,8,2,3,11,385
2020-04-05,전북,대전,4552,28,33,17,16,195,4841,3856,25,35,5,9,151,4081
2020-04-05,전북,부산,354,1,13,9,7,17,401,376,2,17,2,9,18,424
2020-04-05,전북,서울,3229,7,43,15,10,105,3409,1645,8,16,1,4,49,1723
2020-04-05,전북,세종,1401,4,7,5,6,56,1479,856,3,9,1,4,32,905
2020-04-05,전북,울산,71,0,4,5,0,2,82,59,1,6,2,10,0,78
2020-04-05,전북,전남,7001,82,147,111,199,197,7737,8075,95,145,177,198,212,8902
2020-04-05,전북,전북,18041,200,304,123,96,642,19406,18041,200,304,123,96,642,19406
2020-04-05,전북,충남,25445,154,628,287,295,849,27658,15966,123,654,183,221,569,17716
2020-04-05,전북,충북,2872,40,41,102,47,113,3215,2072,38,45,69,37,86,2347
2020-04-05,충남,강원,389,2,4,4,11,22,432,495,2,1,7,7,14,526
2020-04-05,충남,경기,47957,311,758,425,555,2020,52026,41533,298,888,515,606,1965,45805
2020-04-05,충남,경남,1665,14,31,70,56,73,1909,1809,13,29,42,26,74,1993
2020-04-05,충남,경북,3591,21,77,78,107,143,4017,4099,37,43,85,90,155,4509
2020-04-05,충남,광주,4467,34,304,104,52,147,5108,6981,43,257,111,75,214,7681
2020-04-05,충남,대구,898,11,9,42,13,42,1015,1457,9,14,25,20,63,1588
2020-04-05,충남,대전,15143,106,181,61,58,809,16358,15383,102,166,48,56,816,16571
2020-04-05,충남,부산,124,1,5,10,19,5,164,267,3,4,4,20,7,305
2020-04-05,충남,서울,44608,171,1175,545,291,1670,48460,37211,130,1304,220,183,1481,40529
2020-04-05,충남,세종,6292,43,76,40,33,256,6740,6150,48,67,30,36,243,6574
2020-04-05,충남,울산,147,3,1,4,27,4,186,216,2,5,7,23,7,260
2020-04-05,충남,전남,5390,44,249,96,145,167,6091,10713,46,228,432,347,262,12028
2020-04-05,충남,전북,15966,123,654,183,221,569,17716,25445,154,628,287,295,849,27658
2020-04-05,충남,충남,122424,950,2864,1543,1750,4742,134273,122424,950,2864,1543,1750,4742,134273
2020-04-05,충남,충북,12208,138,210,193,224,578,13551,11515,111,209,180,253,548,12816
2020-04-05,충북,강원,5001,59,79,39,50,245,5473,5739,74,91,37,59,257,6257
2020-04-05,충북,경기,36677,481,604,475,407,1622,40266,29447,458,613,502,487,1396,32903
2020-04-05,충북,경남,1670,19,50,100,54,63,1956,1909,10,26,57,45,59,2106
2020-04-05,충북,경북,6386,75,105,113,109,265,7053,7414,68,102,123,137,273,8117
2020-04-05,충북,광주,606,9,19,31,15,23,703,776,7,16,22,8,22,851
2020-04-05,충북,대구,1303,11,25,43,18,57,1457,1866,11,40,57,69,71,2114
2020-04-05,충북,대전,9315,88,171,27,22,535,10158,10384,110,170,37,19,567,11287
2020-04-05,충북,부산,117,3,6,20,8,3,157,287,1,6,4,18,7,323
2020-04-05,충북,서울,19041,103,483,236,105,723,20691,17449,99,485,210,101,711,19055
2020-04-05,충북,세종,465,5,2,3,1,29,505,419,3,5,4,3,19,453
2020-04-05,충북,울산,19,0,0,1,17,1,38,23,1,1,1,4,2,32
2020-04-05,충북,전남,473,2,13,23,36,22,569,779,4,6,32,26,19,866
2020-04-05,충북,전북,2072,38,45,69,37,86,2347,2872,40,41,102,47,113,3215
2020-04-05,충북,충남,11515,111,209,180,253,548,12816,12208,138,210,193,224,578,13551
2020-04-05,충북,충북,39105,488,518,374,506,1815,42806,39105,488,518,374,506,1815,42806
2020-04-06,강원,강원,62612,2325,2385,1493,3248,4151,76214,62612,2325,2385,1493,3248,4151,76214
2020-04-06,강원,경기,20830,587,816,676,770,959,24638,19999,610,873,661,930,972,24045
2020-04-06,강원,경남,168,3,14,6,20,8,219,80,1,3,20,16,2,122
2020-04-06,강원,경북,357,19,25,17,31,12,461,332,26,18,28,43,11,458
2020-04-06,강원,광주,67,1,4,6,7,5,90,88,0,6,10,4,1,109
2020-04-06,강원,대구,130,3,5,3,10,1,152,244,6,9,17,14,7,297
2020-04-06,강원,대전,135,3,4,4,1,9,156,168,5,9,2,2,5,191
2020-04-06,강원,부산,4,0,0,0,1,0,5,4,1,0,0,5,0,10
2020-04-06,강원,서울,755,15,131,8,32,28,969,715,17,127,10,12,36,917
2020-04-06,강원,세종,4,0,0,0,0,0,4,7,0,0,0,0,0,7
2020-04-06,강원,울산,2,0,0,0,0,0,2,1,0,0,0,0,0,1
2020-04-06,강원,전남,38,1,3,2,5,3,52,40,2,2,6,10,0,60
2020-04-06,강원,전북,113,4,14,12,17,3,163,127,5,10,23,20,6,191
2020-04-06,강원,충남,314,8,19,15,25,14,395,380,10,21,20,55,13,499
2020-04-06,강원,충북,4664,207,276,263,454,287,6151,4572,197,271,203,386,248,5877
2020-04-06,경기,강원,19999,610,873,661,930,972,24045,20830,587,816,676,770,959,24638
2020-04-06,경기,경기,433643,22712,23248,18892,23811,31815,554121,433643,22712,23248,18892,23811,31815,554121
2020-04-06,경기,경남,2720,87,239,410,390,98,3944,1984,55,180,411,372,66,3068
2020-04-06,경기,경북,3903,184,404,538,460,131,5620,3333,169,361,773,535,128,5299
2020-04-06,경기,광주,691,31,94,254,131,18,1219,705,16,81,191,122,28,1143
2020-04-06,경기,대구,1514,67,147,234,164,42,2168,2202,84,134,359,432,73,3284
2020-04-06,경기,대전,1930,84,130,72,59,84,2359,2366,92,127,96,65,121,2867
2020-04-06,경기,부산,207,17,18,77,92,6,417,198,15,31,63,202,13,522
2020-04-06,경기,서울,144761,7049,8056,4771,3826,9690,178153,149742,6651,8339,4847,3475,9852,182906
2020-04-06,경기,세종,30,2,3,0,5,0,40,53,2,3,2,1,2,63
2020-04-06,경기,울산,21,0,5,5,7,1,39,39,1,1,16,51,3,111
2020-04-06,경기,전남,732,14,70,128,112,22,1078,800,14,47,107,111,13,1092
2020-04-06,경기,전북,1204,50,123,113,155,39,1684,1381,45,101,183,157,51,1918
2020-04-06,경기,충남,40372,1540,2468,2248,4208,2120,52956,37066,1471,2318,2124,3969,1934,48882
2020-04-06,경기,충북,29237,2209,2746,3052,3612,1402,42258,27080,2114,2567,2713,3828,1313,39615
2020-04-06,경남,강원,80,1,3,20,16,2,122,168,3,14,6,20,8,219
2020-04-06,경남,경기,1984,55,180,411,372,66,3068,2720,87,239,410,390,98,3944
2020-04-06,경남,경남,188428,9832,9256,6628,12583,14113,240840,188428,9832,9256,6628,12583,14113,240840
2020-04-06,경남,경북,9111,626,851,830,1751,431,13600,10880,859,1011,1064,2366,448,16628
2020-04-06,경남,광주,921,50,108,161,162,31,1433,1066,38,128,136,132,29,1529
2020-04-06,경남,대구,10844,700,696,942,1560,447,15189,8375,456,506,408,452,365,10562
2020-04-06,경남,대전,599,13,77,68,29,37,823,949,18,63,55,49,47,1181
2020-04-06,경남,부산,83288,2591,2378,1793,4306,5887,100243,84683,2661,2608,1807,4587,5942,102288
2020-04-06,경남,서울,1914,37,257,216,130,56,2610,2624,31,275,97,44,94,3165
2020-04-06,경남,세종,152,2,8,8,6,6,182,244,1,10,11,20,12,298
2020-04-06,경남,울산,9343,649,641,424,631,591,12279,8665,594,637,409,597,566,11468
2020-04-06,경남,전남,5969,261,380,443,1297,278,8628,5512,287,372,374,1197,239,7981
2020-04-06,경남,전북,1072,45,98,94,176,41,1526,1036,46,97,93,147,30,1449
2020-04-06,경남,충남,1216,48,90,228,227,50,1859,1544,47,135,252,352,49,2379
2020-04-06,경남,충북,1112,64,113,240,251,39,1819,1242,70,166,331,496,37,2342
2020-04-06,경북,강원,332,26,18,28,43,11,458,357,19,25,17,31,12,461
2020-04-06,경북,경기,3333,169,361,773,535,128,5299,3903,184,404,538,460,131,5620
2020-04-06,경북,경남,10880,859,1011,1064,2366,448,16628,9111,626,851,830,1751,431,13600
2020-04-06,경북,경북,69643,3851,3859,2753,5890,3740,89736,69643,3851,3859,2753,5890,3740,89736
2020-04-06,경북,광주,650,41,105,186,131,24,1137,822,29,98,164,86,21,1220
2020-04-06,경북,대구,67425,2806,2263,1534,3358,3635,81021,72855,3025,2652,1955,3928,3840,88255
2020-04-06,경북,대전,1476,53,74,107,80,76,1866,1709,42,74,102,57,77,2061
2020-04-06,경북,부산,3736,111,168,170,546,182,4913,4563,127,193,184,668,213,5948
2020-04-06,경북,서울,2444,80,209,347,140,93,3313,2808,47,193,186,71,118,3423
2020-04-06,경북,세종,224,7,18,20,13,8,290,279,5,9,20,14,11,338
2020-04-06,경북,울산,4841,162,271,422,1023,283,7002,4787,149,266,332,1285,292,7111
2020-04-06,경북,전남,934,43,88,118,401,30,1614,894,43,79,104,533,30,1683
2020-04-06,경북,전북,1747,89,162,187,299,62,2546,1455,110,158,157,278,53,2211
2020-04-06,경북,충남,3064,144,333,548,542,123,4754,3018,136,323,435,678,127,4717
2020-04-06,경북,충북,4754,233,508,686,1020,178,7379,4596,226,515,601,1098,180,7216
2020-04-06,광주,강원,88,0,6,10,4,1,109,67,1,4,6,7,5,90
2020-04-06,광주,경기,705,16,81,191,122,28,1143,691,31,94,254,131,18,1219
2020-04-06,광주,경남,1066,38,128,136,132,29,1529,921,50,108,161,162,31,1433
2020-04-06,광주,경북,822,29,98,164,86,21,1220,650,41,105,186,131,24,1137
2020-04-06,광주,광주,13255,471,591,641,360,573,15891,13255,471,591,641,360,573,15891
2020-04-06,광주,대구,393,20,39,84,30,15,581,472,20,38,54,27,21,632
2020-04-06,광주,대전,383,23,14,17,8,12,457,449,17,16,10,16,14,522
2020-04-06,광주,부산,341,8,28,31,58,11,477,384,14,37,58,118,11,622
2020-04-06,광주,서울,618,18,12,64,18,14,744,674,19,14,26,17,24,774
2020-04-06,광주,세종,144,0,9,6,1,1,161,149,2,10,4,1,1,167
2020-04-06,광주,울산,62,1,3,3,4,1,74,53,0,9,7,6,0,75
2020-04-06,광주,전남,34765,1016,1079,748,1999,1344,40951,31409,986,938,647,1835,1288,37103
2020-04-06,광주,전북,7914,411,488,355,388,302,9858,7442,427,450,310,412,268,9309
2020-04-06,광주,충남,4333,106,375,422,262,120,5618,3919,128,395,450,280,125,5297
2020-04-06,광주,충북,592,25,56,133,64,12,882,530,26,67,136,101,14,874
2020-04-06,대구,강원,244,6,9,17,14,7,297,130,3,5,3,10,1,152
2020-04-06,대구,경기,2202,84,134,359,432,73,3284,1514,67,147,234,164,42,2168
2020-04-06,대구,경남,8375,456,506,408,452,365,10562,10844,700,696,942,1560,447,15189
2020-04-06,대구,경북,72855,3025,2652,1955,3928,3840,88255,67425,2806,2263,1534,3358,3635,81021
2020-04-06,대구,광주,472,20,38,54,27,21,632,393,20,39,84,30,15,581
2020-04-06,대구,대구,57355,2077,1511,993,1131,3860,66927,57355,2077,1511,993,1131,3860,66927
2020-04-06,대구,대전,705,32,27,59,26,19,868,486,18,16,35,22,17,594
2020-04-06,대구,부산,516,54,79,52,129,15,845,2516,88,113,100,199,104,3120
2020-04-06,대구,서울,2087,60,81,190,104,58,2580,1480,38,51,77,37,39,1722
2020-04-06,대구,세종,262,0,3,7,8,9,289,154,2,3,5,3,5,172
2020-04-06,대구,울산,1086,64,59,71,164,46,1490,926,57,53,63,180,51,1330
2020-04-06,대구,전남,458,11,31,22,41,8,571,396,14,31,33,37,16,527
2020-04-06,대구,전북,305,9,28,11,13,12,378,244,10,31,13,31,8,337
2020-04-06,대구,충남,1349,69,131,166,243,47,2005,746,48,82,125,152,19,1172
2020-04-06,대구,충북,1486,89,137,228,373,60,2373,843,81,97,157,125,23,1326
2020-04-06,대전,강원,168,5,9,2,2,5,191,135,3,4,4,1,9,156
2020-04-06,대전,경기,2366,92,127,96,65,121,2867,1930,84,130,72,59,84,2359
2020-04-06,대전,경남,949,18,63,55,49,47,1181,599,13,77,68,29,37,823
2020-04-06,대전,경북,1709,42,74,102,57,77,2061,1476,53,74,107,80,76,1866
2020-04-06,대전,광주,449,17,16,10,16,14,522,383,23,14,17,8,12,457
2020-04-06,대전,대구,486,18,16,35,22,17,594,705,32,27,59,26,19,868
2020-04-06,대전,대전,14114,440,380,379,212,1034,16559,14114,440,380,379,212,1034,16559
2020-04-06,대전,부산,78,0,5,7,14,6,110,67,2,5,12,10,3,99
2020-04-06,대전,서울,1994,39,111,26,15,79,2264,1741,44,104,20,8,74,1991
2020-04-06,대전,세종,3451,86,77,23,84,244,3965,3493,78,77,37,92,267,4044
2020-04-06,대전,울산,105,2,5,7,29,3,151,89,2,3,8,26,2,130
2020-04-06,대전,전남,323,11,1,16,20,7,378,263,11,4,22,24,10,334
2020-04-06,대전,전북,3171,72,88,50,46,139,3566,2821,95,74,81,53,137,3261
2020-04-06,대전,충남,17197,480,488,257,370,1273,20065,14675,448,480,279,307,1135,17324
2020-04-06,대전,충북,11355,473,400,206,180,827,13441,9756,388,329,155,153,745,11526
2020-04-06,부산,강원,4,1,0,0,5,0,10,4,0,0,0,1,0,5
2020-04-06,부산,경기,198,15,31,63,202,13,522,207,17,18,77,92,6,417
2020-04-06,부산,경남,84683,2661,2608,1807,4587,5942,102288,83288,2591,2378,1793,4306,5887,100243
2020-04-06,부산,경북,4563,127,193,184,668,213,5948,3736,111,168,170,546,182,4913
2020-04-06,부산,광주,384,14,37,58,118,11,622,341,8,28,31,58,11,477
2020-04-06,부산,대구,2516,88,113,100,199,104,3120,516,54,79,52,129,15,845
2020-04-06,부산,대전,67,2,5,12,10,3,99,78,0,5,7,14,6,110
2020-04-06,부산,부산,42060,687,550,707,2174,3108,49286,42060,687,550,707,2174,3108,49286
2020-04-06,부산,서울,184,4,11,62,45,9,315,192,11,6,23,23,5,260
2020-04-06,부산,세종,17,0,1,4,1,0,23,22,2,0,1,2,0,27
2020-04-06,부산,울산,15662,339,445,618,2331,1157,20552,14540,358,410,428,2249,1126,19111
2020-04-06,부산,전남,1966,85,97,197,537,90,2972,1595,78,82,126,528,78,2487
2020-04-06,부산,전북,283,10,22,32,89,16,452,262,9,23,25,67,9,395
2020-04-06,부산,충남,201,6,21,50,109,5,392,148,9,21,43,126,4,351
2020-04-06,부산,충북,110,10,23,59,143,4,349,97,10,19,71,155,3,355
2020-04-06,서울,강원,715,17,127,10,12,36,917,755,15,131,8,32,28,969
2020-04-06,서울,경기,149742,6651,8339,4847,3475,9852,182906,144761,7049,8056,4771,3826,9690,178153
2020-04-06,서울,경남,2624,31,275,97,44,94,3165,1914,37,257,216,130,56,2610
2020-04-06,서울,경북,2808,47,193,186,71,118,3423,2444,80,209,347,140,93,3313
2020-04-06,서울,광주,674,19,14,26,17,24,774,618,18,12,64,18,14,744
2020-04-06,서울,대구,1480,38,51,77,37,39,1722,2087,60,81,190,104,58,2580
2020-04-06,서울,대전,1741,44,104,20,8,74,1991,1994,39,111,26,15,79,2264
2020-04-06,서울,부산,192,11,6,23,23,5,260,184,4,11,62,45,9,315
2020-04-06,서울,서울,187,7,7,1,2,7,211,187,7,7,1,2,7,211
2020-04-06,서울,세종,44,1,0,0,0,1,46,21,1,0,1,0,0,23
2020-04-06,서울,울산,35,0,2,2,0,1,40,22,0,3,1,8,0,34
2020-04-06,서울,전남,836,11,17,24,16,21,925,919,4,17,63,36,28,1067
2020-04-06,서울,전북,1285,24,39,26,22,43,1439,1352,16,50,44,27,44,1533
2020-04-06,서울,충남,28730,505,1701,742,710,1203,33591,27171,581,1646,1201,1281,1080,32960
2020-04-06,서울,충북,15589,541,869,723,749,624,19095,13491,640,880,807,925,600,17343
2020-04-06,세종,강원,7,0,0,0,0,0,7,4,0,0,0,0,0,4
2020-04-06,세종,경기,53,2,3,2,1,2,63,30,2,3,0,5,0,40
2020-04-06,세종,경남,244,1,10,11,20,12,298,152,2,8,8,6,6,182
2020-04-06,세종,경북,279,5,9,20,14,11,338,224,7,18,20,13,8,290
2020-04-06,세종,광주,149,2,10,4,1,1,167,144,0,9,6,1,1,161
2020-04-06,세종,대구,154,2,3,5,3,5,172,262,0,3,7,8,9,289
2020-04-06,세종,대전,3493,78,77,37,92,267,4044,3451,86,77,23,84,244,3965
2020-04-06,세종,부산,22,2,0,1,2,0,27,17,0,1,4,1,0,23
2020-04-06,세종,서울,21,1,0,1,0,0,23,44,1,0,0,0,1,46
2020-04-06,세종,세종,216,22,8,2,0,18,266,216,22,8,2,0,18,266
2020-04-06,세종,울산,10,0,0,2,2,1,15,11,0,1,0,3,1,16
2020-04-06,세종,전남,142,1,2,6,11,2,164,131,1,0,6,13,4,155
2020-04-06,세종,전북,701,22,24,14,31,33,825,611,12,19,9,35,27,713
2020-04-06,세종,충남,6302,173,162,109,198,352,7296,4349,135,131,120,133,240,5108
2020-04-06,세종,충북,414,12,19,9,15,32,501,357,17,18,8,26,31,457
2020-04-06,울산,강원,1,0,0,0,0,0,1,2,0,0,0,0,0,2
2020-04-06,울산,경기,39,1,1,16,51,3,111,21,0,5,5,7,1,39
2020-04-06,울산,경남,8665,594,637,409,597,566,11468,9343,649,641,424,631,591,12279
2020-04-06,울산,경북,4787,149,266,332,1285,292,7111,4841,162,271,422,1023,283,7002
2020-04-06,울산,광주,53,0,9,7,6,0,75,62,1,3,3,4,1,74
2020-04-06,울산,대구,926,57,53,63,180,51,1330,1086,64,59,71,164,46,1490
2020-04-06,울산,대전,89,2,3,8,26,2,130,105,2,5,7,29,3,151
2020-04-06,울산,부산,14540,358,410,428,2249,1126,19111,15662,339,445,618,2331,1157,20552
2020-04-06,울산,서울,22,0,3,1,8,0,34,35,0,2,2,0,1,40
2020-04-06,울산,세종,11,0,1,0,3,1,16,10,0,0,2,2,1,15
2020-04-06,울산,울산,7742,321,483,331,677,698,10252,7742,321,483,331,677,698,10252
2020-04-06,울산,전남,172,11,21,9,34,3,250,187,14,23,12,66,3,305
2020-04-06,울산,전북,36,0,5,4,12,2,59,30,2,4,5,3,2,46
2020-04-06,울산,충남,151,5,16,54,107,4,337,143,2,8,25,73,0,251
2020-04-06,울산,충북,14,2,1,6,45,1,69,15,0,3,10,30,1,59
2020-04-06,전남,강원,40,2,2,6,10,0,60,38,1,3,2,5,3,52
2020-04-06,전남,경기,800,14,47,107,111,13,1092,732,14,70,128,112,22,1078
2020-04-06,전남,경남,5512,287,372,374,1197,239,7981,5969,261,380,443,1297,278,8628
2020-04-06,전남,경북,894,43,79,104,533,30,1683,934,43,88,118,401,30,1614
2020-04-06,전남,광주,31409,986,938,647,1835,1288,37103,34765,1016,1079,748,1999,1344,40951
2020-04-06,전남,대구,396,14,31,33,37,16,527,458,11,31,22,41,8,571
2020-04-06,전남,대전,263,11,4,22,24,10,334,323,11,1,16,20,7,378
2020-04-06,전남,부산,1595,78,82,126,528,78,2487,1966,85,97,197,537,90,2972
2020-04-06,전남,서울,919,4,17,63,36,28,1067,836,11,17,24,16,21,925
2020-04-06,전남,세종,131,1,0,6,13,4,155,142,1,2,6,11,2,164
2020-04-06,전남,울산,187,14,23,12,66,3,305,172,11,21,9,34,3,250
2020-04-06,전남,전남,44513,1420,1408,1642,4870,1794,55647,44513,1420,1408,1642,4870,1794,55647
2020-04-06,전남,전북,4691,296,546,444,1393,144,7514,4846,223,493,528,1386,173,7649
2020-04-06,전남,충남,4574,94,324,610,1126,118,6846,4164,86,334,424,810,117,5935
2020-04-06,전남,충북,362,12,27,70,228,15,714,384,20,44,97,194,13,752
2020-04-06,전북,강원,127,5,10,23,20,6,191,113,4,14,12,17,3,163
2020-04-06,전북,경기,1381,45,101,183,157,51,1918,1204,50,123,113,155,39,1684
2020-04-06,전북,경남,1036,46,97,93,147,30,1449,1072,45,98,94,176,41,1526
2020-04-06,전북,경북,1455,110,158,157,278,53,2211,1747,89,162,187,299,62,2546
2020-04-06,전북,광주,7442,427,450,310,412,268,9309,7914,411,488,355,388,302,9858
2020-04-06,전북,대구,244,10,31,13,31,8,337,305,9,28,11,13,12,378
2020-04-06,전북,대전,2821,95,74,81,53,137,3261,3171,72,88,50,46,139,3566
2020-04-06,전북,부산,262,9,23,25,67,9,395,283,10,22,32,89,16,452
2020-04-06,전북,서울,1352,16,50,44,27,44,1533,1285,24,39,26,22,43,1439
2020-04-06,전북,세종,611,12,19,9,35,27,713,701,22,24,14,31,33,825
2020-04-06,전북,울산,30,2,4,5,3,2,46,36,0,5,4,12,2,59
2020-04-06,전북,전남,4846,223,493,528,1386,173,7649,4691,296,546,444,1393,144,7514
2020-04-06,전북,전북,16327,664,874,741,938,632,20176,16327,664,874,741,938,632,20176
2020-04-06,전북,충남,13472,546,1267,1070,1348,468,18171,13093,511,1241,836,1318,457,17456
2020-04-06,전북,충북,1836,102,193,278,265,62,2736,1674,129,240,264,256,70,2633
2020-04-06,충남,강원,380,10,21,20,55,13,499,314,8,19,15,25,14,395
2020-04-06,충남,경기,37066,1471,2318,2124,3969,1934,48882,40372,1540,2468,2248,4208,2120,52956
2020-04-06,충남,경남,1544,47,135,252,352,49,2379,1216,48,90,228,227,50,1859
2020-04-06,충남,경북,3018,136,323,435,678,127,4717,3064,144,333,548,542,123,4754
2020-04-06,충남,광주,3919,128,395,450,280,125,5297,4333,106,375,422,262,120,5618
2020-04-06,충남,대구,746,48,82,125,152,19,1172,1349,69,131,166,243,47,2005
2020-04-06,충남,대전,14675,448,480,279,307,1135,17324,17197,480,488,257,370,1273,20065
2020-04-06,충남,부산,148,9,21,43,126,4,351,201,6,21,50,109,5,392
2020-04-06,충남,서울,27171,581,1646,1201,1281,1080,32960,28730,505,1701,742,710,1203,33591
2020-04-06,충남,세종,4349,135,131,120,133,240,5108,6302,173,162,109,198,352,7296
2020-04-06,충남,울산,143,2,8,25,73,0,251,151,5,16,54,107,4,337
2020-04-06,충남,전남,4164,86,334,424,810,117,5935,4574,94,324,610,1126,118,6846
2020-04-06,충남,전북,13093,511,1241,836,1318,457,17456,13472,546,1267,1070,1348,468,18171
2020-04-06,충남,충남,98500,3656,6631,6674,10068,4714,130243,98500,3656,6631,6674,10068,4714,130243
2020-04-06,충남,충북,13607,691,833,901,1385,764,18181,12584,643,819,812,1415,719,16992
2020-04-06,충북,강원,4572,197,271,203,386,248,5877,4664,207,276,263,454,287,6151
2020-04-06,충북,경기,27080,2114,2567,2713,3828,1313,39615,29237,2209,2746,3052,3612,1402,42258
2020-04-06,충북,경남,1242,70,166,331,496,37,2342,1112,64,113,240,251,39,1819
2020-04-06,충북,경북,4596,226,515,601,1098,180,7216,4754,233,508,686,1020,178,7379
2020-04-06,충북,광주,530,26,67,136,101,14,874,592,25,56,133,64,12,882
2020-04-06,충북,대구,843,81,97,157,125,23,1326,1486,89,137,228,373,60,2373
2020-04-06,충북,대전,9756,388,329,155,153,745,11526,11355,473,400,206,180,827,13441
2020-04-06,충북,부산,97,10,19,71,155,3,355,110,10,23,59,143,4,349
2020-04-06,충북,서울,13491,640,880,807,925,600,17343,15589,541,869,723,749,624,19095
2020-04-06,충북,세종,357,17,18,8,26,31,457,414,12,19,9,15,32,501
2020-04-06,충북,울산,15,0,3,10,30,1,59,14,2,1,6,45,1,69
2020-04-06,충북,전남,384,20,44,97,194,13,752,362,12,27,70,228,15,714
2020-04-06,충북,전북,1674,129,240,264,256,70,2633,1836,102,193,278,265,62,2736
2020-04-06,충북,충남,12584,643,819,812,1415,719,16992,13607,691,833,901,1385,764,18181
2020-04-06,충북,충북,37437,2007,2264,2276,3629,2240,49853,37437,2007,2264,2276,3629,2240,49853
2020-04-07,강원,강원,60143,2444,2523,1613,3344,4077,74144,60143,2444,2523,1613,3344,4077,74144
2020-04-07,강원,경기,17997,627,928,700,871,889,22012,19079,659,849,803,1092,896,23378
2020-04-07,강원,경남,105,4,10,9,28,4,160,89,0,5,23,19,1,137
2020-04-07,강원,경북,343,27,19,22,28,5,444,290,23,15,38,34,15,415
2020-04-07,강원,광주,66,3,7,11,11,0,98,60,2,8,13,6,4,93
2020-04-07,강원,대구,113,8,7,12,5,4,149,170,9,18,21,13,11,242
2020-04-07,강원,대전,128,5,9,4,3,1,150,141,7,9,6,2,4,169
2020-04-07,강원,부산,1,0,0,1,2,0,4,2,0,0,2,4,0,8
2020-04-07,강원,서울,849,20,124,11,34,30,1068,742,23,112,9,18,31,935
2020-04-07,강원,세종,5,0,0,0,2,0,7,3,0,0,0,2,0,5
2020-04-07,강원,울산,2,0,0,0,0,0,2,2,0,0,0,1,0,3
2020-04-07,강원,전남,30,0,2,7,9,2,50,29,0,4,8,8,2,51
2020-04-07,강원,전북,77,4,12,6,12,3,114,100,10,12,24,23,2,171
2020-04-07,강원,충남,236,5,24,29,40,4,338,349,10,25,37,57,14,492
2020-04-07,강원,충북,4246,247,285,312,467,237,5794,4385,249,244,267,410,249,5804
2020-04-07,경기,강원,19079,659,849,803,1092,896,23378,17997,627,928,700,871,889,22012
2020-04-07,경기,경기,432846,23598,24034,19885,25133,31486,556982,432846,23598,24034,19885,25133,31486,556982
2020-04-07,경기,경남,2299,113,296,839,640,84,4271,1465,72,205,589,464,50,2845
2020-04-07,경기,경북,3296,216,466,773,633,119,5503,3134,209,419,967,599,115,5443
2020-04-07,경기,광주,659,28,127,330,183,19,1346,563,24,93,232,128,21,1061
2020-04-07,경기,대구,1302,100,181,424,227,51,2285,1816,113,190,523,466,59,3167
2020-04-07,경기,대전,1809,116,147,145,54,78,2349,1780,107,145,103,49,67,2251
2020-04-07,경기,부산,155,22,45,204,166,4,596,196,26,39,149,318,4,732
2020-04-07,경기,서울,148653,7475,8351,5444,4325,9761,184009,144451,7013,8476,4915,3910,9471,178236
2020-04-07,경기,세종,43,2,5,1,2,1,54,39,3,5,1,2,2,52
2020-04-07,경기,울산,34,2,6,9,20,0,71,46,2,11,39,66,0,164
2020-04-07,경기,전남,610,26,89,187,157,16,1085,591,17,61,163,141,20,993
2020-04-07,경기,전북,1184,57,127,156,195,43,1762,1124,49,110,174,176,51,1684
2020-04-07,경기,충남,36570,1601,2583,2562,4688,1855,49859,35378,1515,2458,2389,4432,1795,47967
2020-04-07,경기,충북,26274,2295,2877,3465,3812,1328,40051,25259,2213,2752,2946,4024,1198,38392
2020-04-07,경남,강원,89,0,5,23,19,1,137,105,4,10,9,28,4,160
2020-04-07,경남,경기,1465,72,205,589,464,50,2845,2299,113,296,839,640,84,4271
2020-04-07,경남,경남,185049,10091,9434,7519,13005,14030,239128,185049,10091,9434,7519,13005,14030,239128
2020-04-07,경남,경북,8172,626,935,975,1874,370,12952,10021,855,1108,1334,2708,441,16467
2020-04-07,경남,광주,909,42,104,181,167,25,1428,907,42,137,156,144,13,1399
2020-04-07,경남,대구,10034,709,752,1069,1784,379,14727,7810,467,560,445,503,295,10080
2020-04-07,경남,대전,555,26,75,94,45,15,810,764,34,76,117,63,24,1078
2020-04-07,경남,부산,83245,2594,2521,2019,4679,5971,101029,82552,2709,2649,2076,4928,5887,100801
2020-04-07,경남,서울,1570,38,294,319,155,43,2419,2184,48,290,232,110,68,2932
2020-04-07,경남,세종,97,2,6,10,5,3,123,176,1,8,12,14,5,216
2020-04-07,경남,울산,8869,613,639,441,661,614,11837,8397,572,683,422,613,564,11251
2020-04-07,경남,전남,5252,307,443,490,1480,222,8194,5175,326,462,431,1496,232,8122
2020-04-07,경남,전북,893,48,103,123,189,39,1395,893,47,107,104,170,34,1355
2020-04-07,경남,충남,1027,58,112,297,262,19,1775,1332,74,138,377,543,34,2498
2020-04-07,경남,충북,847,59,126,288,248,22,1590,1084,77,210,504,612,30,2517
2020-04-07,경북,강원,290,23,15,38,34,15,415,343,27,19,22,28,5,444
2020-04-07,경북,경기,3134,209,419,967,599,115,5443,3296,216,466,773,633,119,5503
2020-04-07,경북,경남,10021,855,1108,1334,2708,441,16467,8172,626,935,975,1874,370,12952
2020-04-07,경북,경북,68125,4090,3909,3862,6091,3618,89695,68125,4090,3909,3862,6091,3618,89695
2020-04-07,경북,광주,606,51,111,229,168,27,1192,542,54,98,174,93,21,982
2020-04-07,경북,대구,67892,2973,2339,1724,3172,3608,81708,71234,3166,2692,2121,3809,3639,86661
2020-04-07,경북,대전,1387,50,89,121,89,75,1811,1451,57,70,133,66,69,1846
2020-04-07,경북,부산,3580,140,209,236,719,160,5044,3951,150,203,221,768,162,5455
2020-04-07,경북,서울,2364,109,250,481,169,66,3439,2377,85,206,261,118,71,3118
2020-04-07,경북,세종,194,3,12,22,12,6,249,210,5,13,20,10,3,261
2020-04-07,경북,울산,4567,169,281,445,1090,264,6816,4436,156,270,349,1317,272,6800
2020-04-07,경북,전남,819,55,84,122,424,18,1522,858,56,82,97,577,28,1698
2020-04-07,경북,전북,1651,100,196,249,335,54,2585,1535,98,150,193,268,41,2285
2020-04-07,경북,충남,2587,167,354,571,656,95,4430,2615,142,370,530,820,94,4571
2020-04-07,경북,충북,4268,228,488,738,1134,151,7007,4237,261,534,731,1209,150,7122
2020-04-07,광주,강원,60,2,8,13,6,4,93,66,3,7,11,11,0,98
2020-04-07,광주,경기,563,24,93,232,128,21,1061,659,28,127,330,183,19,1346
2020-04-07,광주,경남,907,42,137,156,144,13,1399,909,42,104,181,167,25,1428
2020-04-07,광주,경북,542,54,98,174,93,21,982,606,51,111,229,168,27,1192
2020-04-07,광주,광주,13724,544,605,423,539,576,16411,13724,544,605,423,539,576,16411
2020-04-07,광주,대구,394,41,64,97,41,13,650,390,40,69,78,36,10,623
2020-04-07,광주,대전,369,16,18,22,14,10,449,422,25,16,35,10,8,516
2020-04-07,광주,부산,314,19,31,46,56,6,472,383,18,50,83,103,12,649
2020-04-07,광주,서울,524,22,18,68,25,15,672,695,28,29,53,19,14,838
2020-04-07,광주,세종,106,2,9,8,5,4,134,123,3,7,7,4,5,149
2020-04-07,광주,울산,40,1,7,1,5,3,57,31,2,6,4,12,0,55
2020-04-07,광주,전남,32980,1035,1135,893,2126,1294,39463,31610,1041,1006,772,2031,1214,37674
2020-04-07,광주,전북,7402,426,527,390,405,251,9401,7357,455,464,363,442,268,9349
2020-04-07,광주,충남,3524,108,386,457,291,84,4850,3602,145,405,622,385,85,5244
2020-04-07,광주,충북,445,31,74,128,77,10,765,537,30,86,199,121,7,980
2020-04-07,대구,강원,170,9,18,21,13,11,242,113,8,7,12,5,4,149
2020-04-07,대구,경기,1816,113,190,523,466,59,3167,1302,100,181,424,227,51,2285
2020-04-07,대구,경남,7810,467,560,445,503,295,10080,10034,709,752,1069,1784,379,14727
2020-04-07,대구,경북,71234,3166,2692,2121,3809,3639,86661,67892,2973,2339,1724,3172,3608,81708
2020-04-07,대구,광주,390,40,69,78,36,10,623,394,41,64,97,41,13,650
2020-04-07,대구,대구,56068,2081,1621,1380,1212,3741,66103,56068,2081,1621,1380,1212,3741,66103
2020-04-07,대구,대전,661,37,30,89,45,19,881,421,26,27,56,26,17,573
2020-04-07,대구,부산,440,42,109,57,171,16,835,2075,90,158,104,272,86,2785
2020-04-07,대구,서울,1836,76,93,275,123,61,2464,1279,50,80,168,52,34,1663
2020-04-07,대구,세종,160,4,4,6,7,4,185,92,4,2,2,4,2,106
2020-04-07,대구,울산,843,61,62,87,154,45,1252,855,47,70,72,180,43,1267
2020-04-07,대구,전남,405,23,35,36,45,11,555,350,14,36,37,80,7,524
2020-04-07,대구,전북,260,17,27,19,20,11,354,214,9,27,27,25,7,309
2020-04-07,대구,충남,1061,77,145,252,257,29,1821,657,62,105,171,170,22,1187
2020-04-07,대구,충북,1149,108,147,300,406,39,2149,831,82,108,274,162,27,1484
2020-04-07,대전,강원,141,7,9,6,2,4,169,128,5,9,4,3,1,150
2020-04-07,대전,경기,1780,107,145,103,49,67,2251,1809,116,147,145,54,78,2349
2020-04-07,대전,경남,764,34,76,117,63,24,1078,555,26,75,94,45,15,810
2020-04-07,대전,경북,1451,57,70,133,66,69,1846,1387,50,89,121,89,75,1811
2020-04-07,대전,광주,422,25,16,35,10,8,516,369,16,18,22,14,10,449
2020-04-07,대전,대구,421,26,27,56,26,17,573,661,37,30,89,45,19,881
2020-04-07,대전,대전,14059,404,440,296,292,1018,16509,14059,404,440,296,292,1018,16509
2020-04-07,대전,부산,43,2,4,22,19,5,95,61,4,7,19,23,2,116
2020-04-07,대전,서울,1548,52,101,48,12,79,1840,1574,43,112,38,16,71,1854
2020-04-07,대전,세종,3215,91,55,33,63,270,3727,3364,91,81,42,64,277,3919
2020-04-07,대전,울산,84,4,6,20,32,5,151,64,6,8,16,25,2,121
2020-04-07,대전,전남,245,4,6,35,32,9,331,249,5,14,29,23,3,323
2020-04-07,대전,전북,2732,87,87,90,47,139,3182,2713,102,74,82,54,134,3159
2020-04-07,대전,충남,16149,480,529,308,343,1232,19041,14681,459,474,259,313,1132,17318
2020-04-07,대전,충북,10892,451,424,235,205,797,13004,9773,407,374,167,173,750,11644
2020-04-07,부산,강원,2,0,0,2,4,0,8,1,0,0,1,2,0,4
2020-04-07,부산,경기,196,26,39,149,318,4,732,155,22,45,204,166,4,596
2020-04-07,부산,경남,82552,2709,2649,2076,4928,5887,100801,83245,2594,2521,2019,4679,5971,101029
2020-04-07,부산,경북,3951,150,203,221,768,162,5455,3580,140,209,236,719,160,5044
2020-04-07,부산,광주,383,18,50,83,103,12,649,314,19,31,46,56,6,472
2020-04-07,부산,대구,2075,90,158,104,272,86,2785,440,42,109,57,171,16,835
2020-04-07,부산,대전,61,4,7,19,23,2,116,43,2,4,22,19,5,95
2020-04-07,부산,부산,42280,723,625,725,2121,3145,49619,42280,723,625,725,2121,3145,49619
2020-04-07,부산,서울,173,14,20,89,83,5,384,159,14,21,62,25,6,287
2020-04-07,부산,세종,13,0,0,3,2,0,18,10,1,0,3,1,0,15
2020-04-07,부산,울산,14935,372,464,648,2347,1074,19840,14820,390,402,450,2322,1086,19470
2020-04-07,부산,전남,1699,82,124,198,495,63,2661,1570,76,110,144,538,58,2496
2020-04-07,부산,전북,239,14,33,47,128,6,467,217,12,26,50,64,6,375
2020-04-07,부산,충남,116,14,34,61,175,5,405,107,15,27,109,202,2,462
2020-04-07,부산,충북,80,12,28,85,189,4,398,78,12,28,121,195,1,435
2020-04-07,서울,강원,742,23,112,9,18,31,935,849,20,124,11,34,30,1068
2020-04-07,서울,경기,144451,7013,8476,4915,3910,9471,178236,148653,7475,8351,5444,4325,9761,184009
2020-04-07,서울,경남,2184,48,290,232,110,68,2932,1570,38,294,319,155,43,2419
2020-04-07,서울,경북,2377,85,206,261,118,71,3118,2364,109,250,481,169,66,3439
2020-04-07,서울,광주,695,28,29,53,19,14,838,524,22,18,68,25,15,672
2020-04-07,서울,대구,1279,50,80,168,52,34,1663,1836,76,93,275,123,61,2464
2020-04-07,서울,대전,1574,43,112,38,16,71,1854,1548,52,101,48,12,79,1840
2020-04-07,서울,부산,159,14,21,62,25,6,287,173,14,20,89,83,5,384
2020-04-07,서울,서울,200,12,8,4,5,10,239,200,12,8,4,5,10,239
2020-04-07,서울,세종,36,1,0,1,0,1,39,35,0,0,1,0,1,37
2020-04-07,서울,울산,20,2,5,1,0,0,28,13,2,3,10,9,1,38
2020-04-07,서울,전남,763,15,26,46,31,23,904,669,18,22,71,54,22,856
2020-04-07,서울,전북,1248,25,44,22,15,46,1400,998,27,42,49,24,27,1167
2020-04-07,서울,충남,24845,536,1682,887,794,947,29691,24472,650,1655,1381,1352,959,30469
2020-04-07,서울,충북,13106,559,959,892,809,538,16863,12974,670,971,933,988,569,17105
2020-04-07,세종,강원,3,0,0,0,2,0,5,5,0,0,0,2,0,7
2020-04-07,세종,경기,39,3,5,1,2,2,52,43,2,5,1,2,1,54
2020-04-07,세종,경남,176,1,8,12,14,5,216,97,2,6,10,5,3,123
2020-04-07,세종,경북,210,5,13,20,10,3,261,194,3,12,22,12,6,249
2020-04-07,세종,광주,123,3,7,7,4,5,149,106,2,9,8,5,4,134
2020-04-07,세종,대구,92,4,2,2,4,2,106,160,4,4,6,7,4,185
2020-04-07,세종,대전,3364,91,81,42,64,277,3919,3215,91,55,33,63,270,3727
2020-04-07,세종,부산,10,1,0,3,1,0,15,13,0,0,3,2,0,18
2020-04-07,세종,서울,35,0,0,1,0,1,37,36,1,0,1,0,1,39
2020-04-07,세종,세종,213,30,9,0,0,19,271,213,30,9,0,0,19,271
2020-04-07,세종,울산,6,0,1,1,5,0,13,5,0,1,2,5,0,13
2020-04-07,세종,전남,95,3,6,5,13,0,122,119,3,2,8,14,1,147
2020-04-07,세종,전북,531,18,22,14,46,17,648,520,13,26,14,70,17,660
2020-04-07,세종,충남,5561,154,162,118,191,324,6510,4184,156,155,109,169,215,4988
2020-04-07,세종,충북,384,16,16,17,9,27,469,341,19,15,9,24,27,435
2020-04-07,울산,강원,2,0,0,0,1,0,3,2,0,0,0,0,0,2
2020-04-07,울산,경기,46,2,11,39,66,0,164,34,2,6,9,20,0,71
2020-04-07,울산,경남,8397,572,683,422,613,564,11251,8869,613,639,441,661,614,11837
2020-04-07,울산,경북,4436,156,270,349,1317,272,6800,4567,169,281,445,1090,264,6816
2020-04-07,울산,광주,31,2,6,4,12,0,55,40,1,7,1,5,3,57
2020-04-07,울산,대구,855,47,70,72,180,43,1267,843,61,62,87,154,45,1252
2020-04-07,울산,대전,64,6,8,16,25,2,121,84,4,6,20,32,5,151
2020-04-07,울산,부산,14820,390,402,450,2322,1086,19470,14935,372,464,648,2347,1074,19840
2020-04-07,울산,서울,13,2,3,10,9,1,38,20,2,5,1,0,0,28
2020-04-07,울산,세종,5,0,1,2,5,0,13,6,0,1,1,5,0,13
2020-04-07,울산,울산,7744,307,473,311,658,758,10251,7744,307,473,311,658,758,10251
2020-04-07,울산,전남,163,14,21,11,29,0,238,158,16,29,11,74,1,289
2020-04-07,울산,전북,44,1,5,4,14,0,68,37,2,4,4,3,1,51
2020-04-07,울산,충남,112,8,25,63,136,1,345,107,6,8,38,98,3,260
2020-04-07,울산,충북,19,1,2,23,55,0,100,18,0,6,16,32,0,72
2020-04-07,전남,강원,29,0,4,8,8,2,51,30,0,2,7,9,2,50
2020-04-07,전남,경기,591,17,61,163,141,20,993,610,26,89,187,157,16,1085
2020-04-07,전남,경남,5175,326,462,431,1496,232,8122,5252,307,443,490,1480,222,8194
2020-04-07,전남,경북,858,56,82,97,577,28,1698,819,55,84,122,424,18,1522
2020-04-07,전남,광주,31610,1041,1006,772,2031,1214,37674,32980,1035,1135,893,2126,1294,39463
2020-04-07,전남,대구,350,14,36,37,80,7,524,405,23,35,36,45,11,555
2020-04-07,전남,대전,249,5,14,29,23,3,323,245,4,6,35,32,9,331
2020-04-07,전남,부산,1570,76,110,144,538,58,2496,1699,82,124,198,495,63,2661
2020-04-07,전남,서울,669,18,22,71,54,22,856,763,15,26,46,31,23,904
2020-04-07,전남,세종,119,3,2,8,14,1,147,95,3,6,5,13,0,122
2020-04-07,전남,울산,158,16,29,11,74,1,289,163,14,21,11,29,0,238
2020-04-07,전남,전남,42639,1559,1608,1968,5655,1778,55207,42639,1559,1608,1968,5655,1778,55207
2020-04-07,전남,전북,4336,300,509,550,1388,143,7226,4332,273,443,629,1363,134,7174
2020-04-07,전남,충남,3630,108,373,713,1225,98,6147,3701,101,378,615,997,111,5903
2020-04-07,전남,충북,282,16,24,114,241,4,681,315,22,47,128,260,8,780
2020-04-07,전북,강원,100,10,12,24,23,2,171,77,4,12,6,12,3,114
2020-04-07,전북,경기,1124,49,110,174,176,51,1684,1184,57,127,156,195,43,1762
2020-04-07,전북,경남,893,47,107,104,170,34,1355,893,48,103,123,189,39,1395
2020-04-07,전북,경북,1535,98,150,193,268,41,2285,1651,100,196,249,335,54,2585
2020-04-07,전북,광주,7357,455,464,363,442,268,9349,7402,426,527,390,405,251,9401
2020-04-07,전북,대구,214,9,27,27,25,7,309,260,17,27,19,20,11,354
2020-04-07,전북,대전,2713,102,74,82,54,134,3159,2732,87,87,90,47,139,3182
2020-04-07,전북,부산,217,12,26,50,64,6,375,239,14,33,47,128,6,467
2020-04-07,전북,서울,998,27,42,49,24,27,1167,1248,25,44,22,15,46,1400
2020-04-07,전북,세종,520,13,26,14,70,17,660,531,18,22,14,46,17,648
2020-04-07,전북,울산,37,2,4,4,3,1,51,44,1,5,4,14,0,68
2020-04-07,전북,전남,4332,273,443,629,1363,134,7174,4336,300,509,550,1388,143,7226
2020-04-07,전북,전북,16434,730,917,723,931,609,20344,16434,730,917,723,931,609,20344
2020-04-07,전북,충남,12077,570,1293,1167,1485,411,17003,12062,536,1255,1021,1471,416,16761
2020-04-07,전북,충북,1480,133,226,301,297,57,2494,1585,146,245,284,288,59,2607
2020-04-07,충남,강원,349,10,25,37,57,14,492,236,5,24,29,40,4,338
2020-04-07,충남,경기,35378,1515,2458,2389,4432,1795,47967,36570,1601,2583,2562,4688,1855,49859
2020-04-07,충남,경남,1332,74,138,377,543,34,2498,1027,58,112,297,262,19,1775
2020-04-07,충남,경북,2615,142,370,530,820,94,4571,2587,167,354,571,656,95,4430
2020-04-07,충남,광주,3602,145,405,622,385,85,5244,3524,108,386,457,291,84,4850
2020-04-07,충남,대구,657,62,105,171,170,22,1187,1061,77,145,252,257,29,1821
2020-04-07,충남,대전,14681,459,474,259,313,1132,17318,16149,480,529,308,343,1232,19041
2020-04-07,충남,부산,107,15,27,109,202,2,462,116,14,34,61,175,5,405
2020-04-07,충남,서울,24472,650,1655,1381,1352,959,30469,24845,536,1682,887,794,947,29691
2020-04-07,충남,세종,4184,156,155,109,169,215,4988,5561,154,162,118,191,324,6510
2020-04-07,충남,울산,107,6,8,38,98,3,260,112,8,25,63,136,1,345
2020-04-07,충남,전남,3701,101,378,615,997,111,5903,3630,108,373,713,1225,98,6147
2020-04-07,충남,전북,12062,536,1255,1021,1471,416,16761,12077,570,1293,1167,1485,411,17003
2020-04-07,충남,충남,91501,3843,6981,7675,10978,4280,125258,91501,3843,6981,7675,10978,4280,125258
2020-04-07,충남,충북,13156,737,888,1029,1535,728,18073,12195,668,801,873,1483,664,16684
2020-04-07,충북,강원,4385,249,244,267,410,249,5804,4246,247,285,312,467,237,5794
2020-04-07,충북,경기,25259,2213,2752,2946,4024,1198,38392,26274,2295,2877,3465,3812,1328,40051
2020-04-07,충북,경남,1084,77,210,504,612,30,2517,847,59,126,288,248,22,1590
2020-04-07,충북,경북,4237,261,534,731,1209,150,7122,4268,228,488,738,1134,151,7007
2020-04-07,충북,광주,537,30,86,199,121,7,980,445,31,74,128,77,10,765
2020-04-07,충북,대구,831,82,108,274,162,27,1484,1149,108,147,300,406,39,2149
2020-04-07,충북,대전,9773,407,374,167,173,750,11644,10892,451,424,235,205,797,13004
2020-04-07,충북,부산,78,12,28,121,195,1,435,80,12,28,85,189,4,398
2020-04-07,충북,서울,12974,670,971,933,988,569,17105,13106,559,959,892,809,538,16863
2020-04-07,충북,세종,341,19,15,9,24,27,435,384,16,16,17,9,27,469
2020-04-07,충북,울산,18,0,6,16,32,0,72,19,1,2,23,55,0,100
2020-04-07,충북,전남,315,22,47,128,260,8,780,282,16,24,114,241,4,681
2020-04-07,충북,전북,1585,146,245,284,288,59,2607,1480,133,226,301,297,57,2494
2020-04-07,충북,충남,12195,668,801,873,1483,664,16684,13156,737,888,1029,1535,728,18073
2020-04-07,충북,충북,37112,2114,2294,2282,3497,2117,49416,37112,2114,2294,2282,3497,2117,49416
2020-04-08,강원,강원,60465,2512,2408,1613,3222,4051,74271,60465,2512,2408,1613,3222,4051,74271
2020-04-08,강원,경기,18187,643,921,684,787,908,22130,19068,648,884,703,932,912,23147
2020-04-08,강원,경남,101,2,6,20,29,3,161,59,1,4,17,16,0,97
2020-04-08,강원,경북,293,23,20,21,24,11,392,299,15,13,38,28,6,399
2020-04-08,강원,광주,71,5,8,11,10,0,105,40,2,9,8,6,1,66
2020-04-08,강원,대구,132,3,4,12,9,3,163,207,4,21,23,16,5,276
2020-04-08,강원,대전,136,2,7,5,0,8,158,138,3,10,7,4,5,167
2020-04-08,강원,부산,1,0,0,0,2,0,3,3,0,0,2,2,0,7
2020-04-08,강원,서울,864,25,117,22,32,36,1096,799,21,113,16,18,35,1002
2020-04-08,강원,세종,2,0,0,0,0,0,2,5,2,0,0,0,0,7
2020-04-08,강원,울산,0,0,0,0,0,0,0,0,0,0,1,1,0,2
2020-04-08,강원,전남,26,1,3,3,9,3,45,43,3,7,8,18,1,80
2020-04-08,강원,전북,93,5,8,7,17,2,132,103,8,11,23,18,0,163
2020-04-08,강원,충남,247,6,11,21,36,5,326,331,9,13,40,73,3,469
2020-04-08,강원,충북,4337,234,295,267,445,244,5822,4386,235,265,253,431,248,5818
2020-04-08,경기,강원,19068,648,884,703,932,912,23147,18187,643,921,684,787,908,22130
2020-04-08,경기,경기,437804,23198,23908,19066,25084,31545,560605,437804,23198,23908,19066,25084,31545,560605
2020-04-08,경기,경남,2216,86,281,790,580,70,4023,1526,71,209,569,433,47,2855
2020-04-08,경기,경북,3207,177,438,773,547,112,5254,3085,185,402,902,590,104,5268
2020-04-08,경기,광주,612,27,115,326,160,14,1254,518,17,92,232,114,20,993
2020-04-08,경기,대구,1361,89,152,394,200,33,2229,1899,120,175,463,472,59,3188
2020-04-08,경기,대전,1706,92,140,119,70,86,2213,1682,100,139,95,55,71,2142
2020-04-08,경기,부산,174,22,49,202,159,2,608,197,17,30,142,288,10,684
2020-04-08,경기,서울,146307,7294,8209,5324,4260,9521,180915,147072,6958,8516,4901,3899,9557,180903
2020-04-08,경기,세종,33,0,5,1,1,0,40,36,2,2,3,1,5,49
2020-04-08,경기,울산,40,1,8,17,16,0,82,27,1,4,34,62,0,128
2020-04-08,경기,전남,619,21,61,144,151,27,1023,668,17,60,150,110,20,1025
2020-04-08,경기,전북,1133,54,107,127,179,39,1639,1158,51,127,155,185,32,1708
2020-04-08,경기,충남,36641,1549,2602,2456,4444,1870,49562,36178,1473,2401,2354,4187,1815,48408
2020-04-08,경기,충북,26429,2303,2841,3264,3763,1234,39834,25992,2204,2695,2863,4040,1211,39005
2020-04-08,경남,강원,59,1,4,17,16,0,97,101,2,6,20,29,3,161
2020-04-08,경남,경기,1526,71,209,569,433,47,2855,2216,86,281,790,580,70,4023
2020-04-08,경남,경남,185740,9869,9405,7057,13030,14136,239237,185740,9869,9405,7057,13030,14136,239237
2020-04-08,경남,경북,8075,577,854,937,1859,333,12635,9966,848,1072,1209,2766,454,16315
2020-04-08,경남,광주,852,58,112,202,133,22,1379,874,59,150,158,111,23,1375
2020-04-08,경남,대구,10078,701,747,999,1678,386,14589,7806,486,533,418,459,353,10055
2020-04-08,경남,대전,539,17,67,83,29,19,754,760,24,80,111,60,22,1057
2020-04-08,경남,부산,84367,2601,2555,1941,4757,5851,102072,82889,2738,2646,1979,4878,5823,100953
2020-04-08,경남,서울,1556,41,262,303,168,50,2380,2200,47,272,197,106,70,2892
2020-04-08,경남,세종,123,0,6,8,10,6,153,202,5,6,16,15,8,252
2020-04-08,경남,울산,9001,644,601,461,645,577,11929,8642,604,683,449,637,559,11574
2020-04-08,경남,전남,5204,274,394,490,1302,235,7899,5367,305,390,412,1284,227,7985
2020-04-08,경남,전북,918,45,114,134,204,28,1443,893,44,103,136,189,28,1393
2020-04-08,경남,충남,955,66,125,277,230,30,1683,1310,62,155,354,571,30,2482
2020-04-08,경남,충북,844,59,115,275,275,27,1595,1067,65,211,510,669,31,2553
2020-04-08,경북,강원,299,15,13,38,28,6,399,293,23,20,21,24,11,392
2020-04-08,경북,경기,3085,185,402,902,590,104,5268,3207,177,438,773,547,112,5254
2020-04-08,경북,경남,9966,848,1072,1209,2766,454,16315,8075,577,854,937,1859,333,12635
2020-04-08,경북,경북,68895,4033,3777,3241,5745,3694,89385,68895,4033,3777,3241,5745,3694,89385
2020-04-08,경북,광주,613,58,108,223,160,11,1173,571,52,106,173,100,7,1009
2020-04-08,경북,대구,68453,2940,2335,1496,3151,3639,82014,71163,3157,2691,1845,3771,3686,86313
2020-04-08,경북,대전,1349,68,77,126,81,52,1753,1366,52,85,136,63,69,1771
2020-04-08,경북,부산,3619,132,191,205,673,155,4975,3806,124,222,194,808,169,5323
2020-04-08,경북,서울,2366,95,220,397,156,70,3304,2331,64,214,242,111,71,3033
2020-04-08,경북,세종,230,7,14,23,12,7,293,213,12,13,20,15,8,281
2020-04-08,경북,울산,4722,202,284,371,962,264,6805,4678,165,271,344,1160,278,6896
2020-04-08,경북,전남,813,43,68,124,347,26,1421,828,62,71,118,604,25,1708
2020-04-08,경북,전북,1683,90,184,185,357,61,2560,1421,108,153,160,324,31,2197
2020-04-08,경북,충남,2467,143,370,572,660,79,4291,2714,137,373,526,789,110,4649
2020-04-08,경북,충북,4226,297,500,748,1019,165,6955,4224,285,532,691,1122,180,7034
2020-04-08,광주,강원,40,2,9,8,6,1,66,71,5,8,11,10,0,105
2020-04-08,광주,경기,518,17,92,232,114,20,993,612,27,115,326,160,14,1254
2020-04-08,광주,경남,874,59,150,158,111,23,1375,852,58,112,202,133,22,1379
2020-04-08,광주,경북,571,52,106,173,100,7,1009,613,58,108,223,160,11,1173
2020-04-08,광주,광주,13915,504,572,657,444,547,16639,13915,504,572,657,444,547,16639
2020-04-08,광주,대구,411,27,64,97,26,8,633,401,34,73,89,30,9,636
2020-04-08,광주,대전,356,18,7,22,16,5,424,373,28,12,26,15,11,465
2020-04-08,광주,부산,337,14,27,47,71,11,507,340,22,51,77,108,11,609
2020-04-08,광주,서울,486,12,22,64,17,20,621,650,24,17,47,22,13,773
2020-04-08,광주,세종,110,4,10,10,5,4,143,107,1,7,5,0,2,122
2020-04-08,광주,울산,39,1,8,3,5,0,56,41,1,6,7,12,1,68
2020-04-08,광주,전남,32794,1070,1118,798,1960,1303,39043,31941,1057,965,630,1906,1323,37822
2020-04-08,광주,전북,7323,442,503,374,508,280,9430,7341,469,439,347,493,272,9361
2020-04-08,광주,충남,3541,118,378,481,252,91,4861,3603,150,397,614,376,84,5224
2020-04-08,광주,충북,464,31,56,101,68,5,725,503,39,88,202,111,10,953
2020-04-08,대구,강원,207,4,21,23,16,5,276,132,3,4,12,9,3,163
2020-04-08,대구,경기,1899,120,175,463,472,59,3188,1361,89,152,394,200,33,2229
2020-04-08,대구,경남,7806,486,533,418,459,353,10055,10078,701,747,999,1678,386,14589
2020-04-08,대구,경북,71163,3157,2691,1845,3771,3686,86313,68453,2940,2335,1496,3151,3639,82014
2020-04-08,대구,광주,401,34,73,89,30,9,636,411,27,64,97,26,8,633
2020-04-08,대구,대구,56787,2090,1610,877,1151,3780,66295,56787,2090,1610,877,1151,3780,66295
2020-04-08,대구,대전,638,42,27,82,37,20,846,411,21,19,47,23,12,533
2020-04-08,대구,부산,476,46,97,69,127,14,829,2084,103,152,86,249,108,2782
2020-04-08,대구,서울,1839,78,99,256,107,45,2424,1162,36,69,142,51,36,1496
2020-04-08,대구,세종,183,1,12,11,11,4,222,113,1,3,10,4,4,135
2020-04-08,대구,울산,922,61,61,73,134,43,1294,918,58,63,67,170,41,1317
2020-04-08,대구,전남,343,20,38,27,39,9,476,355,15,31,28,58,11,498
2020-04-08,대구,전북,261,9,18,16,20,10,334,262,14,23,20,18,8,345
2020-04-08,대구,충남,1086,63,124,204,263,33,1773,710,68,106,174,172,19,1249
2020-04-08,대구,충북,1212,87,154,263,436,36,2188,859,91,122,219,146,22,1459
2020-04-08,대전,강원,138,3,10,7,4,5,167,136,2,7,5,0,8,158
2020-04-08,대전,경기,1682,100,139,95,55,71,2142,1706,92,140,119,70,86,2213
2020-04-08,대전,경남,760,24,80,111,60,22,1057,539,17,67,83,29,19,754
2020-04-08,대전,경북,1366,52,85,136,63,69,1771,1349,68,77,126,81,52,1753
2020-04-08,대전,광주,373,28,12,26,15,11,465,356,18,7,22,16,5,424
2020-04-08,대전,대구,411,21,19,47,23,12,533,638,42,27,82,37,20,846
2020-04-08,대전,대전,14038,453,410,381,243,1066,16591,14038,453,410,381,243,1066,16591
2020-04-08,대전,부산,54,2,6,15,14,0,91,54,2,7,17,23,1,104
2020-04-08,대전,서울,1519,43,113,38,10,66,1789,1663,34,104,41,13,67,1922
2020-04-08,대전,세종,3376,89,72,41,111,279,3968,3504,92,77,35,85,265,4058
2020-04-08,대전,울산,66,2,4,18,28,3,121,59,8,7,10,33,4,121
2020-04-08,대전,전남,254,7,5,30,32,4,332,253,5,9,24,25,8,324
2020-04-08,대전,전북,2727,75,80,90,47,138,3157,2755,94,85,69,44,118,3165
2020-04-08,대전,충남,16186,494,516,248,230,1228,18902,14660,462,480,251,247,1105,17205
2020-04-08,대전,충북,10727,474,423,230,240,783,12877,9805,430,353,192,219,737,11736
2020-04-08,부산,강원,3,0,0,2,2,0,7,1,0,0,0,2,0,3
2020-04-08,부산,경기,197,17,30,142,288,10,684,174,22,49,202,159,2,608
2020-04-08,부산,경남,82889,2738,2646,1979,4878,5823,100953,84367,2601,2555,1941,4757,5851,102072
2020-04-08,부산,경북,3806,124,222,194,808,169,5323,3619,132,191,205,673,155,4975
2020-04-08,부산,광주,340,22,51,77,108,11,609,337,14,27,47,71,11,507
2020-04-08,부산,대구,2084,103,152,86,249,108,2782,476,46,97,69,127,14,829
2020-04-08,부산,대전,54,2,7,17,23,1,104,54,2,6,15,14,0,91
2020-04-08,부산,부산,42716,699,594,820,2122,3176,50127,42716,699,594,820,2122,3176,50127
2020-04-08,부산,서울,160,14,18,90,78,2,362,178,7,22,64,22,3,296
2020-04-08,부산,세종,13,0,1,3,0,0,17,11,0,1,1,1,0,14
2020-04-08,부산,울산,15167,371,436,615,2291,1103,19983,15217,376,383,427,2222,1129,19754
2020-04-08,부산,전남,1632,82,96,165,458,57,2490,1594,61,97,133,499,57,2441
2020-04-08,부산,전북,241,8,31,35,120,7,442,230,7,17,42,62,8,366
2020-04-08,부산,충남,129,9,37,66,154,4,399,122,10,35,77,157,3,404
2020-04-08,부산,충북,83,8,24,94,222,2,433,88,16,37,110,198,2,451
2020-04-08,서울,강원,799,21,113,16,18,35,1002,864,25,117,22,32,36,1096
2020-04-08,서울,경기,147072,6958,8516,4901,3899,9557,180903,146307,7294,8209,5324,4260,9521,180915
2020-04-08,서울,경남,2200,47,272,197,106,70,2892,1556,41,262,303,168,50,2380
2020-04-08,서울,경북,2331,64,214,242,111,71,3033,2366,95,220,397,156,70,3304
2020-04-08,서울,광주,650,24,17,47,22,13,773,486,12,22,64,17,20,621
2020-04-08,서울,대구,1162,36,69,142,51,36,1496,1839,78,99,256,107,45,2424
2020-04-08,서울,대전,1663,34,104,41,13,67,1922,1519,43,113,38,10,66,1789
2020-04-08,서울,부산,178,7,22,64,22,3,296,160,14,18,90,78,2,362
2020-04-08,서울,서울,221,8,10,7,0,12,258,221,8,10,7,0,12,258
2020-04-08,서울,세종,32,1,0,0,0,1,34,35,0,0,0,0,0,35
2020-04-08,서울,울산,31,1,1,0,3,1,37,19,0,1,7,14,1,42
2020-04-08,서울,전남,741,18,22,37,22,22,862,700,10,12,81,35,16,854
2020-04-08,서울,전북,1113,22,45,30,17,38,1265,1043,21,30,36,33,30,1193
2020-04-08,서울,충남,24349,492,1670,844,761,927,29043,24577,619,1591,1358,1260,920,30325
2020-04-08,서울,충북,13658,576,901,852,846,543,17376,13206,662,876,881,1014,484,17123
2020-04-08,세종,강원,5,2,0,0,0,0,7,2,0,0,0,0,0,2
2020-04-08,세종,경기,36,2,2,3,1,5,49,33,0,5,1,1,0,40
2020-04-08,세종,경남,202,5,6,16,15,8,252,123,0,6,8,10,6,153
2020-04-08,세종,경북,213,12,13,20,15,8,281,230,7,14,23,12,7,293
2020-04-08,세종,광주,107,1,7,5,0,2,122,110,4,10,10,5,4,143
2020-04-08,세종,대구,113,1,3,10,4,4,135,183,1,12,11,11,4,222
2020-04-08,세종,대전,3504,92,77,35,85,265,4058,3376,89,72,41,111,279,3968
2020-04-08,세종,부산,11,0,1,1,1,0,14,13,0,1,3,0,0,17
2020-04-08,세종,서울,35,0,0,0,0,0,35,32,1,0,0,0,1,34
2020-04-08,세종,세종,243,28,3,1,2,24,301,243,28,3,1,2,24,301
2020-04-08,세종,울산,6,0,0,1,4,0,11,5,2,0,0,6,1,14
2020-04-08,세종,전남,121,2,3,4,17,3,150,105,4,2,5,11,1,128
2020-04-08,세종,전북,568,16,25,10,37,20,676,531,9,19,10,53,21,643
2020-04-08,세종,충남,5875,146,170,124,209,331,6855,4463,143,148,119,179,211,5263
2020-04-08,세종,충북,367,13,22,13,12,34,461,298,20,13,16,22,26,395
2020-04-08,울산,강원,0,0,0,1,1,0,2,0,0,0,0,0,0,0
2020-04-08,울산,경기,27,1,4,34,62,0,128,40,1,8,17,16,0,82
2020-04-08,울산,경남,8642,604,683,449,637,559,11574,9001,644,601,461,645,577,11929
2020-04-08,울산,경북,4678,165,271,344,1160,278,6896,4722,202,284,371,962,264,6805
2020-04-08,울산,광주,41,1,6,7,12,1,68,39,1,8,3,5,0,56
2020-04-08,울산,대구,918,58,63,67,170,41,1317,922,61,61,73,134,43,1294
2020-04-08,울산,대전,59,8,7,10,33,4,121,66,2,4,18,28,3,121
2020-04-08,울산,부산,15217,376,383,427,2222,1129,19754,15167,371,436,615,2291,1103,19983
2020-04-08,울산,서울,19,0,1,7,14,1,42,31,1,1,0,3,1,37
2020-04-08,울산,세종,5,2,0,0,6,1,14,6,0,0,1,4,0,11
2020-04-08,울산,울산,7912,312,473,260,626,664,10247,7912,312,473,260,626,664,10247
2020-04-08,울산,전남,159,12,22,16,19,5,233,159,15,23,18,58,2,275
2020-04-08,울산,전북,31,0,7,5,13,0,56,27,0,5,5,8,1,46
2020-04-08,울산,충남,118,4,16,39,139,3,319,102,7,9,32,100,3,253
2020-04-08,울산,충북,16,4,2,17,48,0,87,23,2,1,15,34,0,75
2020-04-08,전남,강원,43,3,7,8,18,1,80,26,1,3,3,9,3,45
2020-04-08,전남,경기,668,17,60,150,110,20,1025,619,21,61,144,151,27,1023
2020-04-08,전남,경남,5367,305,390,412,1284,227,7985,5204,274,394,490,1302,235,7899
2020-04-08,전남,경북,828,62,71,118,604,25,1708,813,43,68,124,347,26,1421
2020-04-08,전남,광주,31941,1057,965,630,1906,1323,37822,32794,1070,1118,798,1960,1303,39043
2020-04-08,전남,대구,355,15,31,28,58,11,498,343,20,38,27,39,9,476
2020-04-08,전남,대전,253,5,9,24,25,8,324,254,7,5,30,32,4,332
2020-04-08,전남,부산,1594,61,97,133,499,57,2441,1632,82,96,165,458,57,2490
2020-04-08,전남,서울,700,10,12,81,35,16,854,741,18,22,37,22,22,862
2020-04-08,전남,세종,105,4,2,5,11,1,128,121,2,3,4,17,3,150
2020-04-08,전남,울산,159,15,23,18,58,2,275,159,12,22,16,19,5,233
2020-04-08,전남,전남,43011,1502,1509,1746,5308,1702,54778,43011,1502,1509,1746,5308,1702,54778
2020-04-08,전남,전북,4562,282,508,578,1397,103,7430,4481,243,503,623,1451,110,7411
2020-04-08,전남,충남,3751,111,319,676,1116,93,6066,3668,94,358,550,903,92,5665
2020-04-08,전남,충북,263,16,33,99,241,11,663,295,17,34,109,266,9,730
2020-04-08,전북,강원,103,8,11,23,18,0,163,93,5,8,7,17,2,132
2020-04-08,전북,경기,1158,51,127,155,185,32,1708,1133,54,107,127,179,39,1639
2020-04-08,전북,경남,893,44,103,136,189,28,1393,918,45,114,134,204,28,1443
2020-04-08,전북,경북,1421,108,153,160,324,31,2197,1683,90,184,185,357,61,2560
2020-04-08,전북,광주,7341,469,439,347,493,272,9361,7323,442,503,374,508,280,9430
2020-04-08,전북,대구,262,14,23,20,18,8,345,261,9,18,16,20,10,334
2020-04-08,전북,대전,2755,94,85,69,44,118,3165,2727,75,80,90,47,138,3157
2020-04-08,전북,부산,230,7,17,42,62,8,366,241,8,31,35,120,7,442
2020-04-08,전북,서울,1043,21,30,36,33,30,1193,1113,22,45,30,17,38,1265
2020-04-08,전북,세종,531,9,19,10,53,21,643,568,16,25,10,37,20,676
2020-04-08,전북,울산,27,0,5,5,8,1,46,31,0,7,5,13,0,56
2020-04-08,전북,전남,4481,243,503,623,1451,110,7411,4562,282,508,578,1397,103,7430
2020-04-08,전북,전북,16630,789,847,603,981,636,20486,16630,789,847,603,981,636,20486
2020-04-08,전북,충남,12174,543,1306,1130,1449,408,17010,12032,519,1290,965,1445,383,16634
2020-04-08,전북,충북,1575,144,202,280,269,57,2527,1590,121,244,287,305,67,2614
2020-04-08,충남,강원,331,9,13,40,73,3,469,247,6,11,21,36,5,326
2020-04-08,충남,경기,36178,1473,2401,2354,4187,1815,48408,36641,1549,2602,2456,4444,1870,49562
2020-04-08,충남,경남,1310,62,155,354,571,30,2482,955,66,125,277,230,30,1683
2020-04-08,충남,경북,2714,137,373,526,789,110,4649,2467,143,370,572,660,79,4291
2020-04-08,충남,광주,3603,150,397,614,376,84,5224,3541,118,378,481,252,91,4861
2020-04-08,충남,대구,710,68,106,174,172,19,1249,1086,63,124,204,263,33,1773
2020-04-08,충남,대전,14660,462,480,251,247,1105,17205,16186,494,516,248,230,1228,18902
2020-04-08,충남,부산,122,10,35,77,157,3,404,129,9,37,66,154,4,399
2020-04-08,충남,서울,24577,619,1591,1358,1260,920,30325,24349,492,1670,844,761,927,29043
2020-04-08,충남,세종,4463,143,148,119,179,211,5263,5875,146,170,124,209,331,6855
2020-04-08,충남,울산,102,7,9,32,100,3,253,118,4,16,39,139,3,319
2020-04-08,충남,전남,3668,94,358,550,903,92,5665,3751,111,319,676,1116,93,6066
2020-04-08,충남,전북,12032,519,1290,965,1445,383,16634,12174,543,1306,1130,1449,408,17010
2020-04-08,충남,충남,92530,3780,6833,7252,10204,4369,124968,92530,3780,6833,7252,10204,4369,124968
2020-04-08,충남,충북,13511,694,849,1056,1520,772,18402,12233,647,838,908,1489,681,16796
2020-04-08,충북,강원,4386,235,265,253,431,248,5818,4337,234,295,267,445,244,5822
2020-04-08,충북,경기,25992,2204,2695,2863,4040,1211,39005,26429,2303,2841,3264,3763,1234,39834
2020-04-08,충북,경남,1067,65,211,510,669,31,2553,844,59,115,275,275,27,1595
2020-04-08,충북,경북,4224,285,532,691,1122,180,7034,4226,297,500,748,1019,165,6955
2020-04-08,충북,광주,503,39,88,202,111,10,953,464,31,56,101,68,5,725
2020-04-08,충북,대구,859,91,122,219,146,22,1459,1212,87,154,263,436,36,2188
2020-04-08,충북,대전,9805,430,353,192,219,737,11736,10727,474,423,230,240,783,12877
2020-04-08,충북,부산,88,16,37,110,198,2,451,83,8,24,94,222,2,433
2020-04-08,충북,서울,13206,662,876,881,1014,484,17123,13658,576,901,852,846,543,17376
2020-04-08,충북,세종,298,20,13,16,22,26,395,367,13,22,13,12,34,461
2020-04-08,충북,울산,23,2,1,15,34,0,75,16,4,2,17,48,0,87
2020-04-08,충북,전남,295,17,34,109,266,9,730,263,16,33,99,241,11,663
2020-04-08,충북,전북,1590,121,244,287,305,67,2614,1575,144,202,280,269,57,2527
2020-04-08,충북,충남,12233,647,838,908,1489,681,16796,13511,694,849,1056,1520,772,18402
2020-04-08,충북,충북,37658,2081,2357,2517,3714,2048,50375,37658,2081,2357,2517,3714,2048,50375
2020-04-09,강원,강원,61821,2540,2568,1574,3319,4014,75836,61821,2540,2568,1574,3319,4014,75836
2020-04-09,강원,경기,18988,638,909,622,781,857,22795,20176,678,831,697,979,860,24221
2020-04-09,강원,경남,114,1,9,16,35,2,177,81,1,3,21,14,2,122
2020-04-09,강원,경북,333,17,23,18,16,12,419,311,17,19,32,20,9,408
2020-04-09,강원,광주,63,5,10,9,9,2,98,65,4,7,14,8,2,100
2020-04-09,강원,대구,137,2,8,10,11,2,170,170,8,12,29,22,7,248
2020-04-09,강원,대전,138,5,5,3,1,4,156,129,7,7,9,1,5,158
2020-04-09,강원,부산,3,0,0,2,2,0,7,2,0,1,0,3,1,7
2020-04-09,강원,서울,835,17,126,14,38,27,1057,895,20,119,19,22,26,1101
2020-04-09,강원,세종,2,0,1,1,0,0,4,6,0,0,1,1,0,8
2020-04-09,강원,울산,0,0,0,0,0,0,0,0,0,1,0,1,0,2
2020-04-09,강원,전남,51,1,3,4,14,2,75,46,3,3,9,9,2,72
2020-04-09,강원,전북,104,3,18,7,18,2,152,102,6,16,23,26,2,175
2020-04-09,강원,충남,258,5,14,31,42,13,363,357,10,29,36,65,10,507
2020-04-09,강원,충북,4325,258,278,287,443,263,5854,4367,223,238,263,412,263,5766
2020-04-09,경기,강원,20176,678,831,697,979,860,24221,18988,638,909,622,781,857,22795
2020-04-09,경기,경기,438044,23168,24061,20019,24967,31436,561695,438044,23168,24061,20019,24967,31436,561695
2020-04-09,경기,경남,2449,112,270,738,572,73,4214,1796,56,220,569,462,50,3153
2020-04-09,경기,경북,3429,235,404,735,613,86,5502,3455,212,396,868,599,99,5629
2020-04-09,경기,광주,739,37,123,318,159,19,1395,559,29,82,258,104,16,1048
2020-04-09,경기,대구,1460,110,164,390,249,41,2414,2011,107,168,438,453,63,3240
2020-04-09,경기,대전,1787,93,123,129,50,91,2273,1778,102,134,97,32,75,2218
2020-04-09,경기,부산,214,29,50,195,133,3,624,206,27,41,172,264,5,715
2020-04-09,경기,서울,144485,7298,8293,5020,4270,9269,178635,147954,7026,8462,4631,3705,9548,181326
2020-04-09,경기,세종,42,2,4,2,6,3,59,50,4,6,3,7,2,72
2020-04-09,경기,울산,16,4,3,16,20,2,61,40,2,7,33,74,1,157
2020-04-09,경기,전남,722,17,81,149,162,22,1153,662,26,55,145,132,21,1041
2020-04-09,경기,전북,1170,52,123,154,180,48,1727,1205,48,117,171,196,37,1774
2020-04-09,경기,충남,37669,1603,2536,2443,4578,1932,50761,38348,1592,2382,2361,4294,1911,50888
2020-04-09,경기,충북,27093,2249,2790,3311,3784,1236,40463,26777,2138,2672,2793,3950,1189,39519
2020-04-09,경남,강원,81,1,3,21,14,2,122,114,1,9,16,35,2,177
2020-04-09,경남,경기,1796,56,220,569,462,50,3153,2449,112,270,738,572,73,4214
2020-04-09,경남,경남,187452,10092,9435,7237,12773,13896,240885,187452,10092,9435,7237,12773,13896,240885
2020-04-09,경남,경북,8522,580,905,888,1827,338,13060,10454,856,1115,1228,2682,447,16782
2020-04-09,경남,광주,943,45,102,194,138,25,1447,947,41,132,178,120,27,1445
2020-04-09,경남,대구,10326,750,783,940,1743,423,14965,7967,508,547,419,506,327,10274
2020-04-09,경남,대전,583,19,78,88,43,24,835,819,30,87,114,62,26,1138
2020-04-09,경남,부산,84603,2596,2533,1907,4537,5971,102147,83347,2667,2678,1913,4680,5786,101071
2020-04-09,경남,서울,1690,40,270,289,162,43,2494,2326,51,276,186,123,67,3029
2020-04-09,경남,세종,154,2,10,12,6,5,189,208,1,15,13,12,3,252
2020-04-09,경남,울산,8956,595,653,485,627,591,11907,8477,525,669,441,650,561,11323
2020-04-09,경남,전남,5423,276,378,485,1313,218,8093,5571,300,453,440,1299,239,8302
2020-04-09,경남,전북,955,46,103,93,194,32,1423,977,43,105,118,187,25,1455
2020-04-09,경남,충남,1022,58,114,270,266,25,1755,1511,71,120,393,498,29,2622
2020-04-09,경남,충북,951,50,145,286,282,26,1740,1216,76,205,475,600,40,2612
2020-04-09,경북,강원,311,17,19,32,20,9,408,333,17,23,18,16,12,419
2020-04-09,경북,경기,3455,212,396,868,599,99,5629,3429,235,404,735,613,86,5502
2020-04-09,경북,경남,10454,856,1115,1228,2682,447,16782,8522,580,905,888,1827,338,13060
2020-04-09,경북,경북,69452,4099,3856,3084,6280,3744,90515,69452,4099,3856,3084,6280,3744,90515
2020-04-09,경북,광주,673,58,109,228,144,12,1224,603,54,93,203,103,16,1072
2020-04-09,경북,대구,68749,2889,2322,1612,3176,3624,82372,73743,3099,2698,2005,3917,3822,89284
2020-04-09,경북,대전,1469,69,92,126,73,50,1879,1432,63,85,121,55,55,1811
2020-04-09,경북,부산,3597,134,185,214,635,151,4916,3855,114,207,220,756,178,5330
2020-04-09,경북,서울,2471,107,240,428,139,65,3450,2512,90,224,249,119,64,3258
2020-04-09,경북,세종,233,6,13,25,14,8,299,231,7,13,19,13,5,288
2020-04-09,경북,울산,4703,179,282,414,972,257,6807,4670,162,255,336,1258,252,6933
2020-04-09,경북,전남,831,42,75,120,414,18,1500,846,47,79,87,570,21,1650
2020-04-09,경북,전북,1728,105,187,180,298,56,2554,1500,115,189,133,250,38,2225
2020-04-09,경북,충남,2637,170,340,588,623,105,4463,2750,154,359,525,767,97,4652
2020-04-09,경북,충북,4518,269,520,762,985,166,7220,4224,264,498,711,1065,161,6923
2020-04-09,광주,강원,65,4,7,14,8,2,100,63,5,10,9,9,2,98
2020-04-09,광주,경기,559,29,82,258,104,16,1048,739,37,123,318,159,19,1395
2020-04-09,광주,경남,947,41,132,178,120,27,1445,943,45,102,194,138,25,1447
2020-04-09,광주,경북,603,54,93,203,103,16,1072,673,58,109,228,144,12,1224
2020-04-09,광주,광주,13934,531,571,424,586,580,16626,13934,531,571,424,586,580,16626
2020-04-09,광주,대구,420,25,65,86,34,10,640,437,25,66,82,26,10,646
2020-04-09,광주,대전,404,24,15,19,13,8,483,413,18,18,34,14,9,506
2020-04-09,광주,부산,352,15,38,36,79,11,531,316,23,49,65,103,10,566
2020-04-09,광주,서울,600,21,18,63,20,15,737,683,23,19,50,21,17,813
2020-04-09,광주,세종,105,1,10,5,10,5,136,158,4,6,3,6,4,181
2020-04-09,광주,울산,46,5,4,1,5,0,61,49,2,7,9,9,1,77
2020-04-09,광주,전남,33168,1023,1138,728,2011,1295,39363,31565,1017,982,656,1955,1226,37401
2020-04-09,광주,전북,7484,441,504,375,436,256,9496,7384,453,436,326,468,253,9320
2020-04-09,광주,충남,3720,107,382,470,284,97,5060,3914,118,404,584,364,94,5478
2020-04-09,광주,충북,477,19,53,116,82,12,759,551,36,79,187,114,13,980
2020-04-09,대구,강원,170,8,12,29,22,7,248,137,2,8,10,11,2,170
2020-04-09,대구,경기,2011,107,168,438,453,63,3240,1460,110,164,390,249,41,2414
2020-04-09,대구,경남,7967,508,547,419,506,327,10274,10326,750,783,940,1743,423,14965
2020-04-09,대구,경북,73743,3099,2698,2005,3917,3822,89284,68749,2889,2322,1612,3176,3624,82372
2020-04-09,대구,광주,437,25,66,82,26,10,646,420,25,65,86,34,10,640
2020-04-09,대구,대구,56439,2099,1577,814,1160,3818,65907,56439,2099,1577,814,1160,3818,65907
2020-04-09,대구,대전,703,34,31,79,35,21,903,447,24,28,47,17,12,575
2020-04-09,대구,부산,441,48,108,70,190,14,871,2238,89,162,104,292,96,2981
2020-04-09,대구,서울,1967,68,83,237,126,49,2530,1261,50,73,128,42,32,1586
2020-04-09,대구,세종,209,4,5,10,9,4,241,121,3,2,5,2,2,135
2020-04-09,대구,울산,908,56,69,81,160,35,1309,930,52,62,66,168,34,1312
2020-04-09,대구,전남,363,17,35,33,38,10,496,413,21,39,36,53,14,576
2020-04-09,대구,전북,283,16,30,15,19,2,365,284,13,17,22,16,6,358
2020-04-09,대구,충남,1127,72,129,220,207,29,1784,828,56,100,188,188,24,1384
2020-04-09,대구,충북,1223,98,155,271,397,42,2186,950,78,133,238,171,25,1595
2020-04-09,대전,강원,129,7,7,9,1,5,158,138,5,5,3,1,4,156
2020-04-09,대전,경기,1778,102,134,97,32,75,2218,1787,93,123,129,50,91,2273
2020-04-09,대전,경남,819,30,87,114,62,26,1138,583,19,78,88,43,24,835
2020-04-09,대전,경북,1432,63,85,121,55,55,1811,1469,69,92,126,73,50,1879
2020-04-09,대전,광주,413,18,18,34,14,9,506,404,24,15,19,13,8,483
2020-04-09,대전,대구,447,24,28,47,17,12,575,703,34,31,79,35,21,903
2020-04-09,대전,대전,14150,409,459,314,258,1062,16652,14150,409,459,314,258,1062,16652
2020-04-09,대전,부산,64,3,5,22,16,3,113,56,4,8,17,19,1,105
2020-04-09,대전,서울,1546,48,127,41,14,57,1833,1643,38,112,42,12,56,1903
2020-04-09,대전,세종,3445,93,68,40,55,255,3956,3439,96,55,37,60,273,3960
2020-04-09,대전,울산,98,0,4,15,33,3,153,103,3,9,15,36,1,167
2020-04-09,대전,전남,257,7,8,26,25,9,332,270,5,8,19,13,7,322
2020-04-09,대전,전북,2842,80,81,87,43,121,3254,2794,89,82,72,50,120,3207
2020-04-09,대전,충남,16335,488,493,299,312,1235,19162,14851,447,489,248,293,1095,17423
2020-04-09,대전,충북,10857,507,419,208,195,780,12966,9905,393,372,174,187,746,11777
2020-04-09,부산,강원,2,0,1,0,3,1,7,3,0,0,2,2,0,7
2020-04-09,부산,경기,206,27,41,172,264,5,715,214,29,50,195,133,3,624
2020-04-09,부산,경남,83347,2667,2678,1913,4680,5786,101071,84603,2596,2533,1907,4537,5971,102147
2020-04-09,부산,경북,3855,114,207,220,756,178,5330,3597,134,185,214,635,151,4916
2020-04-09,부산,광주,316,23,49,65,103,10,566,352,15,38,36,79,11,531
2020-04-09,부산,대구,2238,89,162,104,292,96,2981,441,48,108,70,190,14,871
2020-04-09,부산,대전,56,4,8,17,19,1,105,64,3,5,22,16,3,113
2020-04-09,부산,부산,43245,681,589,574,2004,3058,50151,43245,681,589,574,2004,3058,50151
2020-04-09,부산,서울,180,7,18,81,67,3,356,161,11,17,63,43,0,295
2020-04-09,부산,세종,18,0,1,3,3,0,25,16,3,1,1,4,1,26
2020-04-09,부산,울산,15013,381,411,640,2287,1073,19805,15144,391,375,431,2182,1079,19602
2020-04-09,부산,전남,1662,78,99,179,510,67,2595,1558,76,96,144,542,67,2483
2020-04-09,부산,전북,230,7,27,37,89,9,399,204,7,20,43,63,8,345
2020-04-09,부산,충남,126,14,20,63,148,4,375,125,18,23,80,193,2,441
2020-04-09,부산,충북,93,11,17,76,202,1,400,85,21,20,120,220,3,469
2020-04-09,서울,강원,895,20,119,19,22,26,1101,835,17,126,14,38,27,1057
2020-04-09,서울,경기,147954,7026,8462,4631,3705,9548,181326,144485,7298,8293,5020,4270,9269,178635
2020-04-09,서울,경남,2326,51,276,186,123,67,3029,1690,40,270,289,162,43,2494
2020-04-09,서울,경북,2512,90,224,249,119,64,3258,2471,107,240,428,139,65,3450
2020-04-09,서울,광주,683,23,19,50,21,17,813,600,21,18,63,20,15,737
2020-04-09,서울,대구,1261,50,73,128,42,32,1586,1967,68,83,237,126,49,2530
2020-04-09,서울,대전,1643,38,112,42,12,56,1903,1546,48,127,41,14,57,1833
2020-04-09,서울,부산,161,11,17,63,43,0,295,180,7,18,81,67,3,356
2020-04-09,서울,서울,198,6,6,2,1,18,231,198,6,6,2,1,18,231
2020-04-09,서울,세종,35,0,0,1,2,0,38,39,1,1,2,2,2,47
2020-04-09,서울,울산,26,0,1,1,2,2,32,22,0,8,14,15,0,59
2020-04-09,서울,전남,788,13,21,29,19,27,897,720,10,24,70,35,23,882
2020-04-09,서울,전북,1185,18,44,34,26,39,1346,1116,18,37,46,25,40,1282
2020-04-09,서울,충남,25600,535,1622,868,764,992,30381,24570,666,1572,1326,1266,932,30332
2020-04-09,서울,충북,13633,562,889,870,822,545,17321,13502,662,892,859,979,535,17429
2020-04-09,세종,강원,6,0,0,1,1,0,8,2,0,1,1,0,0,4
2020-04-09,세종,경기,50,4,6,3,7,2,72,42,2,4,2,6,3,59
2020-04-09,세종,경남,208,1,15,13,12,3,252,154,2,10,12,6,5,189
2020-04-09,세종,경북,231,7,13,19,13,5,288,233,6,13,25,14,8,299
2020-04-09,세종,광주,158,4,6,3,6,4,181,105,1,10,5,10,5,136
2020-04-09,세종,대구,121,3,2,5,2,2,135,209,4,5,10,9,4,241
2020-04-09,세종,대전,3439,96,55,37,60,273,3960,3445,93,68,40,55,255,3956
2020-04-09,세종,부산,16,3,1,1,4,1,26,18,0,1,3,3,0,25
2020-04-09,세종,서울,39,1,1,2,2,2,47,35,0,0,1,2,0,38
2020-04-09,세종,세종,250,27,5,1,0,13,296,250,27,5,1,0,13,296
2020-04-09,세종,울산,8,0,0,1,5,0,14,11,0,0,2,8,0,21
2020-04-09,세종,전남,140,4,5,8,16,2,175,115,1,3,10,13,0,142
2020-04-09,세종,전북,611,17,16,13,25,20,702,555,11,19,27,33,22,667
2020-04-09,세종,충남,6003,141,163,132,206,315,6960,4388,136,141,115,167,216,5163
2020-04-09,세종,충북,380,13,28,17,18,24,480,335,17,27,17,25,21,442
2020-04-09,울산,강원,0,0,1,0,1,0,2,0,0,0,0,0,0,0
2020-04-09,울산,경기,40,2,7,33,74,1,157,16,4,3,16,20,2,61
2020-04-09,울산,경남,8477,525,669,441,650,561,11323,8956,595,653,485,627,591,11907
2020-04-09,울산,경북,4670,162,255,336,1258,252,6933,4703,179,282,414,972,257,6807
2020-04-09,울산,광주,49,2,7,9,9,1,77,46,5,4,1,5,0,61
2020-04-09,울산,대구,930,52,62,66,168,34,1312,908,56,69,81,160,35,1309
2020-04-09,울산,대전,103,3,9,15,36,1,167,98,0,4,15,33,3,153
2020-04-09,울산,부산,15144,391,375,431,2182,1079,19602,15013,381,411,640,2287,1073,19805
2020-04-09,울산,서울,22,0,8,14,15,0,59,26,0,1,1,2,2,32
2020-04-09,울산,세종,11,0,0,2,8,0,21,8,0,0,1,5,0,14
2020-04-09,울산,울산,7918,285,438,249,612,686,10188,7918,285,438,249,612,686,10188
2020-04-09,울산,전남,180,13,20,20,23,6,262,164,13,24,11,51,7,270
2020-04-09,울산,전북,38,2,7,1,14,3,65,25,0,5,5,3,2,40
2020-04-09,울산,충남,135,2,17,45,120,2,321,113,6,13,28,99,3,262
2020-04-09,울산,충북,12,3,4,22,24,3,68,28,3,2,17,30,1,81
2020-04-09,전남,강원,46,3,3,9,9,2,72,51,1,3,4,14,2,75
2020-04-09,전남,경기,662,26,55,145,132,21,1041,722,17,81,149,162,22,1153
2020-04-09,전남,경남,5571,300,453,440,1299,239,8302,5423,276,378,485,1313,218,8093
2020-04-09,전남,경북,846,47,79,87,570,21,1650,831,42,75,120,414,18,1500
2020-04-09,전남,광주,31565,1017,982,656,1955,1226,37401,33168,1023,1138,728,2011,1295,39363
2020-04-09,전남,대구,413,21,39,36,53,14,576,363,17,35,33,38,10,496
2020-04-09,전남,대전,270,5,8,19,13,7,322,257,7,8,26,25,9,332
2020-04-09,전남,부산,1558,76,96,144,542,67,2483,1662,78,99,179,510,67,2595
2020-04-09,전남,서울,720,10,24,70,35,23,882,788,13,21,29,19,27,897
2020-04-09,전남,세종,115,1,3,10,13,0,142,140,4,5,8,16,2,175
2020-04-09,전남,울산,164,13,24,11,51,7,270,180,13,20,20,23,6,262
2020-04-09,전남,전남,43589,1420,1552,1792,4884,1689,54926,43589,1420,1552,1792,4884,1689,54926
2020-04-09,전남,전북,4484,318,546,490,1484,128,7450,4358,271,413,606,1414,125,7187
2020-04-09,전남,충남,3955,119,361,741,1215,97,6488,4057,95,386,503,917,107,6065
2020-04-09,전남,충북,315,24,34,89,261,8,731,319,26,55,116,235,8,759
2020-04-09,전북,강원,102,6,16,23,26,2,175,104,3,18,7,18,2,152
2020-04-09,전북,경기,1205,48,117,171,196,37,1774,1170,52,123,154,180,48,1727
2020-04-09,전북,경남,977,43,105,118,187,25,1455,955,46,103,93,194,32,1423
2020-04-09,전북,경북,1500,115,189,133,250,38,2225,1728,105,187,180,298,56,2554
2020-04-09,전북,광주,7384,453,436,326,468,253,9320,7484,441,504,375,436,256,9496
2020-04-09,전북,대구,284,13,17,22,16,6,358,283,16,30,15,19,2,365
2020-04-09,전북,대전,2794,89,82,72,50,120,3207,2842,80,81,87,43,121,3254
2020-04-09,전북,부산,204,7,20,43,63,8,345,230,7,27,37,89,9,399
2020-04-09,전북,서울,1116,18,37,46,25,40,1282,1185,18,44,34,26,39,1346
2020-04-09,전북,세종,555,11,19,27,33,22,667,611,17,16,13,25,20,702
2020-04-09,전북,울산,25,0,5,5,3,2,40,38,2,7,1,14,3,65
2020-04-09,전북,전남,4358,271,413,606,1414,125,7187,4484,318,546,490,1484,128,7450
2020-04-09,전북,전북,16584,764,943,1016,872,617,20796,16584,764,943,1016,872,617,20796
2020-04-09,전북,충남,12658,520,1330,1192,1535,423,17658,12513,494,1267,1027,1544,418,17263
2020-04-09,전북,충북,1610,110,209,285,262,50,2526,1589,116,222,297,276,51,2551
2020-04-09,충남,강원,357,10,29,36,65,10,507,258,5,14,31,42,13,363
2020-04-09,충남,경기,38348,1592,2382,2361,4294,1911,50888,37669,1603,2536,2443,4578,1932,50761
2020-04-09,충남,경남,1511,71,120,393,498,29,2622,1022,58,114,270,266,25,1755
2020-04-09,충남,경북,2750,154,359,525,767,97,4652,2637,170,340,588,623,105,4463
2020-04-09,충남,광주,3914,118,404,584,364,94,5478,3720,107,382,470,284,97,5060
2020-04-09,충남,대구,828,56,100,188,188,24,1384,1127,72,129,220,207,29,1784
2020-04-09,충남,대전,14851,447,489,248,293,1095,17423,16335,488,493,299,312,1235,19162
2020-04-09,충남,부산,125,18,23,80,193,2,441,126,14,20,63,148,4,375
2020-04-09,충남,서울,24570,666,1572,1326,1266,932,30332,25600,535,1622,868,764,992,30381
2020-04-09,충남,세종,4388,136,141,115,167,216,5163,6003,141,163,132,206,315,6960
2020-04-09,충남,울산,113,6,13,28,99,3,262,135,2,17,45,120,2,321
2020-04-09,충남,전남,4057,95,386,503,917,107,6065,3955,119,361,741,1215,97,6488
2020-04-09,충남,전북,12513,494,1267,1027,1544,418,17263,12658,520,1330,1192,1535,423,17658
2020-04-09,충남,충남,94990,3805,6814,7405,10676,4550,128240,94990,3805,6814,7405,10676,4550,128240
2020-04-09,충남,충북,13780,667,851,1043,1517,784,18642,12575,677,829,904,1550,688,17223
2020-04-09,충북,강원,4367,223,238,263,412,263,5766,4325,258,278,287,443,263,5854
2020-04-09,충북,경기,26777,2138,2672,2793,3950,1189,39519,27093,2249,2790,3311,3784,1236,40463
2020-04-09,충북,경남,1216,76,205,475,600,40,2612,951,50,145,286,282,26,1740
2020-04-09,충북,경북,4224,264,498,711,1065,161,6923,4518,269,520,762,985,166,7220
2020-04-09,충북,광주,551,36,79,187,114,13,980,477,19,53,116,82,12,759
2020-04-09,충북,대구,950,78,133,238,171,25,1595,1223,98,155,271,397,42,2186
2020-04-09,충북,대전,9905,393,372,174,187,746,11777,10857,507,419,208,195,780,12966
2020-04-09,충북,부산,85,21,20,120,220,3,469,93,11,17,76,202,1,400
2020-04-09,충북,서울,13502,662,892,859,979,535,17429,13633,562,889,870,822,545,17321
2020-04-09,충북,세종,335,17,27,17,25,21,442,380,13,28,17,18,24,480
2020-04-09,충북,울산,28,3,2,17,30,1,81,12,3,4,22,24,3,68
2020-04-09,충북,전남,319,26,55,116,235,8,759,315,24,34,89,261,8,731
2020-04-09,충북,전북,1589,116,222,297,276,51,2551,1610,110,209,285,262,50,2526
2020-04-09,충북,충남,12575,677,829,904,1550,688,17223,13780,667,851,1043,1517,784,18642
2020-04-09,충북,충북,37342,2106,2312,2302,3666,2139,49867,37342,2106,2312,2302,3666,2139,49867
2020-04-10,강원,강원,75589,2589,2538,1702,3113,4579,90110,75589,2589,2538,1702,3113,4579,90110
2020-04-10,강원,경기,22574,644,919,630,814,1060,26641,31898,681,919,735,1007,1379,36619
2020-04-10,강원,경남,169,5,7,14,23,8,226,127,0,6,20,12,2,167
2020-04-10,강원,경북,456,18,25,24,23,21,567,480,18,16,29,36,21,600
2020-04-10,강원,광주,102,3,7,12,7,5,136,78,2,9,10,5,1,105
2020-04-10,강원,대구,200,4,9,4,7,8,232,294,8,10,28,22,7,369
2020-04-10,강원,대전,176,4,6,12,1,6,205,207,6,4,5,1,7,230
2020-04-10,강원,부산,7,0,1,0,3,1,12,2,1,0,3,9,0,15
2020-04-10,강원,서울,844,16,147,17,42,39,1105,1099,18,146,14,12,45,1334
2020-04-10,강원,세종,2,0,0,0,1,0,3,9,0,1,1,0,0,11
2020-04-10,강원,울산,2,0,0,0,0,1,3,7,0,1,1,1,0,10
2020-04-10,강원,전남,55,1,1,8,12,1,78,58,5,4,6,20,4,97
2020-04-10,강원,전북,134,5,8,7,23,3,180,180,4,12,23,16,3,238
2020-04-10,강원,충남,356,7,19,28,25,14,449,616,12,18,36,67,28,777
2020-04-10,강원,충북,5119,241,238,283,478,308,6667,5580,226,244,240,392,318,7000
2020-04-10,경기,강원,31898,681,919,735,1007,1379,36619,22574,644,919,630,814,1060,26641
2020-04-10,경기,경기,463575,23368,23592,18694,24411,33087,586727,463575,23368,23592,18694,24411,33087,586727
2020-04-10,경기,경남,3859,107,289,759,594,151,5759,2602,73,212,530,444,86,3947
2020-04-10,경기,경북,5039,166,453,730,685,192,7265,4662,179,401,826,602,161,6831
2020-04-10,경기,광주,1326,30,108,302,170,34,1970,835,27,85,254,113,35,1349
2020-04-10,경기,대구,2049,99,166,391,223,66,2994,2809,115,176,425,419,106,4050
2020-04-10,경기,대전,3031,88,140,126,58,148,3591,2307,96,148,107,49,120,2827
2020-04-10,경기,부산,251,17,49,235,165,14,731,288,15,28,151,237,15,734
2020-04-10,경기,서울,158718,7558,8407,5077,4230,10368,194358,149616,6928,8511,4641,3797,9710,183203
2020-04-10,경기,세종,73,2,2,3,1,1,82,49,2,2,5,6,6,70
2020-04-10,경기,울산,31,2,7,12,16,1,69,44,1,3,30,71,3,152
2020-04-10,경기,전남,1323,25,85,170,166,33,1802,952,17,69,143,134,33,1348
2020-04-10,경기,전북,2251,51,136,116,219,90,2863,1489,54,127,170,206,64,2110
2020-04-10,경기,충남,48886,1599,2590,2473,4566,2355,62469,45911,1571,2466,2311,4325,2329,58913
2020-04-10,경기,충북,33737,2247,2829,3328,3680,1645,47466,32067,2185,2717,2954,3965,1490,45378
2020-04-10,경남,강원,127,0,6,20,12,2,167,169,5,7,14,23,8,226
2020-04-10,경남,경기,2602,73,212,530,444,86,3947,3859,107,289,759,594,151,5759
2020-04-10,경남,경남,202664,9757,9101,6973,12943,14687,256125,202664,9757,9101,6973,12943,14687,256125
2020-04-10,경남,경북,10310,588,905,879,1829,486,14997,14000,833,1117,1222,2699,661,20532
2020-04-10,경남,광주,1495,48,127,192,148,38,2048,1265,48,149,162,115,32,1771
2020-04-10,경남,대구,12803,716,754,1061,1544,530,17408,9901,497,539,452,456,451,12296
2020-04-10,경남,대전,1003,16,73,73,35,36,1236,1173,27,75,110,63,52,1500
2020-04-10,경남,부산,92854,2648,2574,1785,4636,6335,110832,89260,2724,2635,1778,4752,6329,107478
2020-04-10,경남,서울,2354,36,330,267,143,76,3206,3098,42,311,185,105,88,3829
2020-04-10,경남,세종,266,2,7,6,10,8,299,384,3,11,19,18,4,439
2020-04-10,경남,울산,10413,635,616,469,626,659,13418,9992,591,657,447,614,624,12925
2020-04-10,경남,전남,6556,265,383,480,1363,262,9309,7144,296,442,394,1349,322,9947
2020-04-10,경남,전북,1385,37,108,102,195,54,1881,1261,35,124,115,199,47,1781
2020-04-10,경남,충남,1412,64,112,266,207,59,2120,2557,58,169,359,464,103,3710
2020-04-10,경남,충북,1335,54,111,290,250,59,2099,1875,59,186,470,577,58,3225
2020-04-10,경북,강원,480,18,16,29,36,21,600,456,18,25,24,23,21,567
2020-04-10,경북,경기,4662,179,401,826,602,161,6831,5039,166,453,730,685,192,7265
2020-04-10,경북,경남,14000,833,1117,1222,2699,661,20532,10310,588,905,879,1829,486,14997
2020-04-10,경북,경북,77184,3920,3818,2874,5257,4012,97065,77184,3920,3818,2874,5257,4012,97065
2020-04-10,경북,광주,980,63,109,179,143,21,1495,755,64,101,187,106,29,1242
2020-04-10,경북,대구,73896,2936,2343,1507,3473,3867,88022,75996,3093,2570,1891,3970,3939,91459
2020-04-10,경북,대전,2065,60,82,113,88,71,2479,1812,52,96,117,67,95,2239
2020-04-10,경북,부산,4950,126,211,213,638,223,6361,4654,117,210,207,785,188,6161
2020-04-10,경북,서울,3022,86,230,388,144,109,3979,3419,77,205,209,128,110,4148
2020-04-10,경북,세종,350,16,21,30,15,16,448,317,8,14,19,17,14,389
2020-04-10,경북,울산,5377,154,282,384,1013,307,7517,5423,151,278,356,1293,306,7807
2020-04-10,경북,전남,1107,49,79,147,347,34,1763,1035,37,94,101,558,47,1872
2020-04-10,경북,전북,2038,93,197,185,295,62,2870,1682,108,155,161,270,67,2443
2020-04-10,경북,충남,3259,156,382,556,623,121,5097,3973,148,393,537,766,174,5991
2020-04-10,경북,충북,5873,246,505,733,1061,237,8655,5449,246,497,644,1177,220,8233
2020-04-10,광주,강원,78,2,9,10,5,1,105,102,3,7,12,7,5,136
2020-04-10,광주,경기,835,27,85,254,113,35,1349,1326,30,108,302,170,34,1970
2020-04-10,광주,경남,1265,48,149,162,115,32,1771,1495,48,127,192,148,38,2048
2020-04-10,광주,경북,755,64,101,187,106,29,1242,980,63,109,179,143,21,1495
2020-04-10,광주,광주,14413,532,622,415,544,570,17096,14413,532,622,415,544,570,17096
2020-04-10,광주,대구,565,18,59,67,30,14,753,583,22,74,66,26,11,782
2020-04-10,광주,대전,439,17,15,20,14,11,516,501,22,17,19,14,16,589
2020-04-10,광주,부산,406,13,29,38,58,19,563,491,18,27,65,102,11,714
2020-04-10,광주,서울,718,17,7,69,24,19,854,1258,17,26,55,18,36,1410
2020-04-10,광주,세종,191,1,10,1,5,2,210,262,2,8,8,7,10,297
2020-04-10,광주,울산,59,2,7,2,2,0,72,80,0,6,5,8,4,103
2020-04-10,광주,전남,35525,983,1079,828,2081,1428,41924,36145,1004,1026,685,2122,1435,42417
2020-04-10,광주,전북,8418,460,500,345,464,326,10513,8491,462,460,334,507,339,10593
2020-04-10,광주,충남,4978,132,451,459,261,114,6395,5751,130,459,559,331,170,7400
2020-04-10,광주,충북,596,29,56,128,64,17,890,824,44,79,161,110,23,1241
2020-04-10,대구,강원,294,8,10,28,22,7,369,200,4,9,4,7,8,232
2020-04-10,대구,경기,2809,115,176,425,419,106,4050,2049,99,166,391,223,66,2994
2020-04-10,대구,경남,9901,497,539,452,456,451,12296,12803,716,754,1061,1544,530,17408
2020-04-10,대구,경북,75996,3093,2570,1891,3970,3939,91459,73896,2936,2343,1507,3473,3867,88022
2020-04-10,대구,광주,583,22,74,66,26,11,782,565,18,59,67,30,14,753
2020-04-10,대구,대구,58691,2057,1558,895,1153,3907,68261,58691,2057,1558,895,1153,3907,68261
2020-04-10,대구,대전,1000,30,39,83,34,43,1229,675,17,25,42,21,20,800
2020-04-10,대구,부산,590,40,103,66,161,22,982,2682,101,173,93,239,115,3403
2020-04-10,대구,서울,2697,61,97,204,115,78,3252,1621,44,67,112,46,44,1934
2020-04-10,대구,세종,273,5,6,8,12,10,314,202,1,3,2,4,4,216
2020-04-10,대구,울산,1224,53,62,79,147,58,1623,1320,47,56,72,158,59,1712
2020-04-10,대구,전남,494,19,33,28,37,12,623,509,22,42,32,51,22,678
2020-04-10,대구,전북,339,20,27,15,17,15,433,363,14,27,17,23,16,460
2020-04-10,대구,충남,1339,63,122,210,230,47,2011,1255,53,109,144,165,50,1776
2020-04-10,대구,충북,1769,111,168,269,369,77,2763,1335,93,132,228,169,50,2007
2020-04-10,대전,강원,207,6,4,5,1,7,230,176,4,6,12,1,6,205
2020-04-10,대전,경기,2307,96,148,107,49,120,2827,3031,88,140,126,58,148,3591
2020-04-10,대전,경남,1173,27,75,110,63,52,1500,1003,16,73,73,35,36,1236
2020-04-10,대전,경북,1812,52,96,117,67,95,2239,2065,60,82,113,88,71,2479
2020-04-10,대전,광주,501,22,17,19,14,16,589,439,17,15,20,14,11,516
2020-04-10,대전,대구,675,17,25,42,21,20,800,1000,30,39,83,34,43,1229
2020-04-10,대전,대전,14664,427,398,262,421,1075,17247,14664,427,398,262,421,1075,17247
2020-04-10,대전,부산,86,3,5,17,20,3,134,102,6,7,14,27,6,162
2020-04-10,대전,서울,1903,45,115,28,14,98,2203,2355,38,131,38,13,108,2683
2020-04-10,대전,세종,3611,111,74,31,49,266,4142,3595,100,73,47,52,306,4173
2020-04-10,대전,울산,113,5,2,18,27,2,167,160,1,4,12,28,9,214
2020-04-10,대전,전남,355,11,6,32,26,12,442,383,11,8,22,26,7,457
2020-04-10,대전,전북,3369,78,74,80,52,151,3804,3219,86,79,72,67,148,3671
2020-04-10,대전,충남,17706,499,540,281,351,1312,20689,16578,440,447,250,301,1231,19247
2020-04-10,대전,충북,11620,468,433,218,200,782,13721,10972,410,363,207,185,778,12915
2020-04-10,부산,강원,2,1,0,3,9,0,15,7,0,1,0,3,1,12
2020-04-10,부산,경기,288,15,28,151,237,15,734,251,17,49,235,165,14,731
2020-04-10,부산,경남,89260,2724,2635,1778,4752,6329,107478,92854,2648,2574,1785,4636,6335,110832
2020-04-10,부산,경북,4654,117,210,207,785,188,6161,4950,126,211,213,638,223,6361
2020-04-10,부산,광주,491,18,27,65,102,11,714,406,13,29,38,58,19,563
2020-04-10,부산,대구,2682,101,173,93,239,115,3403,590,40,103,66,161,22,982
2020-04-10,부산,대전,102,6,7,14,27,6,162,86,3,5,17,20,3,134
2020-04-10,부산,부산,45187,708,638,785,1897,3177,52392,45187,708,638,785,1897,3177,52392
2020-04-10,부산,서울,287,12,16,85,58,8,466,191,12,20,63,23,6,315
2020-04-10,부산,세종,22,0,1,7,4,3,37,21,1,3,4,5,1,35
2020-04-10,부산,울산,16114,365,440,646,2308,1172,21045,17764,392,423,404,2280,1304,22567
2020-04-10,부산,전남,2110,76,108,152,377,59,2882,2047,81,93,114,477,78,2890
2020-04-10,부산,전북,329,7,27,42,85,11,501,283,10,20,38,61,6,418
2020-04-10,부산,충남,177,4,13,49,114,9,366,223,10,21,94,161,12,521
2020-04-10,부산,충북,143,8,25,83,209,7,475,138,20,27,122,186,4,497
2020-04-10,서울,강원,1099,18,146,14,12,45,1334,844,16,147,17,42,39,1105
2020-04-10,서울,경기,149616,6928,8511,4641,3797,9710,183203,158718,7558,8407,5077,4230,10368,194358
2020-04-10,서울,경남,3098,42,311,185,105,88,3829,2354,36,330,267,143,76,3206
2020-04-10,서울,경북,3419,77,205,209,128,110,4148,3022,86,230,388,144,109,3979
2020-04-10,서울,광주,1258,17,26,55,18,36,1410,718,17,7,69,24,19,854
2020-04-10,서울,대구,1621,44,67,112,46,44,1934,2697,61,97,204,115,78,3252
2020-04-10,서울,대전,2355,38,131,38,13,108,2683,1903,45,115,28,14,98,2203
2020-04-10,서울,부산,191,12,20,63,23,6,315,287,12,16,85,58,8,466
2020-04-10,서울,서울,234,8,8,10,2,9,271,234,8,8,10,2,9,271
2020-04-10,서울,세종,58,2,1,1,0,2,64,47,0,1,3,1,3,55
2020-04-10,서울,울산,27,1,3,2,2,0,35,35,0,4,4,17,0,60
2020-04-10,서울,전남,1475,12,24,26,25,47,1609,944,8,14,53,27,33,1079
2020-04-10,서울,전북,2189,22,43,36,20,66,2376,1370,35,40,36,19,50,1550
2020-04-10,서울,충남,33525,571,1731,788,752,1270,38637,31362,617,1779,1225,1224,1270,37477
2020-04-10,서울,충북,16563,564,918,822,820,668,20355,16322,667,890,834,960,662,20335
2020-04-10,세종,강원,9,0,1,1,0,0,11,2,0,0,0,1,0,3
2020-04-10,세종,경기,49,2,2,5,6,6,70,73,2,2,3,1,1,82
2020-04-10,세종,경남,384,3,11,19,18,4,439,266,2,7,6,10,8,299
2020-04-10,세종,경북,317,8,14,19,17,14,389,350,16,21,30,15,16,448
2020-04-10,세종,광주,262,2,8,8,7,10,297,191,1,10,1,5,2,210
2020-04-10,세종,대구,202,1,3,2,4,4,216,273,5,6,8,12,10,314
2020-04-10,세종,대전,3595,100,73,47,52,306,4173,3611,111,74,31,49,266,4142
2020-04-10,세종,부산,21,1,3,4,5,1,35,22,0,1,7,4,3,37
2020-04-10,세종,서울,47,0,1,3,1,3,55,58,2,1,1,0,2,64
2020-04-10,세종,세종,240,25,2,3,1,19,290,240,25,2,3,1,19,290
2020-04-10,세종,울산,17,0,0,8,4,0,29,15,0,1,1,4,0,21
2020-04-10,세종,전남,271,6,4,6,17,5,309,223,2,2,9,10,11,257
2020-04-10,세종,전북,856,12,34,15,34,29,980,728,9,23,19,36,27,842
2020-04-10,세종,충남,6780,177,164,124,196,382,7823,5435,142,137,102,167,254,6237
2020-04-10,세종,충북,410,14,21,13,10,30,498,361,17,22,9,18,28,455
2020-04-10,울산,강원,7,0,1,1,1,0,10,2,0,0,0,0,1,3
2020-04-10,울산,경기,44,1,3,30,71,3,152,31,2,7,12,16,1,69
2020-04-10,울산,경남,9992,591,657,447,614,624,12925,10413,635,616,469,626,659,13418
2020-04-10,울산,경북,5423,151,278,356,1293,306,7807,5377,154,282,384,1013,307,7517
2020-04-10,울산,광주,80,0,6,5,8,4,103,59,2,7,2,2,0,72
2020-04-10,울산,대구,1320,47,56,72,158,59,1712,1224,53,62,79,147,58,1623
2020-04-10,울산,대전,160,1,4,12,28,9,214,113,5,2,18,27,2,167
2020-04-10,울산,부산,17764,392,423,404,2280,1304,22567,16114,365,440,646,2308,1172,21045
2020-04-10,울산,서울,35,0,4,4,17,0,60,27,1,3,2,2,0,35
2020-04-10,울산,세종,15,0,1,1,4,0,21,17,0,0,8,4,0,29
2020-04-10,울산,울산,8183,285,454,291,646,729,10588,8183,285,454,291,646,729,10588
2020-04-10,울산,전남,215,16,26,14,31,3,305,249,17,27,6,45,5,349
2020-04-10,울산,전북,68,2,8,6,15,4,103,35,1,6,4,3,1,50
2020-04-10,울산,충남,192,10,15,57,119,5,398,215,6,14,41,103,7,386
2020-04-10,울산,충북,30,1,4,19,44,2,100,27,1,5,15,23,0,71
2020-04-10,전남,강원,58,5,4,6,20,4,97,55,1,1,8,12,1,78
2020-04-10,전남,경기,952,17,69,143,134,33,1348,1323,25,85,170,166,33,1802
2020-04-10,전남,경남,7144,296,442,394,1349,322,9947,6556,265,383,480,1363,262,9309
2020-04-10,전남,경북,1035,37,94,101,558,47,1872,1107,49,79,147,347,34,1763
2020-04-10,전남,광주,36145,1004,1026,685,2122,1435,42417,35525,983,1079,828,2081,1428,41924
2020-04-10,전남,대구,509,22,42,32,51,22,678,494,19,33,28,37,12,623
2020-04-10,전남,대전,383,11,8,22,26,7,457,355,11,6,32,26,12,442
2020-04-10,전남,부산,2047,81,93,114,477,78,2890,2110,76,108,152,377,59,2882
2020-04-10,전남,서울,944,8,14,53,27,33,1079,1475,12,24,26,25,47,1609
2020-04-10,전남,세종,223,2,2,9,10,11,257,271,6,4,6,17,5,309
2020-04-10,전남,울산,249,17,27,6,45,5,349,215,16,26,14,31,3,305
2020-04-10,전남,전남,49495,1442,1521,1560,5141,1916,61075,49495,1442,1521,1560,5141,1916,61075
2020-04-10,전남,전북,5794,304,526,485,1380,177,8666,5577,265,438,588,1404,175,8447
2020-04-10,전남,충남,5662,111,351,614,1021,173,7932,6922,101,346,512,933,185,8999
2020-04-10,전남,충북,472,21,29,85,244,6,857,485,22,44,111,244,8,914
2020-04-10,전북,강원,180,4,12,23,16,3,238,134,5,8,7,23,3,180
2020-04-10,전북,경기,1489,54,127,170,206,64,2110,2251,51,136,116,219,90,2863
2020-04-10,전북,경남,1261,35,124,115,199,47,1781,1385,37,108,102,195,54,1881
2020-04-10,전북,경북,1682,108,155,161,270,67,2443,2038,93,197,185,295,62,2870
2020-04-10,전북,광주,8491,462,460,334,507,339,10593,8418,460,500,345,464,326,10513
2020-04-10,전북,대구,363,14,27,17,23,16,460,339,20,27,15,17,15,433
2020-04-10,전북,대전,3219,86,79,72,67,148,3671,3369,78,74,80,52,151,3804
2020-04-10,전북,부산,283,10,20,38,61,6,418,329,7,27,42,85,11,501
2020-04-10,전북,서울,1370,35,40,36,19,50,1550,2189,22,43,36,20,66,2376
2020-04-10,전북,세종,728,9,23,19,36,27,842,856,12,34,15,34,29,980
2020-04-10,전북,울산,35,1,6,4,3,1,50,68,2,8,6,15,4,103
2020-04-10,전북,전남,5577,265,438,588,1404,175,8447,5794,304,526,485,1380,177,8666
2020-04-10,전북,전북,18046,753,892,788,885,630,21994,18046,753,892,788,885,630,21994
2020-04-10,전북,충남,15585,537,1301,1054,1464,545,20486,18317,523,1285,974,1513,686,23298
2020-04-10,전북,충북,1940,112,195,257,265,54,2823,2252,124,221,260,277,83,3217
2020-04-10,충남,강원,616,12,18,36,67,28,777,356,7,19,28,25,14,449
2020-04-10,충남,경기,45911,1571,2466,2311,4325,2329,58913,48886,1599,2590,2473,4566,2355,62469
2020-04-10,충남,경남,2557,58,169,359,464,103,3710,1412,64,112,266,207,59,2120
2020-04-10,충남,경북,3973,148,393,537,766,174,5991,3259,156,382,556,623,121,5097
2020-04-10,충남,광주,5751,130,459,559,331,170,7400,4978,132,451,459,261,114,6395
2020-04-10,충남,대구,1255,53,109,144,165,50,1776,1339,63,122,210,230,47,2011
2020-04-10,충남,대전,16578,440,447,250,301,1231,19247,17706,499,540,281,351,1312,20689
2020-04-10,충남,부산,223,10,21,94,161,12,521,177,4,13,49,114,9,366
2020-04-10,충남,서울,31362,617,1779,1225,1224,1270,37477,33525,571,1731,788,752,1270,38637
2020-04-10,충남,세종,5435,142,137,102,167,254,6237,6780,177,164,124,196,382,7823
2020-04-10,충남,울산,215,6,14,41,103,7,386,192,10,15,57,119,5,398
2020-04-10,충남,전남,6922,101,346,512,933,185,8999,5662,111,351,614,1021,173,7932
2020-04-10,충남,전북,18317,523,1285,974,1513,686,23298,15585,537,1301,1054,1464,545,20486
2020-04-10,충남,충남,114554,3820,7108,7254,10283,5175,148194,114554,3820,7108,7254,10283,5175,148194
2020-04-10,충남,충북,15433,670,859,1023,1477,832,20294,13606,633,812,878,1535,755,18219
2020-04-10,충북,강원,5580,226,244,240,392,318,7000,5119,241,238,283,478,308,6667
2020-04-10,충북,경기,32067,2185,2717,2954,3965,1490,45378,33737,2247,2829,3328,3680,1645,47466
2020-04-10,충북,경남,1875,59,186,470,577,58,3225,1335,54,111,290,250,59,2099
2020-04-10,충북,경북,5449,246,497,644,1177,220,8233,5873,246,505,733,1061,237,8655
2020-04-10,충북,광주,824,44,79,161,110,23,1241,596,29,56,128,64,17,890
2020-04-10,충북,대구,1335,93,132,228,169,50,2007,1769,111,168,269,369,77,2763
2020-04-10,충북,대전,10972,410,363,207,185,778,12915,11620,468,433,218,200,782,13721
2020-04-10,충북,부산,138,20,27,122,186,4,497,143,8,25,83,209,7,475
2020-04-10,충북,서울,16322,667,890,834,960,662,20335,16563,564,918,822,820,668,20355
2020-04-10,충북,세종,361,17,22,9,18,28,455,410,14,21,13,10,30,498
2020-04-10,충북,울산,27,1,5,15,23,0,71,30,1,4,19,44,2,100
2020-04-10,충북,전남,485,22,44,111,244,8,914,472,21,29,85,244,6,857
2020-04-10,충북,전북,2252,124,221,260,277,83,3217,1940,112,195,257,265,54,2823
2020-04-10,충북,충남,13606,633,812,878,1535,755,18219,15433,670,859,1023,1477,832,20294
2020-04-10,충북,충북,40724,2112,2348,2381,3461,2244,53270,40724,2112,2348,2381,3461,2244,53270
2020-04-11,강원,강원,89262,1759,1780,898,2633,4583,100915,89262,1759,1780,898,2633,4583,100915
2020-04-11,강원,경기,32186,361,659,338,507,1306,35357,43596,400,619,436,676,1766,47493
2020-04-11,강원,경남,151,2,5,3,5,6,172,120,2,2,6,2,3,135
2020-04-11,강원,경북,488,17,12,15,27,15,574,527,14,5,16,15,15,592
2020-04-11,강원,광주,77,1,5,3,4,3,93,75,0,6,6,2,3,92
2020-04-11,강원,대구,184,1,4,4,2,5,200,304,3,6,15,11,8,347
2020-04-11,강원,대전,195,1,6,7,0,4,213,251,9,6,8,1,12,287
2020-04-11,강원,부산,2,0,0,0,0,0,2,3,0,0,0,0,0,3
2020-04-11,강원,서울,1055,9,116,2,43,24,1249,1583,11,117,2,9,64,1786
2020-04-11,강원,세종,2,0,0,0,0,0,2,7,0,0,0,1,1,9
2020-04-11,강원,울산,2,0,0,0,0,0,2,1,0,1,0,0,0,2
2020-04-11,강원,전남,39,0,4,0,4,1,48,39,1,2,6,5,1,54
2020-04-11,강원,전북,132,2,12,2,4,3,155,165,5,9,14,5,2,200
2020-04-11,강원,충남,317,3,10,13,11,12,366,574,6,19,29,53,12,693
2020-04-11,강원,충북,5345,158,145,155,321,286,6410,6024,129,135,141,301,271,7001
2020-04-11,경기,강원,43596,400,619,436,676,1766,47493,32186,361,659,338,507,1306,35357
2020-04-11,경기,경기,398103,10247,11020,9438,14381,23499,466688,398103,10247,11020,9438,14381,23499,466688
2020-04-11,경기,경남,3152,41,183,481,335,132,4324,1918,32,116,252,187,92,2597
2020-04-11,경기,경북,5346,85,192,403,336,201,6563,4136,69,172,394,274,166,5211
2020-04-11,경기,광주,1018,12,58,158,89,21,1356,743,7,30,94,49,22,945
2020-04-11,경기,대구,1608,27,85,233,120,67,2140,2150,46,81,214,179,67,2737
2020-04-11,경기,대전,3300,52,114,86,32,159,3743,2601,57,117,57,27,131,2990
2020-04-11,경기,부산,302,7,34,130,105,11,589,261,6,14,92,110,10,493
2020-04-11,경기,서울,136362,4098,4574,2869,3067,7686,158656,132996,3649,4712,2246,2741,7384,153728
2020-04-11,경기,세종,37,1,3,1,1,0,43,66,1,1,0,1,1,70
2020-04-11,경기,울산,29,0,4,3,7,1,44,34,0,3,13,27,2,79
2020-04-11,경기,전남,1432,12,47,87,80,30,1688,1034,12,36,75,76,26,1259
2020-04-11,경기,전북,2694,21,80,64,106,94,3059,1861,25,55,83,83,65,2172
2020-04-11,경기,충남,53935,720,1312,1127,2020,2388,61502,47620,696,1276,1099,2238,2108,55037
2020-04-11,경기,충북,36124,950,1261,1565,2138,1629,43667,32078,871,1177,1294,2513,1493,39426
2020-04-11,경남,강원,120,2,2,6,2,3,135,151,2,5,3,5,6,172
2020-04-11,경남,경기,1918,32,116,252,187,92,2597,3152,41,183,481,335,132,4324
2020-04-11,경남,경남,178772,5364,4881,3886,7682,11616,212201,178772,5364,4881,3886,7682,11616,212201
2020-04-11,경남,경북,12226,271,463,386,881,559,14786,14757,384,537,602,1195,671,18146
2020-04-11,경남,광주,1316,27,75,90,77,45,1630,1291,16,72,79,57,34,1549
2020-04-11,경남,대구,12478,351,462,463,655,498,14907,11588,252,356,236,270,434,13136
2020-04-11,경남,대전,937,9,56,35,23,41,1101,1381,11,62,78,37,59,1628
2020-04-11,경남,부산,86341,1421,1579,1059,2110,5371,97881,85602,1377,1581,995,2157,5336,97048
2020-04-11,경남,서울,1855,14,267,114,66,77,2393,2991,18,314,127,70,105,3625
2020-04-11,경남,세종,188,0,3,4,8,5,208,352,0,6,6,6,10,380
2020-04-11,경남,울산,10132,327,305,222,241,586,11813,10237,323,350,189,218,554,11871
2020-04-11,경남,전남,7107,124,198,226,737,290,8682,6923,157,234,178,700,328,8520
2020-04-11,경남,전북,1606,28,72,35,143,72,1956,1396,28,72,43,142,49,1730
2020-04-11,경남,충남,1289,19,57,89,112,42,1608,2053,26,76,201,234,69,2659
2020-04-11,경남,충북,1234,17,58,110,136,43,1598,1754,31,104,259,337,69,2554
2020-04-11,경북,강원,527,14,5,16,15,15,592,488,17,12,15,27,15,574
2020-04-11,경북,경기,4136,69,172,394,274,166,5211,5346,85,192,403,336,201,6563
2020-04-11,경북,경남,14757,384,537,602,1195,671,18146,12226,271,463,386,881,559,14786
2020-04-11,경북,경북,78891,2304,2081,2318,3684,3787,93065,78891,2304,2081,2318,3684,3787,93065
2020-04-11,경북,광주,765,15,56,75,58,27,996,699,20,54,56,25,29,883
2020-04-11,경북,대구,66999,1678,1263,1203,2535,3163,76841,74510,1715,1314,1376,2652,3415,84982
2020-04-11,경북,대전,2038,36,56,53,56,94,2333,2296,24,50,74,37,95,2576
2020-04-11,경북,부산,6114,50,123,94,246,268,6895,6956,57,136,74,252,300,7775
2020-04-11,경북,서울,3048,49,156,167,80,114,3614,4016,31,151,138,81,125,4542
2020-04-11,경북,세종,306,5,8,14,7,12,352,394,3,8,3,9,14,431
2020-04-11,경북,울산,6085,61,128,210,563,329,7376,6347,50,127,158,679,362,7723
2020-04-11,경북,전남,1217,28,47,44,183,42,1561,1140,30,41,49,263,29,1552
2020-04-11,경북,전북,2255,50,106,83,181,61,2736,1801,59,96,59,150,58,2223
2020-04-11,경북,충남,3381,58,116,174,324,157,4210,3866,60,133,236,384,140,4819
2020-04-11,경북,충북,5923,122,220,290,681,249,7485,6202,137,246,386,802,252,8025
2020-04-11,광주,강원,75,0,6,6,2,3,92,77,1,5,3,4,3,93
2020-04-11,광주,경기,743,7,30,94,49,22,945,1018,12,58,158,89,21,1356
2020-04-11,광주,경남,1291,16,72,79,57,34,1549,1316,27,75,90,77,45,1630
2020-04-11,광주,경북,699,20,54,56,25,29,883,765,15,56,75,58,27,996
2020-04-11,광주,광주,13156,354,392,225,290,472,14889,13156,354,392,225,290,472,14889
2020-04-11,광주,대구,477,12,49,51,14,16,619,566,16,58,47,14,13,714
2020-04-11,광주,대전,543,13,2,12,3,34,607,660,8,6,13,10,20,717
2020-04-11,광주,부산,498,6,28,12,33,13,590,465,3,40,21,34,12,575
2020-04-11,광주,서울,663,13,8,37,9,14,744,1059,14,11,30,4,31,1149
2020-04-11,광주,세종,151,1,4,1,1,4,162,287,0,4,5,1,11,308
2020-04-11,광주,울산,59,2,6,2,2,3,74,60,3,4,2,3,2,74
2020-04-11,광주,전남,38797,655,722,442,1005,1418,43039,36234,647,721,330,1088,1307,40327
2020-04-11,광주,전북,9599,243,294,160,271,282,10849,9046,279,272,158,296,269,10320
2020-04-11,광주,충남,5231,42,325,172,170,138,6078,6178,48,347,350,214,174,7311
2020-04-11,광주,충북,599,14,29,48,14,18,722,794,16,41,67,63,24,1005
2020-04-11,대구,강원,304,3,6,15,11,8,347,184,1,4,4,2,5,200
2020-04-11,대구,경기,2150,46,81,214,179,67,2737,1608,27,85,233,120,67,2140
2020-04-11,대구,경남,11588,252,356,236,270,434,13136,12478,351,462,463,655,498,14907
2020-04-11,대구,경북,74510,1715,1314,1376,2652,3415,84982,66999,1678,1263,1203,2535,3163,76841
2020-04-11,대구,광주,566,16,58,47,14,13,714,477,12,49,51,14,16,619
2020-04-11,대구,대구,46107,1204,851,508,877,2673,52220,46107,1204,851,508,877,2673,52220
2020-04-11,대구,대전,913,19,18,37,23,38,1048,579,12,9,38,15,22,675
2020-04-11,대구,부산,800,21,74,47,60,24,1026,3360,39,127,43,79,129,3777
2020-04-11,대구,서울,2088,21,81,110,66,77,2443,1367,17,63,81,18,51,1597
2020-04-11,대구,세종,224,3,2,4,5,8,246,169,1,1,1,1,9,182
2020-04-11,대구,울산,1273,28,38,35,68,55,1497,1327,26,30,30,87,50,1550
2020-04-11,대구,전남,677,5,27,17,11,24,761,593,11,25,27,21,16,693
2020-04-11,대구,전북,407,2,15,4,12,15,455,339,4,19,6,13,11,392
2020-04-11,대구,충남,1331,29,50,71,83,46,1610,1020,17,33,97,112,39,1318
2020-04-11,대구,충북,1725,35,80,109,155,58,2162,1134,38,69,146,99,31,1517
2020-04-11,대전,강원,251,9,6,8,1,12,287,195,1,6,7,0,4,213
2020-04-11,대전,경기,2601,57,117,57,27,131,2990,3300,52,114,86,32,159,3743
2020-04-11,대전,경남,1381,11,62,78,37,59,1628,937,9,56,35,23,41,1101
2020-04-11,대전,경북,2296,24,50,74,37,95,2576,2038,36,56,53,56,94,2333
2020-04-11,대전,광주,660,8,6,13,10,20,717,543,13,2,12,3,34,607
2020-04-11,대전,대구,579,12,9,38,15,22,675,913,19,18,37,23,38,1048
2020-04-11,대전,대전,12887,230,283,110,259,867,14636,12887,230,283,110,259,867,14636
2020-04-11,대전,부산,105,0,3,6,12,6,132,95,2,10,9,18,2,136
2020-04-11,대전,서울,2034,20,117,22,8,86,2287,2482,21,112,23,9,99,2746
2020-04-11,대전,세종,3037,65,39,20,35,174,3370,3088,74,42,17,44,180,3445
2020-04-11,대전,울산,113,2,1,10,15,4,145,128,0,2,5,15,4,154
2020-04-11,대전,전남,514,7,5,21,16,15,578,403,4,7,4,11,15,444
2020-04-11,대전,전북,4655,42,51,57,22,201,5028,4190,60,51,31,35,160,4527
2020-04-11,대전,충남,16473,283,313,166,188,934,18357,15337,260,297,119,173,908,17094
2020-04-11,대전,충북,10604,281,276,132,108,648,12049,9754,242,262,114,121,607,11100
2020-04-11,부산,강원,3,0,0,0,0,0,3,2,0,0,0,0,0,2
2020-04-11,부산,경기,261,6,14,92,110,10,493,302,7,34,130,105,11,589
2020-04-11,부산,경남,85602,1377,1581,995,2157,5336,97048,86341,1421,1579,1059,2110,5371,97881
2020-04-11,부산,경북,6956,57,136,74,252,300,7775,6114,50,123,94,246,268,6895
2020-04-11,부산,광주,465,3,40,21,34,12,575,498,6,28,12,33,13,590
2020-04-11,부산,대구,3360,39,127,43,79,129,3777,800,21,74,47,60,24,1026
2020-04-11,부산,대전,95,2,10,9,18,2,136,105,0,3,6,12,6,132
2020-04-11,부산,부산,50736,343,250,465,937,2971,55702,50736,343,250,465,937,2971,55702
2020-04-11,부산,서울,233,10,12,31,26,9,321,235,9,17,50,20,11,342
2020-04-11,부산,세종,23,1,2,3,0,1,30,24,1,1,1,0,0,27
2020-04-11,부산,울산,17514,191,190,236,1009,1090,20230,18919,180,168,162,1041,1188,21658
2020-04-11,부산,전남,2230,28,63,60,161,78,2620,2164,29,63,56,202,83,2597
2020-04-11,부산,전북,468,2,33,14,42,15,574,318,4,22,20,29,15,408
2020-04-11,부산,충남,186,4,10,18,52,13,283,187,2,6,45,65,4,309
2020-04-11,부산,충북,121,5,11,23,79,6,245,114,7,16,64,94,7,302
2020-04-11,서울,강원,1583,11,117,2,9,64,1786,1055,9,116,2,43,24,1249
2020-04-11,서울,경기,132996,3649,4712,2246,2741,7384,153728,136362,4098,4574,2869,3067,7686,158656
2020-04-11,서울,경남,2991,18,314,127,70,105,3625,1855,14,267,114,66,77,2393
2020-04-11,서울,경북,4016,31,151,138,81,125,4542,3048,49,156,167,80,114,3614
2020-04-11,서울,광주,1059,14,11,30,4,31,1149,663,13,8,37,9,14,744
2020-04-11,서울,대구,1367,17,63,81,18,51,1597,2088,21,81,110,66,77,2443
2020-04-11,서울,대전,2482,21,112,23,9,99,2746,2034,20,117,22,8,86,2287
2020-04-11,서울,부산,235,9,17,50,20,11,342,233,10,12,31,26,9,321
2020-04-11,서울,서울,196,3,7,6,3,9,224,196,3,7,6,3,9,224
2020-04-11,서울,세종,41,1,0,1,1,0,44,54,2,0,1,0,0,57
2020-04-11,서울,울산,40,0,3,1,2,0,46,23,0,0,1,6,1,31
2020-04-11,서울,전남,1692,7,30,23,20,53,1825,1048,3,18,31,21,30,1151
2020-04-11,서울,전북,2733,8,28,6,11,74,2860,1679,14,27,15,11,58,1804
2020-04-11,서울,충남,40836,269,1446,448,418,1503,44920,36408,297,1409,546,700,1373,40733
2020-04-11,서울,충북,19168,214,622,436,416,767,21623,17077,227,584,478,614,733,19713
2020-04-11,세종,강원,7,0,0,0,1,1,9,2,0,0,0,0,0,2
2020-04-11,세종,경기,66,1,1,0,1,1,70,37,1,3,1,1,0,43
2020-04-11,세종,경남,352,0,6,6,6,10,380,188,0,3,4,8,5,208
2020-04-11,세종,경북,394,3,8,3,9,14,431,306,5,8,14,7,12,352
2020-04-11,세종,광주,287,0,4,5,1,11,308,151,1,4,1,1,4,162
2020-04-11,세종,대구,169,1,1,1,1,9,182,224,3,2,4,5,8,246
2020-04-11,세종,대전,3088,74,42,17,44,180,3445,3037,65,39,20,35,174,3370
2020-04-11,세종,부산,24,1,1,1,0,0,27,23,1,2,3,0,1,30
2020-04-11,세종,서울,54,2,0,1,0,0,57,41,1,0,1,1,0,44
2020-04-11,세종,세종,262,22,5,2,2,12,305,262,22,5,2,2,12,305
2020-04-11,세종,울산,10,0,0,0,0,1,11,14,0,0,1,3,2,20
2020-04-11,세종,전남,262,0,3,3,7,5,280,200,0,0,1,6,4,211
2020-04-11,세종,전북,1351,10,10,3,22,63,1459,1076,8,11,8,21,35,1159
2020-04-11,세종,충남,7809,112,98,71,139,344,8573,5754,84,99,56,149,237,6379
2020-04-11,세종,충북,466,7,11,7,14,25,530,348,9,11,12,9,25,414
2020-04-11,울산,강원,1,0,1,0,0,0,2,2,0,0,0,0,0,2
2020-04-11,울산,경기,34,0,3,13,27,2,79,29,0,4,3,7,1,44
2020-04-11,울산,경남,10237,323,350,189,218,554,11871,10132,327,305,222,241,586,11813
2020-04-11,울산,경북,6347,50,127,158,679,362,7723,6085,61,128,210,563,329,7376
2020-04-11,울산,광주,60,3,4,2,3,2,74,59,2,6,2,2,3,74
2020-04-11,울산,대구,1327,26,30,30,87,50,1550,1273,28,38,35,68,55,1497
2020-04-11,울산,대전,128,0,2,5,15,4,154,113,2,1,10,15,4,145
2020-04-11,울산,부산,18919,180,168,162,1041,1188,21658,17514,191,190,236,1009,1090,20230
2020-04-11,울산,서울,23,0,0,1,6,1,31,40,0,3,1,2,0,46
2020-04-11,울산,세종,14,0,0,1,3,2,20,10,0,0,0,0,1,11
2020-04-11,울산,울산,6019,137,139,86,338,456,7175,6019,137,139,86,338,456,7175
2020-04-11,울산,전남,272,8,10,5,6,7,308,245,11,10,5,10,8,289
2020-04-11,울산,전북,65,0,4,0,11,3,83,52,0,3,3,2,1,61
2020-04-11,울산,충남,146,3,2,20,34,6,211,120,2,6,17,44,6,195
2020-04-11,울산,충북,23,2,0,6,16,1,48,21,0,0,2,22,0,45
2020-04-11,전남,강원,39,1,2,6,5,1,54,39,0,4,0,4,1,48
2020-04-11,전남,경기,1034,12,36,75,76,26,1259,1432,12,47,87,80,30,1688
2020-04-11,전남,경남,6923,157,234,178,700,328,8520,7107,124,198,226,737,290,8682
2020-04-11,전남,경북,1140,30,41,49,263,29,1552,1217,28,47,44,183,42,1561
2020-04-11,전남,광주,36234,647,721,330,1088,1307,40327,38797,655,722,442,1005,1418,43039
2020-04-11,전남,대구,593,11,25,27,21,16,693,677,5,27,17,11,24,761
2020-04-11,전남,대전,403,4,7,4,11,15,444,514,7,5,21,16,15,578
2020-04-11,전남,부산,2164,29,63,56,202,83,2597,2230,28,63,60,161,78,2620
2020-04-11,전남,서울,1048,3,18,31,21,30,1151,1692,7,30,23,20,53,1825
2020-04-11,전남,세종,200,0,0,1,6,4,211,262,0,3,3,7,5,280
2020-04-11,전남,울산,245,11,10,5,10,8,289,272,8,10,5,6,7,308
2020-04-11,전남,전남,48553,800,905,838,3329,1583,56008,48553,800,905,838,3329,1583,56008
2020-04-11,전남,전북,6821,176,360,291,792,223,8663,6752,151,284,344,833,234,8598
2020-04-11,전남,충남,5603,52,235,193,364,134,6581,7500,45,275,276,373,193,8662
2020-04-11,전남,충북,403,10,16,38,89,10,566,558,5,10,59,142,11,785
2020-04-11,전북,강원,165,5,9,14,5,2,200,132,2,12,2,4,3,155
2020-04-11,전북,경기,1861,25,55,83,83,65,2172,2694,21,80,64,106,94,3059
2020-04-11,전북,경남,1396,28,72,43,142,49,1730,1606,28,72,35,143,72,1956
2020-04-11,전북,경북,1801,59,96,59,150,58,2223,2255,50,106,83,181,61,2736
2020-04-11,전북,광주,9046,279,272,158,296,269,10320,9599,243,294,160,271,282,10849
2020-04-11,전북,대구,339,4,19,6,13,11,392,407,2,15,4,12,15,455
2020-04-11,전북,대전,4190,60,51,31,35,160,4527,4655,42,51,57,22,201,5028
2020-04-11,전북,부산,318,4,22,20,29,15,408,468,2,33,14,42,15,574
2020-04-11,전북,서울,1679,14,27,15,11,58,1804,2733,8,28,6,11,74,2860
2020-04-11,전북,세종,1076,8,11,8,21,35,1159,1351,10,10,3,22,63,1459
2020-04-11,전북,울산,52,0,3,3,2,1,61,65,0,4,0,11,3,83
2020-04-11,전북,전남,6752,151,284,344,833,234,8598,6821,176,360,291,792,223,8663
2020-04-11,전북,전북,18025,423,562,355,608,621,20594,18025,423,562,355,608,621,20594
2020-04-11,전북,충남,18718,286,809,437,673,654,21577,22569,306,876,501,760,804,25816
2020-04-11,전북,충북,2170,67,81,105,146,92,2661,2651,70,85,117,172,106,3201
2020-04-11,충남,강원,574,6,19,29,53,12,693,317,3,10,13,11,12,366
2020-04-11,충남,경기,47620,696,1276,1099,2238,2108,55037,53935,720,1312,1127,2020,2388,61502
2020-04-11,충남,경남,2053,26,76,201,234,69,2659,1289,19,57,89,112,42,1608
2020-04-11,충남,경북,3866,60,133,236,384,140,4819,3381,58,116,174,324,157,4210
2020-04-11,충남,광주,6178,48,347,350,214,174,7311,5231,42,325,172,170,138,6078
2020-04-11,충남,대구,1020,17,33,97,112,39,1318,1331,29,50,71,83,46,1610
2020-04-11,충남,대전,15337,260,297,119,173,908,17094,16473,283,313,166,188,934,18357
2020-04-11,충남,부산,187,2,6,45,65,4,309,186,4,10,18,52,13,283
2020-04-11,충남,서울,36408,297,1409,546,700,1373,40733,40836,269,1446,448,418,1503,44920
2020-04-11,충남,세종,5754,84,99,56,149,237,6379,7809,112,98,71,139,344,8573
2020-04-11,충남,울산,120,2,6,17,44,6,195,146,3,2,20,34,6,211
2020-04-11,충남,전남,7500,45,275,276,373,193,8662,5603,52,235,193,364,134,6581
2020-04-11,충남,전북,22569,306,876,501,760,804,25816,18718,286,809,437,673,654,21577
2020-04-11,충남,충남,119797,1912,4101,3025,5269,4888,138992,119797,1912,4101,3025,5269,4888,138992
2020-04-11,충남,충북,13127,294,351,482,915,646,15815,12303,308,354,361,823,556,14705
2020-04-11,충북,강원,6024,129,135,141,301,271,7001,5345,158,145,155,321,286,6410
2020-04-11,충북,경기,32078,871,1177,1294,2513,1493,39426,36124,950,1261,1565,2138,1629,43667
2020-04-11,충북,경남,1754,31,104,259,337,69,2554,1234,17,58,110,136,43,1598
2020-04-11,충북,경북,6202,137,246,386,802,252,8025,5923,122,220,290,681,249,7485
2020-04-11,충북,광주,794,16,41,67,63,24,1005,599,14,29,48,14,18,722
2020-04-11,충북,대구,1134,38,69,146,99,31,1517,1725,35,80,109,155,58,2162
2020-04-11,충북,대전,9754,242,262,114,121,607,11100,10604,281,276,132,108,648,12049
2020-04-11,충북,부산,114,7,16,64,94,7,302,121,5,11,23,79,6,245
2020-04-11,충북,서울,17077,227,584,478,614,733,19713,19168,214,622,436,416,767,21623
2020-04-11,충북,세종,348,9,11,12,9,25,414,466,7,11,7,14,25,530
2020-04-11,충북,울산,21,0,0,2,22,0,45,23,2,0,6,16,1,48
2020-04-11,충북,전남,558,5,10,59,142,11,785,403,10,16,38,89,10,566
2020-04-11,충북,전북,2651,70,85,117,172,106,3201,2170,67,81,105,146,92,2661
2020-04-11,충북,충남,12303,308,354,361,823,556,14705,13127,294,351,482,915,646,15815
2020-04-11,충북,충북,37438,1065,1042,1048,2269,1929,44791,37438,1065,1042,1048,2269,1929,44791
2020-04-12,강원,강원,63731,684,1085,298,595,3467,69860,63731,684,1085,298,595,3467,69860
2020-04-12,강원,경기,40039,217,388,201,160,1526,42531,24309,160,370,125,210,1113,26287
2020-04-12,강원,경남,211,2,7,4,4,7,235,115,0,5,4,2,7,133
2020-04-12,강원,경북,545,10,11,6,12,27,611,451,7,7,19,6,25,515
2020-04-12,강원,광주,88,0,4,3,0,2,97,80,0,5,4,1,3,93
2020-04-12,강원,대구,245,0,1,8,3,7,264,202,3,6,6,3,11,231
2020-04-12,강원,대전,231,1,3,0,0,11,246,176,2,4,0,0,10,192
2020-04-12,강원,부산,5,0,0,0,0,0,5,8,0,0,0,0,0,8
2020-04-12,강원,서울,2036,10,137,9,1,78,2271,938,10,110,2,3,27,1090
2020-04-12,강원,세종,7,0,0,0,0,1,8,12,0,1,0,0,1,14
2020-04-12,강원,울산,4,0,0,0,0,0,4,1,0,0,0,0,1,2
2020-04-12,강원,전남,51,0,2,1,2,1,57,61,1,1,4,3,3,73
2020-04-12,강원,전북,161,2,4,1,2,5,175,174,3,4,5,4,7,197
2020-04-12,강원,충남,486,2,5,4,8,22,527,407,2,6,6,15,12,448
2020-04-12,강원,충북,5582,71,75,48,67,259,6102,4580,57,70,36,77,232,5052
2020-04-12,경기,강원,24309,160,370,125,210,1113,26287,40039,217,388,201,160,1526,42531
2020-04-12,경기,경기,322606,4571,5251,3073,3629,18469,357599,322606,4571,5251,3073,3629,18469,357599
2020-04-12,경기,경남,2531,24,117,125,70,103,2970,2940,11,84,140,80,119,3374
2020-04-12,경기,경북,4106,36,100,149,73,159,4623,6109,43,87,177,77,227,6720
2020-04-12,경기,광주,657,5,33,26,14,22,757,1045,4,23,33,20,37,1162
2020-04-12,경기,대구,1590,10,37,77,22,50,1786,2586,17,40,81,50,93,2867
2020-04-12,경기,대전,2232,10,73,11,5,114,2445,3127,16,72,21,7,180,3423
2020-04-12,경기,부산,228,3,8,35,18,3,295,510,3,9,18,36,21,597
2020-04-12,경기,서울,108490,1512,3073,1209,939,5813,121036,117308,1691,3131,1184,991,6504,130809
2020-04-12,경기,세종,29,0,1,0,2,2,34,42,1,1,0,0,0,44
2020-04-12,경기,울산,19,1,4,1,5,0,30,38,0,0,5,8,1,52
2020-04-12,경기,전남,829,4,39,25,24,31,952,1514,11,36,58,21,42,1682
2020-04-12,경기,전북,1406,5,37,18,21,58,1545,2927,8,36,43,24,99,3137
2020-04-12,경기,충남,40049,288,821,448,549,1876,44031,46654,333,707,415,495,1977,50581
2020-04-12,경기,충북,27129,454,568,484,526,1383,30544,34433,442,520,466,474,1527,37862
2020-04-12,경남,강원,115,0,5,4,2,7,133,211,2,7,4,4,7,235
2020-04-12,경남,경기,2940,11,84,140,80,119,3374,2531,24,117,125,70,103,2970
2020-04-12,경남,경남,141388,1947,2138,815,1117,8629,156034,141388,1947,2138,815,1117,8629,156034
2020-04-12,경남,경북,11019,126,214,133,190,556,12238,13978,190,290,199,222,695,15574
2020-04-12,경남,광주,1159,13,34,27,15,40,1288,1458,9,54,20,13,63,1617
2020-04-12,경남,대구,13130,135,180,257,317,533,14552,8925,87,134,79,55,365,9645
2020-04-12,경남,대전,1111,5,49,25,8,46,1244,1249,10,54,15,5,67,1400
2020-04-12,경남,부산,70073,520,952,250,349,4020,76164,64611,559,958,208,459,3991,70786
2020-04-12,경남,서울,2466,18,268,135,63,73,3023,2691,14,293,38,16,98,3150
2020-04-12,경남,세종,338,1,2,0,1,12,354,290,0,4,0,2,22,318
2020-04-12,경남,울산,9347,112,174,34,59,503,10229,8603,89,171,46,56,464,9429
2020-04-12,경남,전남,6085,59,108,89,191,274,6806,7058,76,102,105,188,301,7830
2020-04-12,경남,전북,1334,11,39,17,23,43,1467,1643,9,42,18,35,69,1816
2020-04-12,경남,충남,1781,12,29,32,38,66,1958,1634,11,35,53,61,59,1853
2020-04-12,경남,충북,1741,12,31,56,46,80,1966,1666,20,49,78,71,81,1965
2020-04-12,경북,강원,451,7,7,19,6,25,515,545,10,11,6,12,27,611
2020-04-12,경북,경기,6109,43,87,177,77,227,6720,4106,36,100,149,73,159,4623
2020-04-12,경북,경남,13978,190,290,199,222,695,15574,11019,126,214,133,190,556,12238
2020-04-12,경북,경북,67698,859,845,493,693,3135,73723,67698,859,845,493,693,3135,73723
2020-04-12,경북,광주,727,19,37,45,17,16,861,939,13,31,38,12,27,1060
2020-04-12,경북,대구,58452,539,442,283,238,2548,62502,57385,581,540,293,294,2460,61553
2020-04-12,경북,대전,2145,15,33,30,17,105,2345,2136,10,31,15,4,99,2295
2020-04-12,경북,부산,6262,30,82,35,96,308,6813,6619,28,97,36,92,309,7181
2020-04-12,경북,서울,4037,27,149,148,31,166,4558,3030,16,147,39,17,122,3371
2020-04-12,경북,세종,377,0,2,5,1,12,397,295,0,6,8,1,17,327
2020-04-12,경북,울산,5746,26,51,53,191,290,6357,5024,22,43,35,172,254,5550
2020-04-12,경북,전남,1085,12,35,20,64,47,1263,1339,16,34,14,81,34,1518
2020-04-12,경북,전북,1799,26,41,28,50,63,2007,1924,26,25,34,52,53,2114
2020-04-12,경북,충남,3793,30,41,51,100,153,4168,3374,27,60,65,104,142,3772
2020-04-12,경북,충북,6641,73,118,145,163,245,7385,5636,78,118,105,114,215,6266
2020-04-12,광주,강원,80,0,5,4,1,3,93,88,0,4,3,0,2,97
2020-04-12,광주,경기,1045,4,23,33,20,37,1162,657,5,33,26,14,22,757
2020-04-12,광주,경남,1458,9,54,20,13,63,1617,1159,13,34,27,15,40,1288
2020-04-12,광주,경북,939,13,31,38,12,27,1060,727,19,37,45,17,16,861
2020-04-12,광주,광주,12304,133,368,61,22,425,13313,12304,133,368,61,22,425,13313
2020-04-12,광주,대구,590,5,16,36,14,14,675,449,4,22,12,5,15,507
2020-04-12,광주,대전,560,4,1,1,5,21,592,533,1,1,2,2,24,563
2020-04-12,광주,부산,556,0,22,10,0,16,604,508,0,33,4,8,17,570
2020-04-12,광주,서울,1041,7,13,11,3,33,1108,694,10,7,5,3,21,740
2020-04-12,광주,세종,310,1,1,0,0,13,325,186,1,1,0,2,2,192
2020-04-12,광주,울산,83,0,6,1,0,3,93,41,0,5,0,1,1,48
2020-04-12,광주,전남,34053,248,532,151,231,1144,36359,34925,243,472,235,194,1215,37284
2020-04-12,광주,전북,8395,85,152,54,39,242,8967,8651,80,160,72,37,279,9279
2020-04-12,광주,충남,7182,43,275,117,75,227,7919,4531,29,308,117,34,134,5153
2020-04-12,광주,충북,779,10,18,19,4,21,851,612,6,17,38,8,24,705
2020-04-12,대구,강원,202,3,6,6,3,11,231,245,0,1,8,3,7,264
2020-04-12,대구,경기,2586,17,40,81,50,93,2867,1590,10,37,77,22,50,1786
2020-04-12,대구,경남,8925,87,134,79,55,365,9645,13130,135,180,257,317,533,14552
2020-04-12,대구,경북,57385,581,540,293,294,2460,61553,58452,539,442,283,238,2548,62502
2020-04-12,대구,광주,449,4,22,12,5,15,507,590,5,16,36,14,14,675
2020-04-12,대구,대구,31915,347,262,165,145,1789,34623,31915,347,262,165,145,1789,34623
2020-04-12,대구,대전,845,4,14,10,9,33,915,615,7,6,8,2,25,663
2020-04-12,대구,부산,568,12,12,11,9,25,637,3976,29,40,22,27,159,4253
2020-04-12,대구,서울,1974,12,60,53,25,66,2190,1592,8,49,21,5,52,1727
2020-04-12,대구,세종,284,1,1,2,0,10,298,148,0,0,1,1,4,154
2020-04-12,대구,울산,1055,10,24,10,33,47,1179,1051,8,24,2,24,49,1158
2020-04-12,대구,전남,523,6,15,5,11,20,580,795,4,9,13,8,28,857
2020-04-12,대구,전북,336,1,12,3,6,16,374,377,3,8,5,3,15,411
2020-04-12,대구,충남,1509,9,9,26,24,59,1636,966,5,12,24,26,24,1057
2020-04-12,대구,충북,1725,19,33,62,54,57,1950,1290,9,26,47,23,57,1452
2020-04-12,대전,강원,176,2,4,0,0,10,192,231,1,3,0,0,11,246
2020-04-12,대전,경기,3127,16,72,21,7,180,3423,2232,10,73,11,5,114,2445
2020-04-12,대전,경남,1249,10,54,15,5,67,1400,1111,5,49,25,8,46,1244
2020-04-12,대전,경북,2136,10,31,15,4,99,2295,2145,15,33,30,17,105,2345
2020-04-12,대전,광주,533,1,1,2,2,24,563,560,4,1,1,5,21,592
2020-04-12,대전,대구,615,7,6,8,2,25,663,845,4,14,10,9,33,915
2020-04-12,대전,대전,10318,74,98,34,31,665,11220,10318,74,98,34,31,665,11220
2020-04-12,대전,부산,112,1,0,1,0,4,118,136,2,1,2,0,6,147
2020-04-12,대전,서울,2421,9,120,7,2,115,2674,1872,9,116,3,2,90,2092
2020-04-12,대전,세종,2482,27,18,10,3,141,2681,2047,27,13,11,11,104,2213
2020-04-12,대전,울산,135,0,2,1,9,6,153,98,1,2,2,2,2,107
2020-04-12,대전,전남,391,2,2,4,3,14,416,562,2,0,4,3,17,588
2020-04-12,대전,전북,3452,16,30,7,12,160,3677,4166,26,29,24,13,201,4459
2020-04-12,대전,충남,13048,88,173,29,45,705,14088,12861,85,168,48,37,688,13887
2020-04-12,대전,충북,9082,110,175,34,20,521,9942,8178,84,180,31,21,477,8971
2020-04-12,부산,강원,8,0,0,0,0,0,8,5,0,0,0,0,0,5
2020-04-12,부산,경기,510,3,9,18,36,21,597,228,3,8,35,18,3,295
2020-04-12,부산,경남,64611,559,958,208,459,3991,70786,70073,520,952,250,349,4020,76164
2020-04-12,부산,경북,6619,28,97,36,92,309,7181,6262,30,82,35,96,308,6813
2020-04-12,부산,광주,508,0,33,4,8,17,570,556,0,22,10,0,16,604
2020-04-12,부산,대구,3976,29,40,22,27,159,4253,568,12,12,11,9,25,637
2020-04-12,부산,대전,136,2,1,2,0,6,147,112,1,0,1,0,4,118
2020-04-12,부산,부산,43445,131,101,77,190,2371,46315,43445,131,101,77,190,2371,46315
2020-04-12,부산,서울,322,3,8,27,9,15,384,232,1,5,13,4,8,263
2020-04-12,부산,세종,54,1,1,1,0,2,59,25,0,1,0,0,4,30
2020-04-12,부산,울산,16710,53,77,72,317,1009,18238,15181,63,51,31,338,891,16555
2020-04-12,부산,전남,2126,9,46,15,89,100,2385,2124,7,41,50,95,80,2397
2020-04-12,부산,전북,362,2,27,1,10,10,412,397,1,15,18,10,16,457
2020-04-12,부산,충남,297,3,6,3,14,14,337,176,0,5,10,4,7,202
2020-04-12,부산,충북,227,1,3,7,17,13,268,122,3,2,21,5,6,159
2020-04-12,서울,강원,938,10,110,2,3,27,1090,2036,10,137,9,1,78,2271
2020-04-12,서울,경기,117308,1691,3131,1184,991,6504,130809,108490,1512,3073,1209,939,5813,121036
2020-04-12,서울,경남,2691,14,293,38,16,98,3150,2466,18,268,135,63,73,3023
2020-04-12,서울,경북,3030,16,147,39,17,122,3371,4037,27,149,148,31,166,4558
2020-04-12,서울,광주,694,10,7,5,3,21,740,1041,7,13,11,3,33,1108
2020-04-12,서울,대구,1592,8,49,21,5,52,1727,1974,12,60,53,25,66,2190
2020-04-12,서울,대전,1872,9,116,3,2,90,2092,2421,9,120,7,2,115,2674
2020-04-12,서울,부산,232,1,5,13,4,8,263,322,3,8,27,9,15,384
2020-04-12,서울,서울,199,3,11,7,0,4,224,199,3,11,7,0,4,224
2020-04-12,서울,세종,30,0,0,0,0,2,32,39,0,0,1,0,1,41
2020-04-12,서울,울산,26,0,1,0,1,0,28,31,2,0,0,3,0,36
2020-04-12,서울,전남,965,2,11,8,2,20,1008,1787,4,22,38,21,31,1903
2020-04-12,서울,전북,1400,3,18,3,2,41,1467,2820,8,38,24,8,92,2990
2020-04-12,서울,충남,35556,159,1372,224,158,1506,38975,43551,165,1239,537,257,1650,47399
2020-04-12,서울,충북,16426,110,508,202,127,682,18055,18202,117,494,216,117,721,19867
2020-04-12,세종,강원,12,0,1,0,0,1,14,7,0,0,0,0,1,8
2020-04-12,세종,경기,42,1,1,0,0,0,44,29,0,1,0,2,2,34
2020-04-12,세종,경남,290,0,4,0,2,22,318,338,1,2,0,1,12,354
2020-04-12,세종,경북,295,0,6,8,1,17,327,377,0,2,5,1,12,397
2020-04-12,세종,광주,186,1,1,0,2,2,192,310,1,1,0,0,13,325
2020-04-12,세종,대구,148,0,0,1,1,4,154,284,1,1,2,0,10,298
2020-04-12,세종,대전,2047,27,13,11,11,104,2213,2482,27,18,10,3,141,2681
2020-04-12,세종,부산,25,0,1,0,0,4,30,54,1,1,1,0,2,59
2020-04-12,세종,서울,39,0,0,1,0,1,41,30,0,0,0,0,2,32
2020-04-12,세종,세종,289,6,2,0,0,13,310,289,6,2,0,0,13,310
2020-04-12,세종,울산,14,0,0,1,1,0,16,16,0,0,0,0,0,16
2020-04-12,세종,전남,185,1,2,1,3,5,197,344,1,1,2,5,6,359
2020-04-12,세종,전북,768,2,6,1,8,26,811,1153,1,3,5,7,51,1220
2020-04-12,세종,충남,5736,54,82,23,29,222,6146,6056,38,77,43,24,255,6493
2020-04-12,세종,충북,352,4,5,3,3,14,381,384,8,2,2,1,35,432
2020-04-12,울산,강원,1,0,0,0,0,1,2,4,0,0,0,0,0,4
2020-04-12,울산,경기,38,0,0,5,8,1,52,19,1,4,1,5,0,30
2020-04-12,울산,경남,8603,89,171,46,56,464,9429,9347,112,174,34,59,503,10229
2020-04-12,울산,경북,5024,22,43,35,172,254,5550,5746,26,51,53,191,290,6357
2020-04-12,울산,광주,41,0,5,0,1,1,48,83,0,6,1,0,3,93
2020-04-12,울산,대구,1051,8,24,2,24,49,1158,1055,10,24,10,33,47,1179
2020-04-12,울산,대전,98,1,2,2,2,2,107,135,0,2,1,9,6,153
2020-04-12,울산,부산,15181,63,51,31,338,891,16555,16710,53,77,72,317,1009,18238
2020-04-12,울산,서울,31,2,0,0,3,0,36,26,0,1,0,1,0,28
2020-04-12,울산,세종,16,0,0,0,0,0,16,14,0,0,1,1,0,16
2020-04-12,울산,울산,4637,27,72,16,46,305,5103,4637,27,72,16,46,305,5103
2020-04-12,울산,전남,274,2,2,0,4,5,287,307,0,3,2,2,6,320
2020-04-12,울산,전북,60,0,3,0,8,0,71,77,0,4,1,0,1,83
2020-04-12,울산,충남,215,0,3,5,21,8,252,139,1,1,5,16,7,169
2020-04-12,울산,충북,23,1,1,1,4,0,30,24,0,0,1,3,1,29
2020-04-12,전남,강원,61,1,1,4,3,3,73,51,0,2,1,2,1,57
2020-04-12,전남,경기,1514,11,36,58,21,42,1682,829,4,39,25,24,31,952
2020-04-12,전남,경남,7058,76,102,105,188,301,7830,6085,59,108,89,191,274,6806
2020-04-12,전남,경북,1339,16,34,14,81,34,1518,1085,12,35,20,64,47,1263
2020-04-12,전남,광주,34925,243,472,235,194,1215,37284,34053,248,532,151,231,1144,36359
2020-04-12,전남,대구,795,4,9,13,8,28,857,523,6,15,5,11,20,580
2020-04-12,전남,대전,562,2,0,4,3,17,588,391,2,2,4,3,14,416
2020-04-12,전남,부산,2124,7,41,50,95,80,2397,2126,9,46,15,89,100,2385
2020-04-12,전남,서울,1787,4,22,38,21,31,1903,965,2,11,8,2,20,1008
2020-04-12,전남,세종,344,1,1,2,5,6,359,185,1,2,1,3,5,197
2020-04-12,전남,울산,307,0,3,2,2,6,320,274,2,2,0,4,5,287
2020-04-12,전남,전남,45640,378,586,378,541,1590,49113,45640,378,586,378,541,1590,49113
2020-04-12,전남,전북,7049,85,116,150,188,204,7792,6286,91,156,94,197,192,7016
2020-04-12,전남,충남,9546,37,250,391,341,269,10834,4927,37,247,109,147,163,5630
2020-04-12,전남,충북,655,3,2,41,31,15,747,427,6,21,19,29,21,523
2020-04-12,전북,강원,174,3,4,5,4,7,197,161,2,4,1,2,5,175
2020-04-12,전북,경기,2927,8,36,43,24,99,3137,1406,5,37,18,21,58,1545
2020-04-12,전북,경남,1643,9,42,18,35,69,1816,1334,11,39,17,23,43,1467
2020-04-12,전북,경북,1924,26,25,34,52,53,2114,1799,26,41,28,50,63,2007
2020-04-12,전북,광주,8651,80,160,72,37,279,9279,8395,85,152,54,39,242,8967
2020-04-12,전북,대구,377,3,8,5,3,15,411,336,1,12,3,6,16,374
2020-04-12,전북,대전,4166,26,29,24,13,201,4459,3452,16,30,7,12,160,3677
2020-04-12,전북,부산,397,1,15,18,10,16,457,362,2,27,1,10,10,412
2020-04-12,전북,서울,2820,8,38,24,8,92,2990,1400,3,18,3,2,41,1467
2020-04-12,전북,세종,1153,1,3,5,7,51,1220,768,2,6,1,8,26,811
2020-04-12,전북,울산,77,0,4,1,0,1,83,60,0,3,0,8,0,71
2020-04-12,전북,전남,6286,91,156,94,197,192,7016,7049,85,116,150,188,204,7792
2020-04-12,전북,전북,15457,187,272,118,84,529,16647,15457,187,272,118,84,529,16647
2020-04-12,전북,충남,23938,154,616,272,269,864,26113,15750,129,619,150,211,613,17472
2020-04-12,전북,충북,2684,32,61,91,53,112,3033,1963,34,68,60,37,62,2224
2020-04-12,충남,강원,407,2,6,6,15,12,448,486,2,5,4,8,22,527
2020-04-12,충남,경기,46654,333,707,415,495,1977,50581,40049,288,821,448,549,1876,44031
2020-04-12,충남,경남,1634,11,35,53,61,59,1853,1781,12,29,32,38,66,1958
2020-04-12,충남,경북,3374,27,60,65,104,142,3772,3793,30,41,51,100,153,4168
2020-04-12,충남,광주,4531,29,308,117,34,134,5153,7182,43,275,117,75,227,7919
2020-04-12,충남,대구,966,5,12,24,26,24,1057,1509,9,9,26,24,59,1636
2020-04-12,충남,대전,12861,85,168,48,37,688,13887,13048,88,173,29,45,705,14088
2020-04-12,충남,부산,176,0,5,10,4,7,202,297,3,6,3,14,14,337
2020-04-12,충남,서울,43551,165,1239,537,257,1650,47399,35556,159,1372,224,158,1506,38975
2020-04-12,충남,세종,6056,38,77,43,24,255,6493,5736,54,82,23,29,222,6146
2020-04-12,충남,울산,139,1,1,5,16,7,169,215,0,3,5,21,8,252
2020-04-12,충남,전남,4927,37,247,109,147,163,5630,9546,37,250,391,341,269,10834
2020-04-12,충남,전북,15750,129,619,150,211,613,17472,23938,154,616,272,269,864,26113
2020-04-12,충남,충남,115125,907,2836,1512,1845,4691,126916,115125,907,2836,1512,1845,4691,126916
2020-04-12,충남,충북,10946,154,212,181,230,543,12266,10360,146,217,180,241,525,11669
2020-04-12,충북,강원,4580,57,70,36,77,232,5052,5582,71,75,48,67,259,6102
2020-04-12,충북,경기,34433,442,520,466,474,1527,37862,27129,454,568,484,526,1383,30544
2020-04-12,충북,경남,1666,20,49,78,71,81,1965,1741,12,31,56,46,80,1966
2020-04-12,충북,경북,5636,78,118,105,114,215,6266,6641,73,118,145,163,245,7385
2020-04-12,충북,광주,612,6,17,38,8,24,705,779,10,18,19,4,21,851
2020-04-12,충북,대구,1290,9,26,47,23,57,1452,1725,19,33,62,54,57,1950
2020-04-12,충북,대전,8178,84,180,31,21,477,8971,9082,110,175,34,20,521,9942
2020-04-12,충북,부산,122,3,2,21,5,6,159,227,1,3,7,17,13,268
2020-04-12,충북,서울,18202,117,494,216,117,721,19867,16426,110,508,202,127,682,18055
2020-04-12,충북,세종,384,8,2,2,1,35,432,352,4,5,3,3,14,381
2020-04-12,충북,울산,24,0,0,1,3,1,29,23,1,1,1,4,0,30
2020-04-12,충북,전남,427,6,21,19,29,21,523,655,3,2,41,31,15,747
2020-04-12,충북,전북,1963,34,68,60,37,62,2224,2684,32,61,91,53,112,3033
2020-04-12,충북,충남,10360,146,217,180,241,525,11669,10946,154,212,181,230,543,12266
2020-04-12,충북,충북,32856,468,485,367,511,1646,36333,32856,468,485,367,511,1646,36333
